티커,종목명,시가,종가,변동폭,등락률,거래량,거래대금
095570,AJ네트웍스,4980,4980,0,0.0,30599,150175245
068400,AJ렌터카,11250,11050,-200,-1.78,74604,826936700
006840,AK홀딩스,56200,56100,-100,-0.18,14300,801592600
027410,BGF,8530,8430,-100,-1.17,107833,904959550
282330,BGF리테일,204000,206000,2000,0.98,10256,2109709500
138930,BNK금융지주,6820,6860,40,0.59,651572,4467613810
001460,BYC,237500,237000,-500,-0.21,133,31416000
001465,BYC우,111000,110500,-500,-0.45,24,2651000
001040,CJ,121500,122500,1000,0.82,39576,4796289000
079160,CJCGV,45900,45550,-350,-0.76,155988,7053268150
000120,CJ대한통운,181500,182500,1000,0.55,47554,8651911500
011150,CJ씨푸드,2340,2310,-30,-1.28,43448,100385530
011155,CJ씨푸드1우,28100,27850,-250,-0.89,308,8538300
001045,CJ우,54800,55500,700,1.28,3188,175211400
097950,CJ제일제당,322500,328500,6000,1.86,46010,15013907500
097955,CJ제일제당우,131500,135500,4000,3.04,8201,1095605000
037560,CJ헬로,9080,9180,100,1.1,218687,1977825070
000590,CS홀딩스,63300,61900,-1400,-2.21,386,23970800
012030,DB,893,888,-5,-0.56,568661,499654158
016610,DB금융투자,4750,4900,150,3.16,157171,763269445
005830,DB손해보험,69400,69800,400,0.58,81758,5704588400
000990,DB하이텍,11650,11650,0,0.0,189655,2186315650
000995,DB하이텍1우,33450,33850,400,1.2,95,3182100
139130,DGB금융지주,8320,8240,-80,-0.96,492686,4075012100
004840,DRB동일,6890,6770,-120,-1.74,29377,197596010
155660,DSR,4755,4825,70,1.47,153668,736716720
069730,DSR제강,5100,5200,100,1.96,384686,1996254920
017940,E1,58700,58800,100,0.17,5295,310072600
007700,FF,73500,71700,-1800,-2.45,213584,15308037900
114090,GKL,23200,22650,-550,-2.37,272113,6177228600
078930,GS,51400,51100,-300,-0.58,120068,6099718900
006360,GS건설,41350,41600,250,0.6,270615,11226575700
001250,GS글로벌,2630,2605,-25,-0.95,249535,648893200
007070,GS리테일,37650,38350,700,1.86,71526,2715568550
078935,GS우,36700,36550,-150,-0.41,2086,76302450
012630,HDC,19400,18950,-450,-2.32,469727,8827457600
039570,HDC아이콘트롤스,10500,10450,-50,-0.48,21189,218280900
089470,HDC현대EP,4580,4475,-105,-2.29,26635,119976970
294870,HDC현대산업개발,49200,48950,-250,-0.51,72841,3556681150
082740,HSD엔진,4700,4650,-50,-1.06,113372,525532695
003560,IHQ,2110,2030,-80,-3.79,4719263,9842402630
175330,JB금융지주,5850,5870,20,0.34,286810,1675418990
234080,JW생명과학,25200,25100,-100,-0.4,51153,1280324850
001060,JW중외제약,42750,42250,-500,-1.17,36604,1539882850
001067,JW중외제약2우B,42900,42500,-400,-0.93,572,24238350
001065,JW중외제약우,28300,27900,-400,-1.41,4103,114130400
096760,JW홀딩스,7390,7440,50,0.68,51110,378340110
105560,KB금융,42150,42700,550,1.3,1034318,44111138200
002380,KCC,307500,307500,0,0.0,10922,3367699000
009070,KCTC,3285,3370,85,2.59,252455,838059890
009440,KC그린홀딩스,4310,4600,290,6.73,1651066,7721936360
119650,KC코트렐,6730,7020,290,4.31,4702127,33254512970
092220,KEC,1095,1095,0,0.0,540691,584483705
001390,KG케미칼,16500,16450,-50,-0.3,80625,1310790700
001940,KISCO홀딩스,13500,13550,50,0.37,2087,28110750
025000,KPX케미칼,56400,56800,400,0.71,5797,325462500
092230,KPX홀딩스,60500,60500,0,0.0,296,17828500
000040,KR모터스,494,493,-1,-0.2,117642,57587878
044450,KSS해운,7100,7030,-70,-0.99,15517,109130930
030200,KT,27750,27650,-100,-0.36,408561,11340362700
033780,KTG,107000,109500,2500,2.34,323426,35144788500
030210,KTB투자증권,3015,2950,-65,-2.16,469555,1376603885
058850,KTcs,2390,2365,-25,-1.05,198550,468248805
093050,LF,24650,24450,-200,-0.81,69336,1688080550
003550,LG,73200,74900,1700,2.32,132508,9865047400
034220,LG디스플레이,21300,21050,-250,-1.17,1089633,22891366300
001120,LG상사,16950,16850,-100,-0.59,117657,1972695150
051900,LG생활건강,1273000,1274000,1000,0.08,29340,37144261000
051905,LG생활건강우,758000,754000,-4000,-0.53,1628,1219103000
003555,LG우,43050,43050,0,0.0,10791,464200500
032640,LG유플러스,14750,14700,-50,-0.34,1186570,17351384450
011070,LG이노텍,107000,109000,2000,1.87,95992,10463135000
066570,LG전자,73700,75300,1600,2.17,796316,59668007600
066575,LG전자우,29500,30000,500,1.69,33063,976110250
108670,LG하우시스,66000,65300,-700,-1.06,27482,1791882200
108675,LG하우시스우,31850,31600,-250,-0.78,797,25103300
051910,LG화학,364500,361000,-3500,-0.96,176310,63609123500
051915,LG화학우,205500,203000,-2500,-1.22,4825,985710000
079550,LIG넥스원,37800,37700,-100,-0.26,81552,3030654900
006260,LS,54600,54500,-100,-0.18,86825,4679800900
000680,LS네트웍스,2670,2735,65,2.43,37842,101514180
010120,LS산전,49600,48300,-1300,-2.62,153081,7386429100
229640,LS전선아시아,6040,6090,50,0.83,9936,59847450
023150,MH에탄올,6550,6470,-80,-1.22,7028,45352410
035420,NAVER,133000,133500,500,0.38,151479,20146603500
181710,NHN엔터테인먼트,80900,85600,4700,5.81,352597,30046433000
005940,NH투자증권,12600,12650,50,0.4,304324,3842302750
005945,NH투자증권우,8660,8680,20,0.23,10940,94789210
034310,NICE,19100,19050,-50,-0.26,26571,503669600
008260,NI스틸,2530,2485,-45,-1.78,26057,64499670
004250,NPC,3890,3840,-50,-1.29,8075,31201390
004255,NPC우,2170,2170,0,0.0,566,1223695
010060,OCI,98700,97700,-1000,-1.01,116404,11354048500
005490,POSCO,249500,248000,-1500,-0.6,200216,49589432500
100840,STC,12300,12200,-100,-0.81,2430,29399350
064960,ST모티브,32800,33150,350,1.07,42703,1408222000
003570,ST중공업,7490,7550,60,0.8,6853,51640610
036530,ST홀딩스,13450,13550,100,0.74,28454,382607150
010950,S-Oil,96300,92400,-3900,-4.05,969225,89873088600
010955,S-Oil우,66300,63200,-3100,-4.68,49614,3160637600
034120,SBS,26250,25650,-600,-2.29,80306,2063028750
101060,SBS미디어홀딩스,2320,2290,-30,-1.29,25428,58003090
004060,SG세계물산,781,779,-2,-0.26,966176,733060290
001380,SG충방,2530,2390,-140,-5.53,566307,1368400440
002360,SH에너지화학,1070,1060,-10,-0.93,653944,682592460
009160,SIMPAC,2750,2740,-10,-0.36,52633,144171825
123700,SJM,3265,3265,0,0.0,5288,17335070
025530,SJM홀딩스,3330,3280,-50,-1.5,26874,87520185
034730,SK,265500,266500,1000,0.38,48689,12852853500
011790,SKC,36900,37650,750,2.03,88191,3288183200
018670,SK가스,84500,84700,200,0.24,14123,1197294200
001740,SK네트웍스,5830,5840,10,0.17,572511,3327304750
001745,SK네트웍스우,54500,54600,100,0.18,259,14115100
006120,SK디스커버리,29600,28500,-1100,-3.72,71371,2034595450
006125,SK디스커버리우,15950,15900,-50,-0.31,2675,43008950
210980,SK디앤디,30000,30000,0,0.0,11458,344156000
03473K,SK우,144000,145000,1000,0.69,1832,264653000
096770,SK이노베이션,192000,188500,-3500,-1.82,204415,38671512500
096775,SK이노베이션우,125500,125000,-500,-0.4,5670,712025000
001510,SK증권,706,701,-5,-0.71,1646453,1151210161
001515,SK증권우,3400,3315,-85,-2.5,62140,206113910
285130,SK케미칼,73000,72400,-600,-0.82,18813,1351827500
28513K,SK케미칼우,26200,25850,-350,-1.34,1056,26906700
017670,SK텔레콤,252000,249000,-3000,-1.19,159827,39835163000
000660,SK하이닉스,66700,66600,-100,-0.15,2869008,192102682500
005610,SPC삼립,114000,121500,7500,6.58,45694,5455598000
011810,STX,16000,16050,50,0.31,32921,521742050
077970,STX엔진,7080,7110,30,0.42,10945,77549490
071970,STX중공업,5860,5950,90,1.54,37062,218136770
084870,TBH글로벌,2540,2575,35,1.38,91365,234479760
002710,TCC동양,2490,2500,10,0.4,52325,129148830
024070,WISCOM,2915,2845,-70,-2.4,9503,27151610
037270,YGPLUS,2100,2050,-50,-2.38,531699,1077410225
000500,가온전선,18200,18100,-100,-0.55,3615,65544850
000860,강남제비스코,26800,26700,-100,-0.37,7661,206055150
035250,강원랜드,30450,31500,1050,3.45,612802,19224504700
011420,갤럭시아에스엠,1550,1535,-15,-0.97,60661,93546670
002100,경농,13900,13900,0,0.0,235997,3276003650
009450,경동나비엔,56200,58000,1800,3.2,540743,30935728000
267290,경동도시가스,36500,35900,-600,-1.64,3363,121088000
012320,경동인베스트,41300,40500,-800,-1.94,7785,316155050
000050,경방,11400,11250,-150,-1.32,8110,91061850
214390,경보제약,10850,10850,0,0.0,34406,369382650
012610,경인양행,5870,5870,0,0.0,124448,724122570
009140,경인전자,29550,29150,-400,-1.35,695,20076650
013580,계룡건설,23400,23200,-200,-0.85,11016,254457650
012200,계양전기,3640,3570,-70,-1.92,76013,268501195
012205,계양전기우,8060,8080,20,0.25,37412,297130280
004200,고려개발,4950,4875,-75,-1.52,7485,36753245
002140,고려산업,2225,2230,5,0.22,42055,93492920
010130,고려아연,437000,442500,5500,1.26,18768,8233322500
002240,고려제강,26550,26500,-50,-0.19,6948,183077500
001290,골든브릿지증권,2740,2770,30,1.09,281378,788016675
009290,광동제약,7380,7370,-10,-0.14,51342,375717930
017040,광명전기,2540,2505,-35,-1.38,268046,670340835
017900,광전자,2260,2260,0,0.0,88294,198000720
037710,광주신세계,197000,193500,-3500,-1.78,682,132577500
030610,교보증권,9460,9330,-130,-1.37,121782,1136316890
007690,국도화학,51500,50100,-1400,-2.72,8543,431477500
005320,국동,2680,2635,-45,-1.68,66516,176073700
001140,국보,14650,17850,3200,21.84,618184,10790857600
002720,국제약품,4625,4590,-35,-0.76,52497,240877270
083420,그린케미칼,3535,3535,0,0.0,6215,21977560
014530,극동유화,3525,3545,20,0.57,68575,241746070
014280,금강공업,22400,21950,-450,-2.01,8082,176432300
014285,금강공업우,33700,33250,-450,-1.34,36,1202100
008870,금비,68300,68000,-300,-0.44,267,18073400
001570,금양,2275,2250,-25,-1.1,51304,114808350
002990,금호산업,12000,12350,350,2.92,75214,917373950
002995,금호산업우,24600,24450,-150,-0.61,848,20549650
011780,금호석유,93600,95400,1800,1.92,216066,20821605500
011785,금호석유우,33200,34000,800,2.41,11289,383973150
214330,금호에이치티,6660,6660,0,0.0,87002,578205520
001210,금호전기,6150,6130,-20,-0.33,30044,184039000
073240,금호타이어,5050,4985,-65,-1.29,511850,2549101920
092440,기신정기,4000,4020,20,0.5,3970,15833460
000270,기아차,33650,33900,250,0.74,681839,23003160600
024110,기업은행,13800,13950,150,1.09,804836,11227626400
013700,까뮤이앤씨,1355,1310,-45,-3.32,271122,371239660
004540,깨끗한나라,3340,3255,-85,-2.54,60944,198777340
004545,깨끗한나라우,19400,19100,-300,-1.55,2803,53164250
074610,나노메딕스,6590,6270,-320,-4.86,490347,3077890140
001260,남광토건,13400,13100,-300,-2.24,48997,638289600
008350,남선알미늄,2315,2225,-90,-3.89,1835085,4110187050
008355,남선알미우,26450,25950,-500,-1.89,4792,125211250
004270,남성,1870,1840,-30,-1.6,182681,336884120
003920,남양유업,630000,637000,7000,1.11,469,296472000
003925,남양유업우,212500,212500,0,0.0,2,425000
002070,남영비비안,6240,6290,50,0.8,1595,9955460
025860,남해화학,11200,11050,-150,-1.34,277914,3049722000
005720,넥센,6200,6220,20,0.32,6395,39295650
005725,넥센우,3650,3645,-5,-0.14,2354,8536580
002350,넥센타이어,9470,9480,10,0.11,102852,975747890
002355,넥센타이어1우B,3880,3880,0,0.0,530,2058575
003580,넥스트사이언스,5910,5970,60,1.02,84721,502424750
251270,넷마블,113000,113500,500,0.44,94465,10665950500
090350,노루페인트,8020,8080,60,0.75,134918,1079307280
090355,노루페인트우,11300,11000,-300,-2.65,40788,449766000
000320,노루홀딩스,12800,12600,-200,-1.56,3152,39865100
000325,노루홀딩스우,18750,18750,0,0.0,180,3343750
006280,녹십자,151000,152500,1500,0.99,45817,6887292000
005250,녹십자홀딩스,24900,25300,400,1.61,48078,1190919850
005257,녹십자홀딩스2우,17700,17850,150,0.85,1618,28616400
004370,농심,279000,295500,16500,5.91,62748,18414689500
072710,농심홀딩스,81800,84500,2700,3.3,2768,230251000
058730,다스코,7340,7280,-60,-0.82,114543,832662440
023590,다우기술,21900,22000,100,0.46,77365,1665263500
019680,대교,6550,6640,90,1.37,33984,223948870
019685,대교우B,4420,4420,0,0.0,1443,6383615
006370,대구백화점,8810,8630,-180,-2.04,29949,258952290
008060,대덕전자,9900,9840,-60,-0.61,387285,3758868050
00806K,대덕전자1우,5800,5730,-70,-1.21,1974,11329700
000490,대동공업,5710,5700,-10,-0.18,29595,166873990
008110,대동전자,3530,3575,45,1.27,2533,8938765
005750,대림BCo,4940,4995,55,1.11,28766,140237940
000210,대림산업,91700,94200,2500,2.73,82282,7718105400
000215,대림산업우,36400,36700,300,0.82,2803,102899650
004440,대림씨엔에스,10950,10850,-100,-0.91,11267,121530600
006570,대림통상,4040,4160,120,2.97,2795,11320920
001680,대상,28100,29200,1100,3.91,322911,9398996600
001685,대상우,13000,13350,350,2.69,5098,67356150
084690,대상홀딩스,8350,8490,140,1.68,91082,765718340
084695,대상홀딩스우,5830,5830,0,0.0,395,2297210
128820,대성산업,5070,5040,-30,-0.59,60565,306403170
117580,대성에너지,5350,5370,20,0.37,9457,50685080
016710,대성홀딩스,6940,6850,-90,-1.3,28195,195556810
003540,대신증권,11250,11100,-150,-1.33,142728,1582151300
003547,대신증권2우B,8230,8180,-50,-0.61,5431,44584290
003545,대신증권우,8750,8720,-30,-0.34,30548,266476870
009190,대양금속,4530,4505,-25,-0.55,6519,29383390
014160,대영포장,1225,1240,15,1.22,1470391,1801785965
047040,대우건설,4855,4785,-70,-1.44,838103,4021534155
009320,대우부품,2675,2675,0,0.0,660381,1770459825
042660,대우조선해양,30200,29150,-1050,-3.48,561525,16419621300
003090,대웅,19350,19300,-50,-0.26,64594,1238626300
069620,대웅제약,184500,180500,-4000,-2.17,58943,10617362500
000430,대원강업,4885,4920,35,0.72,163683,790838135
006340,대원전선,1505,1490,-15,-1.0,828004,1230364150
006345,대원전선우,3350,3270,-80,-2.39,27585,90894125
003220,대원제약,16950,16950,0,0.0,54646,910019950
024890,대원화성,1725,1700,-25,-1.45,84640,143178840
002880,대유에이텍,1265,1310,45,3.56,7273896,9290632280
000300,대유플러스,1005,1010,5,0.5,451474,451144456
012800,대창,982,980,-2,-0.2,306875,297659027
015230,대창단조,40700,41100,400,0.98,2627,107097850
001070,대한방직,14000,13950,-50,-0.36,9844,136660800
006650,대한유화,162000,160500,-1500,-0.93,46593,7422578500
001440,대한전선,1120,1135,15,1.34,1869858,2160613575
084010,대한제강,6150,6090,-60,-0.98,48793,292872560
001790,대한제당,21400,21400,0,0.0,1076,22872800
001799,대한제당3우B,23350,23250,-100,-0.43,1,23250
001795,대한제당우,12200,12200,0,0.0,174,2115500
001130,대한제분,190000,189000,-1000,-0.53,945,177834500
003490,대한항공,34700,33950,-750,-2.16,564621,19146348300
003495,대한항공우,14600,14550,-50,-0.34,3883,56285000
005880,대한해운,21850,22300,450,2.06,98772,2150841050
003830,대한화섬,108000,106500,-1500,-1.39,296,31564500
016090,대현,2560,2635,75,2.93,234507,598333770
069460,대호에이엘,5420,5420,0,0.0,0,0
012510,더존비즈온,45100,44150,-950,-2.11,137692,6030687800
004830,덕성,3330,3210,-120,-3.6,34770,112387990
004835,덕성우,4100,4085,-15,-0.37,6773,27502655
024900,덕양산업,1380,1375,-5,-0.36,127382,175005715
145720,덴티움,62300,61800,-500,-0.8,29155,1792374200
002150,도화엔지니어링,9190,9300,110,1.2,311964,2914195730
001620,동국실업,905,894,-11,-1.22,149888,131954196
001230,동국제강,7980,7990,10,0.13,200533,1592592810
023450,동남합성,24800,24500,-300,-1.21,776,19220550
004140,동방,1635,1610,-25,-1.53,345011,555726510
007590,동방아그로,6960,7000,40,0.57,11963,82873690
005960,동부건설,7850,7920,70,0.89,24084,187601510
005965,동부건설우,15850,16050,200,1.26,394,6294700
016380,동부제철,10750,10350,-400,-3.72,30008,313221300
016385,동부제철우,42950,42500,-450,-1.05,1043,44128050
083370,동북아12호,5030,5030,0,0.0,100,503000
083380,동북아13호,5010,5010,0,0.0,0,0
026960,동서,21050,21050,0,0.0,193782,4061022000
002210,동성제약,18450,17800,-650,-3.52,445863,7919560000
102260,동성코퍼레이션,5710,5660,-50,-0.88,54051,305060270
005190,동성화학,14350,14150,-200,-1.39,11148,157873050
000640,동아쏘시오홀딩스,111000,111500,500,0.45,8847,981326500
170900,동아에스티,104000,106000,2000,1.92,12679,1329867000
028100,동아지질,16300,16250,-50,-0.31,115975,1859710150
282690,동아타이어,12700,12600,-100,-0.79,1267,15828550
001520,동양,1960,1955,-5,-0.26,238389,463425160
001527,동양2우B,10850,10700,-150,-1.38,209,2209650
001529,동양3우B,30400,30250,-150,-0.49,214,6452950
084670,동양고속,28000,28200,200,0.71,670,18792700
030790,동양네트웍스,1905,1880,-25,-1.31,616356,1144590980
002900,동양물산,1900,1860,-40,-2.11,1163294,2201448835
082640,동양생명,4805,4765,-40,-0.83,83189,394296450
001525,동양우,8400,8280,-120,-1.43,1166,9669910
008970,동양철관,1370,1340,-30,-2.19,1365798,1826212230
092780,동양피스톤,5920,5800,-120,-2.03,132624,765714080
049770,동원FB,267500,271000,3500,1.31,5633,1506342000
018500,동원금속,850,847,-3,-0.35,80652,67313554
006040,동원산업,230500,229500,-1000,-0.43,3412,774907500
030720,동원수산,8790,8690,-100,-1.14,34630,298609840
014820,동원시스템즈,28350,28400,50,0.18,17051,479903800
014825,동원시스템즈우,20400,20000,-400,-1.96,522,10440800
163560,동일고무벨트,6860,6850,-10,-0.15,21030,142063420
001530,동일방직,65500,64200,-1300,-1.98,3398,218736400
004890,동일산업,58400,58900,500,0.86,1324,77915200
002690,동일제강,3180,3125,-55,-1.73,25323,79268435
000020,동화약품,9930,9850,-80,-0.81,89651,877700660
000150,두산,96100,95500,-600,-0.62,69974,6611438300
000157,두산2우B,72700,72300,-400,-0.55,170,12243000
011160,두산건설,1395,1405,10,0.72,85285,118757915
241560,두산밥캣,30650,31050,400,1.31,171311,5312454900
000155,두산우,72500,72100,-400,-0.55,5212,379108200
042670,두산인프라코어,7640,7540,-100,-1.31,1422938,10723618390
034020,두산중공업,7870,7800,-70,-0.89,1040650,8058196020
016740,두올,3050,3040,-10,-0.33,73128,220767470
024090,디씨엠,11250,11200,-50,-0.44,217648,2466111250
003160,디아이,3780,3785,5,0.13,93889,355566785
092200,디아이씨,6550,6560,10,0.15,103625,676287160
013570,디와이,5860,5720,-140,-2.39,149767,857404990
210540,디와이파워,15500,14650,-850,-5.48,207000,3048675150
007340,디티알오토모티브,32350,32300,-50,-0.15,2042,65153050
026890,디피씨,6400,6600,200,3.13,1782143,11584656500
115390,락앤락,19800,19600,-200,-1.01,68284,1344177750
032350,롯데관광개발,13050,13000,-50,-0.38,171091,2209978050
000400,롯데손해보험,2910,2970,60,2.06,382518,1118063505
023530,롯데쇼핑,189000,188500,-500,-0.26,52760,9947621500
004000,롯데정밀화학,46900,46400,-500,-1.07,99971,4591227650
286940,롯데정보통신,46800,47100,300,0.64,83913,3921442850
280360,롯데제과,184000,187500,3500,1.9,2175,397310000
004990,롯데지주,50700,50000,-700,-1.38,124934,6254694800
00499K,롯데지주우,51300,51300,0,0.0,491,25235600
005300,롯데칠성,1600000,1628000,28000,1.75,3865,6283040000
005305,롯데칠성우,691000,709000,18000,2.6,281,198856000
011170,롯데케미칼,291500,289000,-2500,-0.86,172958,49668881000
002270,롯데푸드,663000,672000,9000,1.36,1499,1002273000
071840,롯데하이마트,51100,55600,4500,8.81,272197,14818571600
027740,마니커,770,770,0,0.0,608326,465260752
204320,만도,31200,30600,-600,-1.92,331598,10142041500
001080,만호제강,17450,17050,-400,-2.29,3133,53607600
088980,맥쿼리인프라,9960,9990,30,0.3,291805,2911740290
094800,맵스리얼티1,3780,3780,0,0.0,52826,199103705
015540,메디파트너생명공학,6760,6790,30,0.44,9546,64227200
138040,메리츠금융지주,13300,13400,100,0.75,57084,750264600
008560,메리츠종금증권,4615,4625,10,0.22,1429597,6563122915
000060,메리츠화재,22750,22700,-50,-0.22,97186,2204536700
090370,메타랩스,1545,1500,-45,-2.91,380942,566055120
017180,명문제약,5660,5570,-90,-1.59,249344,1379235470
012690,모나리자,4460,4520,60,1.35,1714464,7757878820
005360,모나미,2840,2770,-70,-2.46,52853,146382535
204210,모두투어리츠,3090,3080,-10,-0.32,2752,8554110
009680,모토닉,11550,11850,300,2.6,281363,3285441950
009580,무림PP,6230,6330,100,1.61,335390,2092165060
009200,무림페이퍼,3320,3290,-30,-0.9,200285,652198375
033920,무학,13650,14050,400,2.93,20093,280297450
008420,문배철강,3010,2990,-20,-0.66,169938,508284210
025560,미래산업,166,162,-4,-2.41,2362883,384870514
007120,미래아이앤지,469,469,0,0.0,106579,49947131
006800,미래에셋대우,7270,7330,60,0.83,1121894,8163894050
00680K,미래에셋대우2우B,3665,3655,-10,-0.27,154496,564330100
006805,미래에셋대우우,4075,4045,-30,-0.74,16754,67780150
085620,미래에셋생명,5120,5050,-70,-1.37,214688,1085116060
002840,미원상사,328000,337000,9000,2.74,983,332313000
268280,미원에스씨,67100,67100,0,0.0,1170,78447700
107590,미원홀딩스,40150,39900,-250,-0.62,6610,265071900
134380,미원화학,42450,42850,400,0.94,677,28893950
003650,미창석유,81000,81400,400,0.49,466,38046700
155900,바다로19호,2945,2945,0,0.0,1724,5075890
003610,방림,2320,2320,0,0.0,10206,23497215
001340,백광산업,2705,2690,-15,-0.55,153680,409712190
014580,백광소재,2850,2860,10,0.35,298634,858907960
035150,백산,7100,7380,280,3.94,82769,594567690
002410,범양건영,1800,1840,40,2.22,44739,80522290
096300,베트남개발1,365,364,-1,-0.27,383861,139646329
007210,벽산,2850,2900,50,1.75,216858,616106920
002760,보락,2400,2360,-40,-1.67,389457,923587335
003850,보령제약,10400,10350,-50,-0.48,135714,1394544000
000890,보해양조,1675,1645,-30,-1.79,2543596,4245936645
003000,부광약품,22450,22450,0,0.0,107909,2409043950
001270,부국증권,20900,20950,50,0.24,1541,32149600
001275,부국증권우,19300,19150,-150,-0.78,541,10327400
026940,부국철강,2850,2815,-35,-1.23,118273,331274310
015350,부산가스,40400,40550,150,0.37,11293,453076350
011390,부산산업,126500,125500,-1000,-0.79,12137,1524906500
005030,부산주공,573,572,-1,-0.17,249836,139927489
100220,비상교육,7120,7110,-10,-0.14,15507,109871000
005180,빙그레,70000,72200,2200,3.14,19534,1395576400
003960,사조대림,21150,21250,100,0.47,11430,239057800
008040,사조동아원,1385,1435,50,3.61,2925872,4136999055
007160,사조산업,55300,56200,900,1.63,4030,223812900
014710,사조씨푸드,6390,6360,-30,-0.47,17760,112618710
006090,사조오양,9260,9230,-30,-0.32,38936,353897570
079660,사조해표,10050,9860,-190,-1.89,56929,560005060
005090,삼광글라스,40100,40700,600,1.5,13003,529139250
001470,삼부토건,4935,4965,30,0.61,69911,340319720
006400,삼성SDI,220500,217500,-3000,-1.36,350400,76209164500
006405,삼성SDI우,92600,92600,0,0.0,1425,131738700
006660,삼성공조,9600,9480,-120,-1.25,64579,614160540
028260,삼성물산,109500,108500,-1000,-0.91,182711,19758787000
02826K,삼성물산우B,71400,71400,0,0.0,1969,142021300
207940,삼성바이오로직스,373500,367500,-6000,-1.61,81574,29946552000
032830,삼성생명,85300,85400,100,0.12,159141,13602794000
018260,삼성에스디에스,222500,221000,-1500,-0.67,67152,14751975500
028050,삼성엔지니어링,15550,15350,-200,-1.29,557001,8562932800
009150,삼성전기,99600,100000,400,0.4,691864,69187739900
009155,삼성전기우,41800,42100,300,0.72,3008,126321350
005930,삼성전자,43800,43650,-150,-0.34,10717408,471357939175
005935,삼성전자우,35150,34750,-400,-1.14,1162079,40777229900
001360,삼성제약,2765,2700,-65,-2.35,354125,946547835
010140,삼성중공업,8700,8940,240,2.76,2776371,24489159920
010145,삼성중공우,49550,50500,950,1.92,1904,95327950
016360,삼성증권,33200,33450,250,0.75,159951,5348284700
068290,삼성출판사,16650,16650,0,0.0,246622,4112798250
029780,삼성카드,33000,33250,250,0.76,52122,1732987600
000810,삼성화재,287500,291000,3500,1.22,61615,17892449500
000815,삼성화재우,188000,190000,2000,1.06,5390,1017047000
006110,삼아알미늄,4465,4435,-30,-0.67,21403,94953020
145990,삼양사,63200,62700,-500,-0.79,7395,462328600
145995,삼양사우,37500,38250,750,2.0,87,3264550
003230,삼양식품,73100,79800,6700,9.17,191933,14962296900
002170,삼양통상,44200,44800,600,1.36,9737,434052400
272550,삼양패키징,18600,18650,50,0.27,13917,257961600
000070,삼양홀딩스,87400,86900,-500,-0.57,9353,809374500
000075,삼양홀딩스우,49100,49000,-100,-0.2,397,19374450
002810,삼영무역,15200,15250,50,0.33,8201,124260150
005680,삼영전자,12850,12750,-100,-0.78,31888,407517150
003720,삼영화학,790,774,-16,-2.03,177373,136376227
023000,삼원강재,3075,3030,-45,-1.46,11337,34139655
004380,삼익THK,12150,11800,-350,-2.88,70275,825347200
002450,삼익악기,1820,1800,-20,-1.1,293991,526813765
000520,삼일제약,26050,28000,1950,7.49,281839,7743717950
009770,삼정펄프,35600,35600,0,0.0,77,2738850
005500,삼진제약,42750,42650,-100,-0.23,102232,4346225350
004690,삼천리,94400,95500,1100,1.17,3724,354601000
001880,삼호,15050,14700,-350,-2.33,20187,296662500
010960,삼호개발,4980,4960,-20,-0.4,115470,567124710
004450,삼화왕관,46900,46950,50,0.11,54,2529900
009470,삼화전기,20750,20400,-350,-1.69,41205,842522000
011230,삼화전자,3770,3650,-120,-3.18,141289,510136265
001820,삼화콘덴서,58200,57200,-1000,-1.72,130794,7485478400
000390,삼화페인트,6100,6060,-40,-0.66,13318,80379970
041650,상신브레이크,4300,4190,-110,-2.56,46689,196667720
075180,새론오토모티브,5300,5300,0,0.0,5257,27633200
007540,샘표,35300,35600,300,0.85,14210,502151050
248170,샘표식품,29850,29850,0,0.0,4190,123981600
007860,서연,3875,3855,-20,-0.52,20843,79841565
200880,서연이화,5100,5020,-80,-1.57,58390,295775270
017390,서울가스,85500,85800,300,0.35,197,16784700
004410,서울식품,188,195,7,3.72,2884318,551157781
004415,서울식품우,4005,4065,60,1.5,24260,97572100
021050,서원,1160,1150,-10,-0.86,58652,66516925
008490,서흥,26750,25800,-950,-3.55,29548,763077800
007610,선도전기,4010,3950,-60,-1.5,190356,749560165
136490,선진,11700,11750,50,0.43,20811,241159450
002820,선창산업,5300,5210,-90,-1.7,11430,59426200
014910,성문전자,2955,2870,-85,-2.88,193227,559177435
014915,성문전자우,15950,15450,-500,-3.13,69365,1103552250
003080,성보화학,5390,5320,-70,-1.3,24038,127263510
004980,성신양회,10650,10850,200,1.88,256151,2763580650
004987,성신양회2우B,13150,12800,-350,-2.66,7616,98483950
004989,성신양회3우B,10650,10450,-200,-1.88,369,3824950
004985,성신양회우,10800,10750,-50,-0.46,7900,84628300
011300,성안,626,626,0,0.0,136432,84208735
000180,성창기업지주,2160,2150,-10,-0.46,52426,112508310
002420,세기상사,70200,72700,2500,3.56,274,19474200
004360,세방,13450,13500,50,0.37,16697,225410400
004365,세방우,6440,6450,10,0.16,176,1133330
004490,세방전지,42400,42850,450,1.06,23572,1003171950
001430,세아베스틸,19850,20100,250,1.26,60601,1209846800
306200,세아제강,61200,61500,300,0.49,6050,366810100
003030,세아제강지주,50400,50800,400,0.79,8331,417285700
019440,세아특수강,15600,15650,50,0.32,21340,331411700
058650,세아홀딩스,95800,95600,-200,-0.21,1242,117576300
013000,세우글로벌,1810,1760,-50,-2.76,380592,673775485
091090,세원셀론텍,4035,3870,-165,-4.09,824786,3160409745
021820,세원정공,7680,7630,-50,-0.65,2029,15503610
067830,세이브존IC,3945,3920,-25,-0.63,15754,61029410
033530,세종공업,7200,7020,-180,-2.5,303591,2114416670
075580,세진중공업,4025,4025,0,0.0,80265,321063845
027970,세하,1540,1540,0,0.0,92073,138806420
145210,세화아이엠씨,2990,2990,0,0.0,0,0
068270,셀트리온,206000,205000,-1000,-0.49,298618,60929464000
004430,송원산업,19500,18850,-650,-3.33,312667,5869624250
017550,수산중공업,1620,1620,0,0.0,391538,631184980
002200,수출포장,21000,21050,50,0.24,4464,93291100
053210,스카이라이프,12050,12200,150,1.24,52076,631120700
134790,시디즈,39900,39150,-750,-1.88,2012,78109850
016590,신대양제지,75400,77400,2000,2.65,31240,2383064800
029530,신도리코,48350,48600,250,0.52,3657,177375550
004970,신라교역,14350,14250,-100,-0.7,6533,92166800
011930,신성이엔지,1220,1190,-30,-2.46,1149682,1360269070
005390,신성통상,919,917,-2,-0.22,433295,391298788
004170,신세계,289000,296500,7500,2.6,81011,23735014000
035510,신세계IC,152000,156000,4000,2.63,14978,2267408000
034300,신세계건설,31900,30600,-1300,-4.08,15796,490889550
031430,신세계인터내셔날,262500,277500,15000,5.71,64358,17433496000
031440,신세계푸드,96200,95600,-600,-0.62,18046,1706043000
006880,신송홀딩스,4525,4520,-5,-0.11,37346,166870390
005800,신영와코루,132000,132500,500,0.38,45,5910500
001720,신영증권,59800,59500,-300,-0.5,4216,250867000
001725,신영증권우,55700,55800,100,0.18,559,31125900
009270,신원,2075,2030,-45,-2.17,1333257,2711021980
009275,신원우,49050,48300,-750,-1.53,2211,107381100
002700,신일산업,1705,1765,60,3.52,14050399,24444818275
019170,신풍제약,8230,8230,0,0.0,1127776,9179068960
019175,신풍제약우,6860,6590,-270,-3.94,23279,153853950
002870,신풍제지,1345,1340,-5,-0.37,95852,126970020
005450,신한,4945,4945,0,0.0,0,0
293940,신한알파리츠,5690,5720,30,0.53,123617,705092890
055550,신한지주,42000,42900,900,2.14,867115,37326162700
001770,신화실업,21550,21900,350,1.62,314,6744050
004080,신흥,10100,10050,-50,-0.5,3710,37057250
102280,쌍방울,1035,1020,-15,-1.45,531738,540176435
003410,쌍용양회,6230,6200,-30,-0.48,938438,5764177360
003415,쌍용양회우,5920,5910,-10,-0.17,32579,190628440
003620,쌍용차,5090,5110,20,0.39,129617,656792010
004770,써니전자,2795,2775,-20,-0.72,449915,1238977880
004920,씨아이테크,557,534,-23,-4.13,337807,180041674
112610,씨에스윈드,32450,32800,350,1.08,98592,3200236550
008700,아남전자,2710,2725,15,0.55,983633,2698391420
002790,아모레G,72400,70000,-2400,-3.31,160861,11216654700
002795,아모레G우,31000,30050,-950,-3.06,3983,120107100
090430,아모레퍼시픽,197500,188500,-9000,-4.56,285609,54082849000
090435,아모레퍼시픽우,105500,103000,-2500,-2.37,16211,1661801300
002030,아세아,125000,125000,0,0.0,1747,215470500
183190,아세아시멘트,110000,107500,-2500,-2.27,15552,1675010500
002310,아세아제지,34700,35700,1000,2.88,69409,2428674100
267850,아시아나IDT,16350,16450,100,0.61,20569,336064050
020560,아시아나항공,4145,4050,-95,-2.29,657660,2667985395
122900,아이마켓코리아,9390,9300,-90,-0.96,88275,826509590
010780,아이에스동서,31800,31800,0,0.0,31237,991563900
033660,아주캐피탈,9160,9270,110,1.2,53590,492925260
101140,아티스,4310,4310,0,0.0,138694,594948465
001780,알루코,2715,2740,25,0.92,140542,376967980
002250,알보젠코리아,28700,28750,50,0.17,4983,142800300
018250,애경산업,47450,48100,650,1.37,211747,10091217850
161000,애경유화,9110,9010,-100,-1.1,92546,834959820
011090,에넥스,1540,1495,-45,-2.92,1585204,2387411860
005850,에스엘,20700,21250,550,2.66,76782,1614377400
012750,에스원,96600,97600,1000,1.04,31676,3086356100
023960,에쓰씨엔지니어링,1830,1780,-50,-2.73,32277,58072530
298690,에어부산,4370,4360,-10,-0.23,152201,659659840
140910,에이리츠,5860,5910,50,0.85,23186,137207320
078520,에이블씨엔씨,15100,15200,100,0.66,386051,5702301550
015260,에이엔피,517,538,21,4.06,2763763,1504399338
007460,에이프로젠KIC,3000,2975,-25,-0.83,11520622,33725795285
003060,에이프로젠제약,2640,2550,-90,-3.41,704740,1810940505
036570,엔씨소프트,430500,435000,4500,1.05,58961,25736491500
138250,엔에스쇼핑,12500,12000,-500,-4.0,66489,803776050
085310,엔케이,1900,1910,10,0.53,576173,1096187945
009810,엔케이물산,934,951,17,1.82,2563150,2372796551
900140,엘브이엠씨홀딩스,2755,2620,-135,-4.9,212418,557950460
014440,영보화학,3895,3920,25,0.64,16026,62159270
111770,영원무역,31150,31400,250,0.8,201072,6268176850
009970,영원무역홀딩스,68000,68200,200,0.29,3658,244947200
003520,영진약품,7090,7090,0,0.0,886295,6202105040
000670,영풍,815000,819000,4000,0.49,1301,1061410000
006740,영풍제지,3500,3570,70,2.0,41293,144625665
012280,영화금속,1430,1435,5,0.35,327516,465561875
012160,영흥철강,1275,1275,0,0.0,472034,593362635
015360,예스코홀딩스,41050,41050,0,0.0,782,32029700
007310,오뚜기,761000,765000,4000,0.53,6074,4663395000
079440,오렌지라이프,35250,35700,450,1.28,104882,3733066000
002630,오리엔트바이오,552,543,-9,-1.63,1630605,888122817
271560,오리온,103000,105500,2500,2.43,156146,16406756500
001800,오리온홀딩스,19450,19600,150,0.77,70200,1371021475
070960,용평리조트,7340,7300,-40,-0.54,733380,5342240760
316140,우리금융지주,14000,14150,150,1.07,663971,9352211650
004720,우리들제약,8550,9210,660,7.72,1075904,9752350180
118000,우리들휴브레인,2520,2575,55,2.18,163550,421574105
010050,우리종금,759,753,-6,-0.79,1255641,945402891
006980,우성사료,2525,2485,-40,-1.58,71682,179270860
017370,우신시스템,6310,6400,90,1.43,5345,33454180
105840,우진,4910,4800,-110,-2.24,188774,908703255
010400,우진아이엔에스,10600,10400,-200,-1.89,51816,537555200
049800,우진플라임,5880,5540,-340,-5.78,134658,758629920
016880,웅진,2540,2710,170,6.69,6306072,17099249965
095720,웅진씽크빅,3155,3720,565,17.91,15011832,53622373555
103130,웅진에너지,1685,1690,5,0.3,167463,284063555
005820,원림,18150,18050,-100,-0.55,1390,24976900
010600,웰바이오텍,4850,4860,10,0.21,267470,1287211955
008600,윌비스,1425,1370,-55,-3.86,789878,1091224420
033270,유나이티드제약,26550,26650,100,0.38,50367,1318398800
014830,유니드,46800,50100,3300,7.05,46556,2279194650
000910,유니온,4025,4065,40,0.99,82730,330868900
047400,유니온머티리얼,1900,1875,-25,-1.32,65363,122435005
011330,유니켐,1805,1865,60,3.32,6981285,11440252265
077500,유니퀘스트,6950,6990,40,0.58,57751,401434720
002920,유성기업,2835,2845,10,0.35,5499,15540350
000700,유수홀딩스,8020,7830,-190,-2.37,60817,478056410
003470,유안타증권,3185,3165,-20,-0.63,173274,546385455
003475,유안타증권우,2185,2140,-45,-2.06,11754,25192540
011690,유양디앤유,7800,8440,640,8.21,1430459,11675169830
072130,유엔젤,4250,4110,-140,-3.29,48633,201652555
000220,유유제약,12600,12600,0,0.0,60176,752815200
000225,유유제약1우,7300,7180,-120,-1.64,1808,12993760
000227,유유제약2우B,18550,18200,-350,-1.89,93,1709850
001200,유진투자증권,2600,2600,0,0.0,117498,302377520
000100,유한양행,256000,261000,5000,1.95,49084,12713200500
000105,유한양행우,215500,216500,1000,0.46,159,34069500
003460,유화증권,12850,12800,-50,-0.39,1056,13572950
003465,유화증권우,12600,12600,0,0.0,802,10136300
008730,율촌화학,13600,13600,0,0.0,50470,675671150
008250,이건산업,10100,10050,-50,-0.5,128462,1289622120
025820,이구산업,1990,1920,-70,-3.52,95885,186155660
214320,이노션,70500,70900,400,0.57,22913,1612552400
088260,이리츠코크렙,4800,4800,0,0.0,77309,370782180
139480,이마트,176000,176000,0,0.0,78655,13755730000
007660,이수페타시스,5100,5000,-100,-1.96,952855,4728918210
005950,이수화학,9920,9800,-120,-1.21,21471,210322710
015020,이스타코,693,703,10,1.44,113553,77206589
093230,이아이디,194,192,-2,-1.03,396461,75694357
102460,이연제약,18300,18100,-200,-1.09,51511,932858750
084680,이월드,2130,2110,-20,-0.94,312233,656589375
000760,이화산업,20000,19750,-250,-1.25,4322,85383700
014990,인디에프,2300,2295,-5,-0.22,443139,1003581510
006490,인스코비,5870,5800,-70,-1.19,605263,3465169840
023800,인지컨트롤스,7580,7510,-70,-0.92,156300,1179385680
034590,인천도시가스,29300,29250,-50,-0.17,1010,29467850
129260,인터지스,2470,2440,-30,-1.21,48975,118484955
023810,인팩,4310,4210,-100,-2.32,27242,115190070
249420,일동제약,21800,21950,150,0.69,121585,2668692600
000230,일동홀딩스,13100,13000,-100,-0.76,1320,17166150
013360,일성건설,1455,1380,-75,-5.15,796149,1117607895
003120,일성신약,93900,93700,-200,-0.21,178,16662000
003200,일신방직,97900,97300,-600,-0.61,962,93588400
007110,일신석재,2230,2235,5,0.22,3191698,7101671225
007570,일양약품,30800,30600,-200,-0.65,30122,917033550
007575,일양약품우,19500,19000,-500,-2.56,323,6230400
008500,일정실업,21550,22150,600,2.78,3776,84227800
081000,일진다이아,36250,35050,-1200,-3.31,195054,6907765050
020760,일진디스플,3800,3755,-45,-1.18,32662,124169380
020150,일진머티리얼즈,39200,39300,100,0.26,302276,11668645600
103590,일진전기,3670,3600,-70,-1.91,38074,135906215
015860,일진홀딩스,3830,3770,-60,-1.57,97997,366829975
226320,잇츠한불,32650,32200,-450,-1.38,86448,2774444050
033240,자화전자,12700,12700,0,0.0,69043,873455750
000950,전방,17950,17900,-50,-0.28,376,6691200
194370,제이에스코퍼레이션,14550,14300,-250,-1.72,53572,744098400
025620,제이준코스메틱,11450,10600,-850,-7.42,1291457,13783570600
030000,제일기획,23300,23450,150,0.64,333664,7755698550
271980,제일약품,47100,46800,-300,-0.64,28197,1306803250
001560,제일연마,6460,6410,-50,-0.77,975,6221830
002620,제일파마홀딩스,26350,26700,350,1.33,11097,295223900
006220,제주은행,4765,4755,-10,-0.21,11072,52449115
089590,제주항공,38000,38400,400,1.05,102472,3872590450
004910,조광페인트,7160,7080,-80,-1.12,17779,124936380
004700,조광피혁,36800,37150,350,0.95,1651,60837200
001550,조비,21200,21350,150,0.71,36136,763820200
000480,조선내화,83300,83200,-100,-0.12,441,36585000
120030,조선선재,84800,83400,-1400,-1.65,2853,237636100
018470,조일알미늄,958,930,-28,-2.92,105048,97941343
002600,조흥,195500,194000,-1500,-0.77,45,8632500
185750,종근당,104500,106000,1500,1.44,23358,2448154500
063160,종근당바이오,22850,22800,-50,-0.22,8640,196230650
001630,종근당홀딩스,67900,69200,1300,1.91,7052,481236500
044380,주연테크,453,442,-11,-2.43,848969,376509528
013870,지엠비코리아,8530,7990,-540,-6.33,592503,4796213840
071320,지역난방공사,60500,62700,2200,3.64,29042,1798944400
010580,지코,785,773,-12,-1.53,350528,271819171
035000,지투알,8180,8110,-70,-0.86,11647,94128370
088790,진도,4630,4595,-35,-0.76,7188,32949680
003780,진양산업,3585,3615,30,0.84,99620,357856395
010640,진양폴리,2260,2180,-80,-3.54,72338,157895135
100250,진양홀딩스,2590,2570,-20,-0.77,34426,88763440
051630,진양화학,4570,4535,-35,-0.77,64900,292214175
272450,진에어,22300,22200,-100,-0.45,268601,5989650300
011000,진원생명과학,5000,4900,-100,-2.0,129361,631807175
002780,진흥기업,1960,2005,45,2.3,77179,153536365
002787,진흥기업2우B,10700,10750,50,0.47,6841,72066950
002785,진흥기업우B,4240,4295,55,1.3,7799,33210435
009310,참엔지니어링,1635,1590,-45,-2.75,192235,302012245
000650,천일고속,77200,77200,0,0.0,277,21298600
012600,청호컴넷,2630,2590,-40,-1.52,9726,25421870
033250,체시스,923,904,-19,-2.06,114310,103590494
035720,카카오,107500,106000,-1500,-1.4,276026,29311620000
006380,카프로,4800,4680,-120,-2.5,217406,1019837490
109070,컨버즈,3920,3850,-70,-1.79,98099,374637630
029460,케이씨,13450,13700,250,1.86,87482,1174791300
281820,케이씨텍,14650,15550,900,6.14,139149,2122622200
145270,케이탑리츠,965,955,-10,-1.04,326609,311935766
058860,케이티스,2700,2700,0,0.0,98713,263661335
007815,코리아써우,2715,2745,30,1.1,708,1931645
007810,코리아써키트,5900,6000,100,1.69,27194,159774950
00781K,코리아써키트2우B,4125,4035,-90,-2.18,341,1382335
152330,코리아오토글라스,14700,14500,-200,-1.36,37856,549317250
003690,코리안리,9290,9330,40,0.43,112058,1042795940
192820,코스맥스,146000,145500,-500,-0.34,42640,6152779500
044820,코스맥스비티아이,25200,25100,-100,-0.4,33721,833202300
005070,코스모신소재,16550,16600,50,0.3,513101,8255862550
005420,코스모화학,16100,15800,-300,-1.86,339880,5242758500
071950,코아스,1370,1325,-45,-3.28,304724,406523610
002020,코오롱,33450,33300,-150,-0.45,13391,439700500
003070,코오롱글로벌,8290,8290,0,0.0,31838,257187650
003075,코오롱글로벌우,13550,13450,-100,-0.74,598,8100150
144620,코오롱머티리얼,2860,2760,-100,-3.5,244710,679172970
002025,코오롱우,17700,17200,-500,-2.82,1323,22460050
120110,코오롱인더,51200,50900,-300,-0.59,72630,3686012300
120115,코오롱인더우,22400,22200,-200,-0.89,3294,73072100
138490,코오롱플라스틱,6350,6330,-20,-0.31,37455,235512720
021240,코웨이,90800,92600,1800,1.98,991683,90573938600
031820,콤텍시스템,1465,1505,40,2.73,703563,1050910220
192400,쿠쿠홀딩스,153500,157500,4000,2.61,6478,1007873000
284740,쿠쿠홈시스,193000,198000,5000,2.59,1889,367539000
015590,큐로,627,618,-9,-1.44,1269186,796821414
264900,크라운제과,10400,10800,400,3.85,13527,139317050
26490K,크라운제과우,8060,8040,-20,-0.25,1253,10032270
005740,크라운해태홀딩스,12200,12050,-150,-1.23,51180,615551950
005745,크라운해태홀딩스우,11950,11900,-50,-0.42,4531,53383550
020120,키다리스튜디오,2705,2645,-60,-2.22,27087,72058485
039490,키움증권,78200,78700,500,0.64,49840,3877284300
012170,키위미디어그룹,339,328,-11,-3.24,1797299,585236514
015890,태경산업,5550,5600,50,0.9,134904,740679560
006890,태경화학,5820,5540,-280,-4.81,519346,2922650580
003240,태광산업,1512000,1523000,11000,0.73,853,1287170000
011280,태림포장,4810,4590,-220,-4.57,338216,1560200030
004100,태양금속,1440,1415,-25,-1.74,263087,367925080
004105,태양금속우,3360,3410,50,1.49,24700,82456700
009410,태영건설,11900,11900,0,0.0,184833,2171671200
009415,태영건설우,5700,5700,0,0.0,7991,44882940
001420,태원물산,5470,5540,70,1.28,48661,259306950
007980,태평양물산,2630,2540,-90,-3.42,180731,460328670
055490,테이팩스,19600,19300,-300,-1.53,19995,383332700
078000,텔코웨어,14350,14350,0,0.0,31221,443124850
214420,토니모리,13900,13200,-700,-5.04,191279,2539651900
140890,트러스제7호,3450,3440,-10,-0.29,3681,12685510
019180,티에이치엔,2650,2475,-175,-6.6,287758,725497435
091810,티웨이항공,8560,8270,-290,-3.39,345937,2885799980
004870,티웨이홀딩스,2525,2470,-55,-2.18,323339,799296075
005690,파미셀,13300,13350,50,0.38,1481633,19287570250
036580,팜스코,7640,7540,-100,-1.31,41032,310026550
028670,팬오션,4155,4030,-125,-3.01,1929473,7794186810
010820,퍼스텍,2945,2865,-80,-2.72,526018,1526025040
016800,퍼시스,32200,32250,50,0.16,3987,127722250
001020,페이퍼코리아,898,929,31,3.45,118993,108371906
090080,평화산업,2310,2175,-135,-5.84,530716,1170329325
010770,평화홀딩스,6470,6000,-470,-7.26,219047,1332937880
058430,포스코강판,21650,21350,-300,-1.39,5785,121912350
047050,포스코대우,18350,18300,-50,-0.27,144644,2626155100
007630,폴루스바이오팜,3890,3940,50,1.29,964547,3815896700
017810,풀무원,95100,96000,900,0.95,6730,642461300
103140,풍산,29850,29850,0,0.0,138819,4084115200
005810,풍산홀딩스,40000,40050,50,0.13,2895,114367900
033180,필룩스,11800,12250,450,3.81,1770516,21339091950
086790,하나금융지주,36800,37750,950,2.58,847824,32017885748
099340,하나니켈1호,855,842,-13,-1.52,240394,201666372
099350,하나니켈2호,1260,1225,-35,-2.78,67418,82946265
293480,하나제약,26400,27000,600,2.27,361756,9959061050
039130,하나투어,70400,71200,800,1.14,129666,9094187500
172580,하이골드12호,2890,2895,5,0.17,6759,19513145
153360,하이골드3호,1870,1870,0,0.0,2052,3837330
159650,하이골드8호,1385,1390,5,0.36,4531,6204770
071090,하이스틸,23650,23100,-550,-2.33,14618,336530900
019490,하이트론,3835,3840,5,0.13,1109,4205695
000080,하이트진로,18200,18200,0,0.0,159447,2882875100
000087,하이트진로2우B,14700,14700,0,0.0,1002,14685850
000140,하이트진로홀딩스,7870,7880,10,0.13,5653,44121600
000145,하이트진로홀딩스우,8280,8220,-60,-0.72,24,198190
152550,한국ANKOR유전,1700,1715,15,0.88,45530,77411690
036460,한국가스공사,50200,49700,-500,-1.0,84994,4221519150
005430,한국공항,43900,42950,-950,-2.16,6276,266899000
071050,한국금융지주,61200,60600,-600,-0.98,145903,8784626900
071055,한국금융지주우,36250,36250,0,0.0,3536,127408950
010040,한국내화,6050,6040,-10,-0.17,433779,2607806270
025540,한국단자,56300,57600,1300,2.31,18067,1025194200
004090,한국석유,127500,123500,-4000,-3.14,6953,856135000
002960,한국쉘석유,329500,329000,-500,-0.15,895,294338000
123890,한국자산신탁,4190,4220,30,0.72,42471,177329465
015760,한국전력,34650,35000,350,1.01,730542,25491599800
006200,한국전자홀딩스,825,818,-7,-0.85,69936,56808751
002300,한국제지,18950,18800,-150,-0.79,3771,70836750
023350,한국종합기술,5130,5170,40,0.78,48120,248124530
025890,한국주강,1920,1850,-70,-3.65,42744,79054785
000970,한국주철관,10050,10400,350,3.48,81898,835216780
104700,한국철강,6030,6110,80,1.33,23817,144109350
017960,한국카본,8300,8440,140,1.69,390695,3274697900
161890,한국콜마,77400,78000,600,0.78,69458,5371882400
024720,한국콜마홀딩스,38250,37950,-300,-0.78,62391,2340373650
161390,한국타이어,41450,42700,1250,3.02,153644,6536065100
000240,한국타이어월드와이드,16000,16200,200,1.25,46518,748878600
034830,한국토지신탁,2490,2550,60,2.41,234239,590926440
007280,한국특수형강,2005,1960,-45,-2.24,86613,170988710
168490,한국패러랠,2450,2445,-5,-0.2,13864,33845980
010100,한국프랜지,1635,1585,-50,-3.06,45698,73137265
047810,한국항공우주,36650,36700,50,0.14,511064,18438500800
123690,한국화장품,12200,12200,0,0.0,142066,1709643200
003350,한국화장품제조,37450,36700,-750,-2.0,30692,1118138900
011500,한농화성,4075,4065,-10,-0.25,6741,27280625
002390,한독,31000,31200,200,0.65,162974,4998687400
014790,한라,4090,4100,10,0.24,117659,477867795
060980,한라홀딩스,42200,41800,-400,-0.95,11486,480128500
053690,한미글로벌,11300,11450,150,1.33,135585,1528767700
042700,한미반도체,7880,7980,100,1.27,77046,608202220
008930,한미사이언스,81600,80200,-1400,-1.72,45313,3605424100
128940,한미약품,482500,479000,-3500,-0.73,28958,13807487000
009240,한샘,89800,90400,600,0.67,116164,10472079600
020000,한섬,38950,38400,-550,-1.41,45253,1741189900
003680,한성기업,6160,6110,-50,-0.81,11071,67505740
105630,한세실업,24850,24950,100,0.4,134790,3338724550
069640,한세엠케이,7370,7200,-170,-2.31,20997,151758020
016450,한세예스24홀딩스,8700,8610,-90,-1.03,51818,441311680
010420,한솔PNS,1425,1375,-50,-3.51,191412,264224460
009180,한솔로지스틱스,1430,1400,-30,-2.1,182172,254358385
213500,한솔제지,17900,18050,150,0.84,87714,1577796200
014680,한솔케미칼,87000,87800,800,0.92,39701,3423360000
004710,한솔테크닉스,7160,7330,170,2.37,100602,720989740
004150,한솔홀딩스,4760,4760,0,0.0,90792,429062855
025750,한솔홈데코,1395,1410,15,1.08,624093,865183440
004960,한신공영,18000,17650,-350,-1.94,29128,516849100
011700,한신기계,2465,2425,-40,-1.62,135557,326154975
001750,한양증권,6880,6820,-60,-0.87,11367,77208900
001755,한양증권우,7720,7760,40,0.52,355,2728820
018880,한온시스템,11750,12100,350,2.98,721702,8615499950
009420,한올바이오파마,35950,36400,450,1.25,329065,11794040650
014130,한익스프레스,4810,4865,55,1.14,21375,102406980
300720,한일시멘트,133500,130000,-3500,-2.62,5441,710967500
002220,한일철강,21400,20750,-650,-3.04,3798,79306400
006390,한일현대시멘트,39650,39500,-150,-0.38,38722,1516288400
003300,한일홀딩스,54000,53600,-400,-0.74,7361,395144400
051600,한전KPS,35850,35850,0,0.0,97009,3443201050
052690,한전기술,27650,27050,-600,-2.17,102283,2768479050
130660,한전산업,3835,3810,-25,-0.65,54423,206121365
002320,한진,37800,39150,1350,3.57,180210,6922162400
097230,한진중공업,1190,1190,0,0.0,0,0
003480,한진중공업홀딩스,4245,4490,245,5.77,259345,1150878455
180640,한진칼,27500,26850,-650,-2.36,337821,9058396100
18064K,한진칼우,18250,17950,-300,-1.64,13231,239279850
005110,한창,2830,2810,-20,-0.71,8183478,23180753730
009460,한창제지,2795,2810,15,0.54,2452175,6851437080
000880,한화,30950,30850,-100,-0.32,112681,3457025400
00088K,한화3우B,15050,15000,-50,-0.33,15156,227436800
027390,한화갤러리아타임월드,36500,36600,100,0.27,123396,4518858650
088350,한화생명,4010,4005,-5,-0.12,913383,3655045930
000370,한화손해보험,5600,5490,-110,-1.96,224811,1232594400
012450,한화에어로스페이스,32500,32750,250,0.77,153631,4993806850
000885,한화우,19750,19750,0,0.0,2694,52499700
009830,한화케미칼,22550,22700,150,0.67,359092,8117113050
009835,한화케미칼우,11700,11700,0,0.0,4124,47782700
003530,한화투자증권,2250,2245,-5,-0.22,129914,290211535
003535,한화투자증권우,2230,2225,-5,-0.22,4773,10518870
195870,해성디에스,14100,13750,-350,-2.48,64590,890678900
101530,해태제과식품,11300,11300,0,0.0,20649,228749750
143210,핸즈코퍼레이션,6780,6780,0,0.0,3724,25013970
000720,현대건설,51100,51100,0,0.0,727591,36737964350
267270,현대건설기계,53000,50700,-2300,-4.34,242123,12222783050
000725,현대건설우,166000,164000,-2000,-1.2,6759,1098725000
005440,현대그린푸드,14300,14350,50,0.35,103761,1489809550
086280,현대글로비스,133000,131000,-2000,-1.5,86227,11261125500
064350,현대로템,21950,21900,-50,-0.23,1012947,22151740150
079430,현대리바트,21500,21600,100,0.47,47703,1026402550
012330,현대모비스,204000,205500,1500,0.74,119911,24510216500
010620,현대미포조선,57000,57300,300,0.53,174462,9970371400
069960,현대백화점,96800,97400,600,0.62,61998,6012472500
004560,현대비앤지스틸,10250,10250,0,0.0,38623,390668370
004565,현대비앤지스틸우,63200,60800,-2400,-3.8,3002,185042200
011760,현대상사,24300,24550,250,1.03,118529,2888786100
011200,현대상선,3725,3755,30,0.81,1015540,3762074840
004310,현대약품,4930,4970,40,0.81,258391,1270292980
126560,현대에이치씨엔,4270,4200,-70,-1.64,35733,149286525
017800,현대엘리베이,82300,82200,-100,-0.12,465728,38231128300
011210,현대위아,43250,42200,-1050,-2.43,94302,3993348550
267260,현대일렉트릭,28850,28500,-350,-1.21,67258,1895318400
004020,현대제철,46050,46000,-50,-0.11,256970,11729187150
009540,현대중공업,125500,125500,0,0.0,177968,22148300500
267250,현대중공업지주,347000,346000,-1000,-0.29,21421,7378736000
005380,현대차,120000,121000,1000,0.83,281873,33948856000
005387,현대차2우B,77800,77600,-200,-0.26,85461,6665456000
005389,현대차3우B,67500,67600,100,0.15,1623,108741400
005385,현대차우,71700,70400,-1300,-1.81,74714,5261667400
001500,현대차증권,9500,9560,60,0.63,35416,334659010
227840,현대코퍼레이션홀딩스,14700,14750,50,0.34,46873,686098400
001450,현대해상,36750,37300,550,1.5,145053,5404482650
057050,현대홈쇼핑,109000,113500,4500,4.13,48715,5518166154
093240,형지엘리트,1800,1730,-70,-3.89,617831,1069386725
003010,혜인,5710,5680,-30,-0.53,181390,1019813840
111110,호전실업,11300,11450,150,1.33,7445,83903650
008770,호텔신라,84700,84000,-700,-0.83,642378,53837721900
008775,호텔신라우,47800,47200,-600,-1.26,5142,243869750
002460,화성산업,14300,14350,50,0.35,13173,188208750
013520,화승알앤에이,2200,2325,125,5.68,340835,776864145
241590,화승엔터프라이즈,11250,11250,0,0.0,165826,1878929400
006060,화승인더,7930,7950,20,0.25,158014,1246363780
010690,화신,2535,2485,-50,-1.97,30320,73892665
133820,화인베스틸,3080,3140,60,1.95,529389,1669610665
010660,화천기계,21450,21550,100,0.47,2525,53963050
000850,화천기공,43150,42950,-200,-0.46,967,41418900
016580,환인제약,18500,18550,50,0.27,16420,303131000
032560,황금에스티,9900,9680,-220,-2.22,57455,553881710
004800,효성,75900,76500,600,0.79,120026,9097679700
094280,효성ITX,10650,10500,-150,-1.41,8326,87297700
298040,효성중공업,41000,41100,100,0.24,30876,1265353750
298050,효성첨단소재,117000,116500,-500,-0.43,12593,1462135500
298020,효성티앤씨,164500,164500,0,0.0,8928,1448324000
298000,효성화학,146500,147000,500,0.34,17655,2561379500
093370,후성,8020,8000,-20,-0.25,457193,3620978380
081660,휠라코리아,62000,62400,400,0.65,361234,22453213800
005870,휴니드,9660,9150,-510,-5.28,76474,707577620
079980,휴비스,7450,7370,-80,-1.07,74211,543330170
005010,휴스틸,11850,11850,0,0.0,17726,206121700
069260,휴켐스,20300,20000,-300,-1.48,131557,2626681750
000540,흥국화재,4990,5000,10,0.2,130359,660716935
000547,흥국화재2우B,24500,24450,-50,-0.2,457,11201500
000545,흥국화재우,5490,5450,-40,-0.73,4814,26718770
003280,흥아해운,383,378,-5,-1.31,722328,277123230
