티커,종목명,시가,종가,변동폭,등락률,거래량,거래대금
095570,AJ네트웍스,4890,4885,-5,-0.1,23745,115279325
068400,AJ렌터카,11850,11600,-250,-2.11,88792,1034842050
006840,AK홀딩스,56100,54100,-2000,-3.57,19711,1083736600
027410,BGF,8510,8280,-230,-2.7,236301,1968950600
282330,BGF리테일,219500,215000,-4500,-2.05,26656,5730304000
138930,BNK금융지주,7110,7020,-90,-1.27,860215,6072451630
001460,BYC,237500,261500,24000,10.11,19926,5261360000
001465,BYC우,114000,148000,34000,29.82,8145,1184605500
001040,CJ,131000,128500,-2500,-1.91,54018,6957319000
079160,CJCGV,47450,46150,-1300,-2.74,151791,7047173150
000120,CJ대한통운,176500,173000,-3500,-1.98,61380,10706224500
011150,CJ씨푸드,2335,2320,-15,-0.64,67446,156378705
011155,CJ씨푸드1우,27550,28050,500,1.81,3194,89614500
001045,CJ우,59500,58500,-1000,-1.68,4682,275026900
097950,CJ제일제당,330000,328000,-2000,-0.61,22790,7479520000
097955,CJ제일제당우,139000,138500,-500,-0.36,2179,300967000
037560,CJ헬로,9660,9550,-110,-1.14,195742,1874536770
000590,CS홀딩스,62200,63000,800,1.29,172,10696300
012030,DB,916,889,-27,-2.95,739836,666510531
016610,DB금융투자,5020,5000,-20,-0.4,83458,416061500
005830,DB손해보험,72900,70600,-2300,-3.16,132041,9355617700
000990,DB하이텍,12700,13000,300,2.36,1049953,13919074900
000995,DB하이텍1우,35500,36800,1300,3.66,2128,78036850
139130,DGB금융지주,8660,8630,-30,-0.35,623678,5405649660
004840,DRB동일,6680,6670,-10,-0.15,16218,107792880
155660,DSR,4850,4845,-5,-0.1,37918,183317740
069730,DSR제강,5440,5320,-120,-2.21,384497,2100731570
017940,E1,65600,64500,-1100,-1.68,28715,1875327100
007700,FF,79300,76300,-3000,-3.78,171037,13133180000
114090,GKL,23200,22600,-600,-2.59,225039,5118567750
078930,GS,53900,53600,-300,-0.56,111303,5974540800
006360,GS건설,44000,42600,-1400,-3.18,646074,27686751600
001250,GS글로벌,2715,2700,-15,-0.55,144506,391088665
007070,GS리테일,38550,37850,-700,-1.82,97171,3695830500
078935,GS우,36800,37000,200,0.54,1810,66937200
012630,HDC,20800,19750,-1050,-5.05,521886,10455833400
039570,HDC아이콘트롤스,10500,10400,-100,-0.95,26565,275117400
089470,HDC현대EP,4625,4620,-5,-0.11,18166,84468170
294870,HDC현대산업개발,51100,49500,-1600,-3.13,148631,7373486700
082740,HSD엔진,5090,5040,-50,-0.98,246194,1224524665
003560,IHQ,2180,2070,-110,-5.05,2284590,4797829840
175330,JB금융지주,5860,5830,-30,-0.51,222029,1300138650
234080,JW생명과학,24900,24700,-200,-0.8,48677,1208796700
001060,JW중외제약,41550,40250,-1300,-3.13,99963,4069514700
001067,JW중외제약2우B,44000,43450,-550,-1.25,1817,79419650
001065,JW중외제약우,27250,27150,-100,-0.37,5404,148363500
096760,JW홀딩스,7220,7000,-220,-3.05,131296,932027380
105560,KB금융,43500,43000,-500,-1.15,1825661,78658819650
002380,KCC,320000,317000,-3000,-0.94,25134,7984976500
009070,KCTC,3170,3175,5,0.16,186552,593985785
009440,KC그린홀딩스,4970,5000,30,0.6,179704,888906050
119650,KC코트렐,6710,6790,80,1.19,922188,6087909460
092220,KEC,1155,1135,-20,-1.73,745187,853459235
001390,KG케미칼,16100,16000,-100,-0.62,100934,1626394550
001940,KISCO홀딩스,13400,13600,200,1.49,9698,129426400
025000,KPX케미칼,55800,55200,-600,-1.08,7418,407892800
092230,KPX홀딩스,61200,60500,-700,-1.14,840,51007900
000040,KR모터스,474,464,-10,-2.11,109730,51877713
044450,KSS해운,7280,7250,-30,-0.41,43561,316057790
030200,KT,28150,27950,-200,-0.71,358356,10062468100
033780,KTG,107500,105500,-2000,-1.86,343007,36142620500
030210,KTB투자증권,3095,3065,-30,-0.97,152130,471717050
058850,KTcs,2410,2395,-15,-0.62,143155,342172110
093050,LF,24950,24400,-550,-2.2,59959,1473616400
003550,LG,77700,77500,-200,-0.26,174987,13519903500
034220,LG디스플레이,20500,20800,300,1.46,1858039,38733360000
001120,LG상사,17400,17450,50,0.29,175708,3093415550
051900,LG생활건강,1416000,1390000,-26000,-1.84,43683,60807682000
051905,LG생활건강우,840000,836000,-4000,-0.48,1266,1053423000
003555,LG우,44350,44600,250,0.56,1353,60136100
032640,LG유플러스,15000,14750,-250,-1.67,1299754,19285171000
011070,LG이노텍,99500,109000,9500,9.55,485145,51502733837
066570,LG전자,77400,74100,-3300,-4.26,1570980,117537055640
066575,LG전자우,30500,30150,-350,-1.15,29018,874060550
108670,LG하우시스,64500,63100,-1400,-2.17,28178,1786343800
108675,LG하우시스우,31550,31500,-50,-0.16,764,23878450
051910,LG화학,363000,382000,19000,5.23,422078,159970605500
051915,LG화학우,201500,212000,10500,5.21,27069,5666238000
079550,LIG넥스원,36700,36000,-700,-1.91,140861,5097486650
006260,LS,55500,54300,-1200,-2.16,82936,4544227600
000680,LS네트웍스,3315,3200,-115,-3.47,204931,663254940
010120,LS산전,48550,48050,-500,-1.03,103311,4993431600
229640,LS전선아시아,6040,6040,0,0.0,18495,111258840
023150,MH에탄올,6520,6480,-40,-0.61,5146,33258380
035420,NAVER,128500,128000,-500,-0.39,399492,51357230000
181710,NHN엔터테인먼트,88300,86000,-2300,-2.6,198566,16854975700
005940,NH투자증권,13250,13350,100,0.75,877444,11704567258
005945,NH투자증권우,8770,8780,10,0.11,40117,351393810
034310,NICE,19700,19350,-350,-1.78,29178,568062150
008260,NI스틸,2605,2575,-30,-1.15,42060,108881795
004250,NPC,4015,4015,0,0.0,11267,45173475
004255,NPC우,2210,2195,-15,-0.68,3825,8261475
010060,OCI,99400,99600,200,0.2,99681,9955527900
005490,POSCO,256500,258000,1500,0.58,271792,70233848000
100840,STC,12450,12200,-250,-2.01,9938,122679650
064960,ST모티브,40450,39350,-1100,-2.72,68284,2709820500
003570,ST중공업,7460,7520,60,0.8,6958,52232250
036530,ST홀딩스,13900,13800,-100,-0.72,2061,28482450
010950,S-Oil,96600,97200,600,0.62,304909,29620854700
010955,S-Oil우,64000,64400,400,0.63,10801,694457300
034120,SBS,24900,24650,-250,-1.0,81094,1994351450
101060,SBS미디어홀딩스,2140,2130,-10,-0.47,51297,110107865
004060,SG세계물산,795,785,-10,-1.26,315332,246948297
001380,SG충방,2530,2450,-80,-3.16,398339,984136940
002360,SH에너지화학,1095,1085,-10,-0.91,390050,423393205
009160,SIMPAC,2710,2610,-100,-3.69,178963,470812300
123700,SJM,3310,3300,-10,-0.3,4537,14936315
025530,SJM홀딩스,3190,3190,0,0.0,8889,28231690
034730,SK,280500,278000,-2500,-0.89,135176,37753841500
011790,SKC,37100,36300,-800,-2.16,112484,4109579250
018670,SK가스,92000,91000,-1000,-1.09,19896,1811006000
001740,SK네트웍스,6360,6170,-190,-2.99,1390553,8705455180
001745,SK네트웍스우,54600,56200,1600,2.93,1100,61517900
006120,SK디스커버리,28450,27850,-600,-2.11,61548,1725815600
006125,SK디스커버리우,16400,16050,-350,-2.13,910,14652950
210980,SK디앤디,31550,31750,200,0.63,11872,376005000
03473K,SK우,148500,149500,1000,0.67,1219,180538500
096770,SK이노베이션,195500,195000,-500,-0.26,205354,40172022000
096775,SK이노베이션우,130500,130500,0,0.0,3933,514693500
001510,SK증권,701,704,3,0.43,3345614,2377812233
001515,SK증권우,3240,3315,75,2.31,1125291,3993446905
285130,SK케미칼,71900,70200,-1700,-2.36,29656,2095231400
28513K,SK케미칼우,25450,25000,-450,-1.77,2970,73774250
017670,SK텔레콤,251000,249500,-1500,-0.6,126455,31617670000
000660,SK하이닉스,70500,75900,5400,7.66,10030131,747350585250
005610,SPC삼립,126500,127000,500,0.4,10059,1275255500
011810,STX,16200,16200,0,0.0,15999,257240450
077970,STX엔진,7100,7110,10,0.14,9464,67512360
071970,STX중공업,6310,6180,-130,-2.06,154045,968523090
084870,TBH글로벌,2405,2300,-105,-4.37,373764,861793730
002710,TCC동양,2495,2610,115,4.61,570068,1486265600
024070,WISCOM,2700,2690,-10,-0.37,5826,15710790
037270,YGPLUS,1950,1880,-70,-3.59,614706,1152627165
000500,가온전선,18100,17800,-300,-1.66,4555,81288400
000860,강남제비스코,28750,28100,-650,-2.26,14554,409744700
035250,강원랜드,32650,32100,-550,-1.68,425402,13714339325
011420,갤럭시아에스엠,1500,1465,-35,-2.33,110955,166666855
002100,경농,14200,13700,-500,-3.52,257892,3561626150
009450,경동나비엔,58800,56200,-2600,-4.42,225025,12798481300
267290,경동도시가스,35050,35300,250,0.71,16098,563005300
012320,경동인베스트,40000,40350,350,0.88,6572,265659400
000050,경방,10700,10700,0,0.0,19192,205176550
214390,경보제약,10800,10800,0,0.0,51938,561895750
012610,경인양행,6170,6120,-50,-0.81,130277,801491570
009140,경인전자,30950,31400,450,1.45,4021,124589100
013580,계룡건설,23600,23100,-500,-2.12,7675,178256450
012200,계양전기,3640,3645,5,0.14,24321,88601960
012205,계양전기우,8000,8260,260,3.25,124294,1035451220
004200,고려개발,4790,4805,15,0.31,20226,95813890
002140,고려산업,2245,2230,-15,-0.67,149044,333297075
010130,고려아연,461500,459500,-2000,-0.43,30586,14026549500
002240,고려제강,26800,25700,-1100,-4.1,9685,252726000
001290,골든브릿지증권,2705,2695,-10,-0.37,84542,226819725
009290,광동제약,7450,7360,-90,-1.21,67222,497629310
017040,광명전기,2500,2475,-25,-1.0,123489,307017180
017900,광전자,2750,2790,40,1.45,2553677,7088027480
037710,광주신세계,194500,191500,-3000,-1.54,1046,199838500
030610,교보증권,9670,9650,-20,-0.21,85467,827001500
007690,국도화학,51800,50800,-1000,-1.93,6717,342025400
005320,국동,2695,2640,-55,-2.04,104895,277381520
001140,국보,23200,23000,-200,-0.86,280727,6661181700
002720,국제약품,4630,4555,-75,-1.62,93337,431215305
083420,그린케미칼,3605,3605,0,0.0,4195,15147200
014530,극동유화,3550,3490,-60,-1.69,112961,396302255
014280,금강공업,24250,24650,400,1.65,377446,9587103400
014285,금강공업우,90400,93000,2600,2.88,41612,3931961200
008870,금비,68900,69500,600,0.87,109,7563000
001570,금양,2375,2390,15,0.63,69029,164487555
002990,금호산업,12800,12350,-450,-3.52,180165,2222408200
002995,금호산업우,24850,25400,550,2.21,2217,56132300
011780,금호석유,95700,93500,-2200,-2.3,118744,11145406900
011785,금호석유우,33800,33400,-400,-1.18,725,24162350
214330,금호에이치티,6340,6210,-130,-2.05,168669,1034613760
001210,금호전기,5620,5580,-40,-0.71,15280,84750670
073240,금호타이어,4955,4870,-85,-1.72,518302,2535744735
092440,기신정기,3815,3835,20,0.52,7961,30466480
000270,기아차,34850,34200,-650,-1.87,761526,26105165200
024110,기업은행,14500,14350,-150,-1.03,770624,11072594200
013700,까뮤이앤씨,1340,1315,-25,-1.87,690335,924314375
004540,깨끗한나라,3150,3120,-30,-0.95,51303,159586490
004545,깨끗한나라우,19000,19250,250,1.32,22923,458282650
074610,나노메딕스,5750,5470,-280,-4.87,617983,3434131770
001260,남광토건,13450,13250,-200,-1.49,30700,409886250
008350,남선알미늄,2445,2420,-25,-1.02,6341501,15837249265
008355,남선알미우,24300,25000,700,2.88,39733,997354500
004270,남성,1810,1785,-25,-1.38,135164,242670500
003920,남양유업,645000,629000,-16000,-2.48,502,317956000
003925,남양유업우,212000,209500,-2500,-1.18,11,2309000
002070,남영비비안,6200,6170,-30,-0.48,2133,13162030
025860,남해화학,11100,10900,-200,-1.8,147840,1633483700
005720,넥센,6250,6380,130,2.08,31307,198542530
005725,넥센우,3780,3780,0,0.0,184,688225
002350,넥센타이어,10600,10500,-100,-0.94,89222,942473350
002355,넥센타이어1우B,3960,4000,40,1.01,84,335550
003580,넥스트사이언스,6180,6040,-140,-2.27,316099,1890313500
251270,넷마블,117500,115500,-2000,-1.7,128292,14990281500
090350,노루페인트,8220,8120,-100,-1.22,60746,494455870
090355,노루페인트우,10900,11450,550,5.05,382339,4688959800
000320,노루홀딩스,13150,13100,-50,-0.38,3121,40650700
000325,노루홀딩스우,18700,19000,300,1.6,25132,495850550
006280,녹십자,148000,146000,-2000,-1.35,26305,3858945000
005250,녹십자홀딩스,25150,24600,-550,-2.19,47755,1186011000
005257,녹십자홀딩스2우,18500,18550,50,0.27,2266,42014150
004370,농심,301000,294500,-6500,-2.16,17236,5077415500
072710,농심홀딩스,83700,83900,200,0.24,1009,85037700
058730,다스코,7430,7360,-70,-0.94,95072,703108430
023590,다우기술,22400,22900,500,2.23,155844,3554480550
019680,대교,6500,6430,-70,-1.08,72578,465822960
019685,대교우B,4425,4445,20,0.45,258,1145175
006370,대구백화점,8460,8280,-180,-2.13,40878,338171830
008060,대덕전자,9720,9790,70,0.72,265250,2616585540
00806K,대덕전자1우,5750,5780,30,0.52,1332,7692480
000490,대동공업,6080,5850,-230,-3.78,109625,648980770
008110,대동전자,3525,3530,5,0.14,3769,13257050
005750,대림BCo,5280,5210,-70,-1.33,19195,100325510
000210,대림산업,95800,93500,-2300,-2.4,110948,10462383000
000215,대림산업우,37750,37700,-50,-0.13,1518,57237050
004440,대림씨엔에스,10750,10900,150,1.4,15183,163714950
006570,대림통상,4180,4110,-70,-1.67,134,556620
001680,대상,29100,28300,-800,-2.75,163868,4700072900
001685,대상우,13350,13150,-200,-1.5,3108,40987000
084690,대상홀딩스,8790,8800,10,0.11,28377,247316350
084695,대상홀딩스우,6060,6050,-10,-0.17,113,684280
128820,대성산업,4950,5020,70,1.41,58195,289898825
117580,대성에너지,5420,5400,-20,-0.37,15222,81642060
016710,대성홀딩스,6670,6750,80,1.2,13849,93199390
003540,대신증권,11250,11350,100,0.89,108196,1221483350
003547,대신증권2우B,8190,8190,0,0.0,3737,30587320
003545,대신증권우,8710,8710,0,0.0,50074,435768260
009190,대양금속,4675,4685,10,0.21,10131,46975700
014160,대영포장,1245,1260,15,1.2,4945200,6270319785
047040,대우건설,5040,4975,-65,-1.29,734142,3679387735
009320,대우부품,2675,2540,-135,-5.05,2949247,7748454345
042660,대우조선해양,28550,28450,-100,-0.35,387510,10999096300
003090,대웅,20500,20150,-350,-1.71,107789,2170386150
069620,대웅제약,194000,185500,-8500,-4.38,76739,14385456500
000430,대원강업,4965,4945,-20,-0.4,151515,746646005
006340,대원전선,1490,1455,-35,-2.35,446615,657636535
006345,대원전선우,3370,3425,55,1.63,36071,124049730
003220,대원제약,17350,17100,-250,-1.44,46866,804757600
024890,대원화성,1725,1790,65,3.77,119798,210401515
002880,대유에이텍,1215,1165,-50,-4.12,2496610,2991632660
000300,대유플러스,945,943,-2,-0.21,310724,293168415
012800,대창,1000,992,-8,-0.8,299436,298108029
015230,대창단조,40350,40200,-150,-0.37,1808,72657600
001070,대한방직,14050,14100,50,0.36,8657,122455950
006650,대한유화,165000,164000,-1000,-0.61,27574,4530149000
001440,대한전선,1125,1110,-15,-1.33,336980,374568190
084010,대한제강,6190,6180,-10,-0.16,27065,166887270
001790,대한제당,21700,21550,-150,-0.69,873,18733900
001799,대한제당3우B,23450,24600,1150,4.9,3001,70842400
001795,대한제당우,12450,12350,-100,-0.8,10,123200
001130,대한제분,190500,189000,-1500,-0.79,2214,416942000
003490,대한항공,33450,32450,-1000,-2.99,691045,22493301750
003495,대한항공우,14200,13750,-450,-3.17,23472,325022450
005880,대한해운,22600,22300,-300,-1.33,68288,1520026800
003830,대한화섬,106000,107000,1000,0.94,743,79927000
016090,대현,2530,2510,-20,-0.79,130410,326902410
069460,대호에이엘,5420,5420,0,0.0,0,0
192080,더블유게임즈,61700,60500,-1200,-1.94,82676,5025748000
012510,더존비즈온,46000,45900,-100,-0.22,120335,5605134000
004830,덕성,3310,3230,-80,-2.42,19444,63331105
004835,덕성우,4070,4190,120,2.95,53554,223074830
024900,덕양산업,1390,1370,-20,-1.44,206043,284373920
145720,덴티움,64400,62300,-2100,-3.26,49921,3143420000
002150,도화엔지니어링,9630,9590,-40,-0.42,112809,1086673950
001620,동국실업,877,860,-17,-1.94,134940,115791982
001230,동국제강,8090,7950,-140,-1.73,270939,2170351180
023450,동남합성,25850,26350,500,1.93,3130,81695950
004140,동방,1680,1650,-30,-1.79,185791,308985080
007590,동방아그로,6940,6930,-10,-0.14,13438,93063220
005960,동부건설,8360,8280,-80,-0.96,25275,209279090
005965,동부건설우,16150,16650,500,3.1,1676,27656400
016380,동부제철,8330,8030,-300,-3.6,40190,325377210
016385,동부제철우,36700,36800,100,0.27,1310,47717400
083370,동북아12호,4980,4985,5,0.1,55,274985
083380,동북아13호,5010,5020,10,0.2,0,0
026960,동서,20050,19550,-500,-2.49,164235,3232723150
002210,동성제약,17250,17000,-250,-1.45,244682,4183409100
102260,동성코퍼레이션,5720,5700,-20,-0.35,43977,249862370
005190,동성화학,14450,14300,-150,-1.04,18803,267288650
000640,동아쏘시오홀딩스,113000,110000,-3000,-2.65,17331,1923523500
170900,동아에스티,102000,99400,-2600,-2.55,36797,3677383900
028100,동아지질,16850,16450,-400,-2.37,58917,977826650
282690,동아타이어,12800,13200,400,3.13,11617,152956400
001520,동양,1990,1930,-60,-3.02,369762,728225350
001527,동양2우B,10850,11100,250,2.3,339,3660400
001529,동양3우B,30550,30450,-100,-0.33,931,28583400
084670,동양고속,27950,28000,50,0.18,1032,28931800
030790,동양네트웍스,1915,1860,-55,-2.87,452646,855929535
002900,동양물산,1825,1750,-75,-4.11,1057436,1875971760
082640,동양생명,4775,4730,-45,-0.94,104260,493282765
001525,동양우,8270,8470,200,2.42,1627,13707150
008970,동양철관,1330,1305,-25,-1.88,760023,995240470
092780,동양피스톤,5800,5500,-300,-5.17,380180,2094370870
049770,동원FB,272000,265000,-7000,-2.57,7543,2014885000
018500,동원금속,809,803,-6,-0.74,89946,72971590
006040,동원산업,244500,240500,-4000,-1.64,3734,910801000
030720,동원수산,8880,8860,-20,-0.23,19921,175721110
014820,동원시스템즈,30400,30400,0,0.0,21045,642196850
014825,동원시스템즈우,21000,20950,-50,-0.24,1163,24370900
163560,동일고무벨트,6810,6800,-10,-0.15,12237,83025330
001530,동일방직,82600,81000,-1600,-1.94,18261,1472240600
004890,동일산업,58700,58200,-500,-0.85,664,38758000
002690,동일제강,3080,3100,20,0.65,55914,172428735
000020,동화약품,10000,9820,-180,-1.8,62361,616120910
000150,두산,96200,96700,500,0.52,52440,5084431300
000157,두산2우B,72300,72500,200,0.28,78,5647200
011160,두산건설,1410,1390,-20,-1.42,114248,160880530
241560,두산밥캣,30600,30400,-200,-0.65,239386,7314110300
000155,두산우,72700,72300,-400,-0.55,1854,134326000
042670,두산인프라코어,7680,7620,-60,-0.78,1056523,8100894630
034020,두산중공업,8040,7920,-120,-1.49,3429174,27932135750
016740,두올,3240,3740,500,15.43,17640633,68011077510
192650,드림텍,15700,16000,300,1.91,1101904,17328978100
024090,디씨엠,11350,11250,-100,-0.88,6152,70089700
003160,디아이,4120,4070,-50,-1.21,253955,1050096435
092200,디아이씨,6550,6670,120,1.83,954209,6447511900
013570,디와이,5760,5670,-90,-1.56,47973,272900140
210540,디와이파워,16200,15600,-600,-3.7,132332,2096371700
007340,디티알오토모티브,32450,33100,650,2.0,6701,221692150
026890,디피씨,8260,7890,-370,-4.48,4083015,32655796270
115390,락앤락,21400,20500,-900,-4.21,139812,2891079250
032350,롯데관광개발,13400,13500,100,0.75,184920,2478225100
000400,롯데손해보험,2865,2855,-10,-0.35,229027,654847190
023530,롯데쇼핑,193000,191000,-2000,-1.04,58831,11269165000
004000,롯데정밀화학,47250,46050,-1200,-2.54,132876,6185566550
286940,롯데정보통신,49600,48300,-1300,-2.62,119004,5768529100
280360,롯데제과,183500,179000,-4500,-2.45,4608,826321500
004990,롯데지주,50200,49950,-250,-0.5,132611,6642830500
00499K,롯데지주우,51400,51300,-100,-0.19,724,36737100
005300,롯데칠성,1843000,1821000,-22000,-1.19,2951,5409902000
005305,롯데칠성우,792000,781000,-11000,-1.39,66,52493000
011170,롯데케미칼,290500,289000,-1500,-0.52,182563,52436737500
002270,롯데푸드,680000,667000,-13000,-1.91,2619,1752728000
071840,롯데하이마트,56200,54400,-1800,-3.2,103915,5655315700
027740,마니커,809,803,-6,-0.74,687412,554625895
204320,만도,30900,30600,-300,-0.97,282351,8654614700
001080,만호제강,17400,17500,100,0.57,1739,29973400
088980,맥쿼리인프라,10150,10250,100,0.99,1054124,10761798400
094800,맵스리얼티1,3795,3810,15,0.4,295972,1134902290
015540,메디파트너생명공학,6540,6300,-240,-3.67,18334,116149110
138040,메리츠금융지주,14450,14450,0,0.0,218228,3073056450
008560,메리츠종금증권,4805,4745,-60,-1.25,1253540,5985299020
000060,메리츠화재,24150,23700,-450,-1.86,126955,3024632050
090370,메타랩스,1550,1560,10,0.65,1513480,2443949305
017180,명문제약,5610,5560,-50,-0.89,194259,1086149060
012690,모나리자,4515,4420,-95,-2.1,726533,3256206700
005360,모나미,2715,2655,-60,-2.21,40080,107471345
204210,모두투어리츠,3195,3090,-105,-3.29,7705,23888270
009680,모토닉,13650,13050,-600,-4.4,634228,8419845650
009580,무림PP,5930,5800,-130,-2.19,615457,3606794940
009200,무림페이퍼,3400,3345,-55,-1.62,177438,597305165
033920,무학,14050,13550,-500,-3.56,21364,293433200
008420,문배철강,3100,3055,-45,-1.45,314804,981298015
025560,미래산업,156,151,-5,-3.21,4129796,629304443
007120,미래아이앤지,359,365,6,1.67,2594462,958857000
006800,미래에셋대우,7660,7650,-10,-0.13,1831885,14078228300
00680K,미래에셋대우2우B,3735,3740,5,0.13,155550,581161105
006805,미래에셋대우우,4100,4140,40,0.98,9689,39917035
085620,미래에셋생명,5220,5220,0,0.0,172432,894072890
002840,미원상사,353000,359000,6000,1.7,1752,636097500
268280,미원에스씨,67300,67200,-100,-0.15,1482,99186800
107590,미원홀딩스,39600,39750,150,0.38,1854,73681650
134380,미원화학,42600,42600,0,0.0,1511,64454800
003650,미창석유,78500,78600,100,0.13,4638,367237800
155900,바다로19호,2940,2925,-15,-0.51,28767,84249145
003610,방림,2240,2290,50,2.23,39281,88144565
001340,백광산업,2790,2740,-50,-1.79,101827,281749710
014580,백광소재,2890,2875,-15,-0.52,108835,314142625
035150,백산,7030,6930,-100,-1.42,100045,699331420
002410,범양건영,1775,1705,-70,-3.94,153043,265407505
096300,베트남개발1,378,385,7,1.85,784533,301533813
007210,벽산,3120,2980,-140,-4.49,414077,1248323705
002760,보락,2420,2420,0,0.0,540076,1319523400
003850,보령제약,10800,10950,150,1.39,267383,2935423250
000890,보해양조,1635,1585,-50,-3.06,4773974,7567389810
003000,부광약품,22000,21500,-500,-2.27,190865,4153590050
001270,부국증권,20750,20750,0,0.0,3151,65491700
001275,부국증권우,19350,19400,50,0.26,277,5373650
026940,부국철강,2940,2900,-40,-1.36,42820,124732070
015350,부산가스,42500,42700,200,0.47,5726,245497350
011390,부산산업,125000,122000,-3000,-2.4,8328,1032198500
005030,부산주공,513,512,-1,-0.19,320934,166787087
100220,비상교육,7150,7170,20,0.28,11741,83603380
005180,빙그레,71100,68600,-2500,-3.52,23951,1658905500
003960,사조대림,21350,21050,-300,-1.41,3497,74135300
008040,사조동아원,1565,1495,-70,-4.47,6397143,9723549980
007160,사조산업,55500,54500,-1000,-1.8,7747,424724500
014710,사조씨푸드,6500,6500,0,0.0,8875,57416820
006090,사조오양,9150,9120,-30,-0.33,37617,343070920
079660,사조해표,9690,9570,-120,-1.24,28356,272467490
005090,삼광글라스,40750,40200,-550,-1.35,11345,454799450
001470,삼부토건,4865,4900,35,0.72,52235,255369730
006400,삼성SDI,208000,218000,10000,4.81,1179042,257572612000
006405,삼성SDI우,89000,91900,2900,3.26,5382,493419800
006660,삼성공조,9640,9750,110,1.14,14826,144430840
028260,삼성물산,110000,109000,-1000,-0.91,204397,22391512000
02826K,삼성물산우B,72900,72700,-200,-0.27,127,9205600
207940,삼성바이오로직스,351500,348500,-3000,-0.85,65591,22905677448
032830,삼성생명,87700,86900,-800,-0.91,169542,14794714200
018260,삼성에스디에스,232500,233000,500,0.22,60780,14142665500
028050,삼성엔지니어링,16250,16100,-150,-0.92,961853,15483779550
009150,삼성전기,100000,102500,2500,2.5,1634705,168116098687
009155,삼성전기우,41450,42150,700,1.69,13442,565892250
005930,삼성전자,44050,45850,1800,4.09,21138016,966296342038
005935,삼성전자우,35300,37350,2050,5.81,2064463,75904249844
001360,삼성제약,2715,2680,-35,-1.29,164585,442850590
010140,삼성중공업,8950,8850,-100,-1.12,1885565,16799050820
010145,삼성중공우,53500,54000,500,0.93,7739,417979500
016360,삼성증권,34300,34200,-100,-0.29,208011,7145251400
068290,삼성출판사,16900,17200,300,1.78,366909,6254359300
029780,삼성카드,34850,34700,-150,-0.43,97466,3409212150
000810,삼성화재,308500,297000,-11500,-3.73,136718,40975508903
000815,삼성화재우,199000,198000,-1000,-0.5,18570,3633747500
006110,삼아알미늄,4700,4660,-40,-0.85,63255,297493080
145990,삼양사,63100,61200,-1900,-3.01,13326,825269400
145995,삼양사우,37500,38350,850,2.27,174,6656600
003230,삼양식품,84300,80700,-3600,-4.27,98228,8000272800
002170,삼양통상,48200,47900,-300,-0.62,14659,707410100
272550,삼양패키징,17500,17250,-250,-1.43,30760,534435000
000070,삼양홀딩스,89300,87900,-1400,-1.57,13481,1191016700
000075,삼양홀딩스우,49700,49950,250,0.5,324,16113750
002810,삼영무역,16050,16200,150,0.93,13637,219446750
005680,삼영전자,12750,12650,-100,-0.78,61113,772210650
003720,삼영화학,795,814,19,2.39,94073,75528591
023000,삼원강재,3045,3050,5,0.16,6670,20304375
004380,삼익THK,12600,12850,250,1.98,57834,744606400
002450,삼익악기,1935,1930,-5,-0.26,223572,431210320
000520,삼일제약,33500,31250,-2250,-6.72,809907,25807216500
009770,삼정펄프,36800,36500,-300,-0.82,186,6747350
005500,삼진제약,41200,40200,-1000,-2.43,64757,2621706300
004690,삼천리,97400,97200,-200,-0.21,2909,282797000
001880,삼호,14800,14800,0,0.0,2927,43596700
010960,삼호개발,5080,5000,-80,-1.57,72514,363672900
004450,삼화왕관,46400,45800,-600,-1.29,240,11055750
009470,삼화전기,20300,20650,350,1.72,66760,1398452000
011230,삼화전자,3410,3270,-140,-4.11,280148,898982335
001820,삼화콘덴서,56200,57400,1200,2.14,232360,13531057900
000390,삼화페인트,6080,6060,-20,-0.33,7858,47751700
041650,상신브레이크,4285,4245,-40,-0.93,28487,121407890
075180,새론오토모티브,5550,5750,200,3.6,28536,160450940
007540,샘표,37700,36500,-1200,-3.18,17550,648660650
248170,샘표식품,30050,30000,-50,-0.17,8548,255636150
007860,서연,4460,4510,50,1.12,87844,394791425
200880,서연이화,6710,6750,40,0.6,1433372,9902890890
017390,서울가스,83400,83200,-200,-0.24,86,7166300
004410,서울식품,191,189,-2,-1.05,1044330,197518166
004415,서울식품우,4030,4055,25,0.62,116795,478569550
021050,서원,1190,1175,-15,-1.26,44273,51952485
008490,서흥,26850,26900,50,0.19,12359,331439350
007610,선도전기,3990,3930,-60,-1.5,133233,526501870
136490,선진,12800,12850,50,0.39,54932,712891550
002820,선창산업,5540,5450,-90,-1.62,7447,40573290
014910,성문전자,3090,3005,-85,-2.75,280478,854786490
014915,성문전자우,14600,14800,200,1.37,136801,2054964850
003080,성보화학,5320,5270,-50,-0.94,26037,136902960
004980,성신양회,10850,10700,-150,-1.38,340374,3682208050
004987,성신양회2우B,12650,16400,3750,29.64,191780,2932630650
004989,성신양회3우B,10600,10750,150,1.42,67314,775382800
004985,성신양회우,10250,11600,1350,13.17,561162,6817526350
011300,성안,598,598,0,0.0,118060,70052248
000180,성창기업지주,2180,2135,-45,-2.06,152131,324847120
002420,세기상사,70600,70600,0,0.0,2548,176441800
004360,세방,13950,14100,150,1.08,13960,196220350
004365,세방우,6440,6420,-20,-0.31,2417,15611960
004490,세방전지,47500,46900,-600,-1.26,21505,1012857000
001430,세아베스틸,19800,19300,-500,-2.53,35226,685156050
306200,세아제강,62600,62700,100,0.16,1773,110959100
003030,세아제강지주,51000,50600,-400,-0.78,5556,281258800
019440,세아특수강,15600,15750,150,0.96,9331,145810400
058650,세아홀딩스,95400,95600,200,0.21,1730,165451600
013000,세우글로벌,1845,1785,-60,-3.25,473846,858276575
091090,세원셀론텍,3720,3815,95,2.55,1762398,6655560310
021820,세원정공,7850,7720,-130,-1.66,1101,8639270
067830,세이브존IC,4020,4140,120,2.99,46652,191359960
033530,세종공업,6990,6720,-270,-3.86,313267,2131221660
075580,세진중공업,4350,4265,-85,-1.95,113941,485652640
027970,세하,1565,1560,-5,-0.32,209213,324486975
145210,세화아이엠씨,2990,2990,0,0.0,0,0
068270,셀트리온,201000,200500,-500,-0.25,305223,61323446500
004430,송원산업,18950,18450,-500,-2.64,271989,5073030600
017550,수산중공업,1615,1590,-25,-1.55,187703,300226155
002200,수출포장,22000,21650,-350,-1.59,11303,245622300
053210,스카이라이프,12100,11900,-200,-1.65,47427,568320050
134790,시디즈,37650,36850,-800,-2.12,3321,122810550
016590,신대양제지,87600,86200,-1400,-1.6,16450,1414333300
029530,신도리코,48450,48450,0,0.0,10884,527245850
004970,신라교역,14400,14300,-100,-0.69,1631,23331200
011930,신성이엔지,1180,1185,5,0.42,475390,563551135
005390,신성통상,924,922,-2,-0.22,254321,234503634
004170,신세계,329500,319500,-10000,-3.03,77107,24697769500
035510,신세계IC,156000,152000,-4000,-2.56,10684,1637567000
034300,신세계건설,31650,31500,-150,-0.47,4710,147556750
031430,신세계인터내셔날,316000,298500,-17500,-5.54,134769,39955634500
031440,신세계푸드,100000,101000,1000,1.0,38108,3814742600
006880,신송홀딩스,4460,4505,45,1.01,9755,43660185
005800,신영와코루,129000,130000,1000,0.78,281,36293500
001720,신영증권,60200,60400,200,0.33,2750,165978700
001725,신영증권우,56000,56000,0,0.0,1707,95309600
009270,신원,2055,1995,-60,-2.92,1175669,2372940535
009275,신원우,47850,47950,100,0.21,1677,79985300
002700,신일산업,1920,1850,-70,-3.65,7456139,14022284190
019170,신풍제약,7950,7820,-130,-1.64,777577,6161662110
019175,신풍제약우,6450,6370,-80,-1.24,4841,31056830
002870,신풍제지,1350,1345,-5,-0.37,66853,89639085
005450,신한,4945,4945,0,0.0,0,0
293940,신한알파리츠,5840,5860,20,0.34,121029,708206200
055550,신한지주,44100,43300,-800,-1.81,1286717,55953818100
001770,신화실업,22350,22400,50,0.22,2294,50843300
004080,신흥,10050,10000,-50,-0.5,1550,15500570
102280,쌍방울,1030,1040,10,0.97,461270,479810255
003410,쌍용양회,6040,5960,-80,-1.32,807982,4845350910
003415,쌍용양회우,5960,6010,50,0.84,94065,573418530
003620,쌍용차,5460,5280,-180,-3.3,165971,890910550
004770,써니전자,2925,2900,-25,-0.85,387189,1124568735
004920,씨아이테크,516,541,25,4.84,648588,354376876
112610,씨에스윈드,36400,36100,-300,-0.82,116489,4220823150
008700,아남전자,2805,2740,-65,-2.32,1423189,3987843545
002790,아모레G,73200,71600,-1600,-2.19,92485,6657024600
002795,아모레G우,31150,30650,-500,-1.61,2349,72244650
090430,아모레퍼시픽,198000,193000,-5000,-2.53,186882,36455609000
090435,아모레퍼시픽우,114000,110500,-3500,-3.07,4002,444714500
002030,아세아,128500,128000,-500,-0.39,382,48824500
183190,아세아시멘트,111000,110000,-1000,-0.9,10688,1172009500
002310,아세아제지,39850,39600,-250,-0.63,43797,1721675700
267850,아시아나IDT,15600,15150,-450,-2.88,116573,1775626150
020560,아시아나항공,4050,4040,-10,-0.25,524710,2121476115
122900,아이마켓코리아,9980,9750,-230,-2.3,96153,944895450
010780,아이에스동서,32950,32150,-800,-2.43,49372,1603745250
033660,아주캐피탈,9900,10000,100,1.01,83585,840744340
101140,아티스,4550,4345,-205,-4.51,305942,1363581065
001780,알루코,2740,2715,-25,-0.91,217778,587682480
002250,알보젠코리아,28700,28700,0,0.0,0,0
018250,애경산업,49450,47850,-1600,-3.24,289408,14010387000
161000,애경유화,9800,10050,250,2.55,397249,3992646690
011090,에넥스,1500,1465,-35,-2.33,969702,1427368790
005850,에스엘,22350,21850,-500,-2.24,59146,1297041150
012750,에스원,99700,98200,-1500,-1.5,38724,3838259000
023960,에쓰씨엔지니어링,1760,1750,-10,-0.57,98926,170933755
298690,에어부산,4500,4430,-70,-1.56,212669,952792380
140910,에이리츠,5930,5900,-30,-0.51,6663,39298000
078520,에이블씨엔씨,15800,14750,-1050,-6.65,447319,6762122100
015260,에이엔피,530,518,-12,-2.26,1087139,575786873
007460,에이프로젠KIC,2695,2910,215,7.98,18504020,52155958440
003060,에이프로젠제약,2550,2490,-60,-2.35,272979,684578040
036570,엔씨소프트,454500,463000,8500,1.87,100842,46271265000
138250,엔에스쇼핑,12200,12250,50,0.41,41740,506165650
085310,엔케이,1780,1625,-155,-8.71,3495724,5759334815
009810,엔케이물산,810,806,-4,-0.49,858408,688495702
900140,엘브이엠씨홀딩스,2700,2645,-55,-2.04,99727,263003980
014440,영보화학,3910,3900,-10,-0.26,9967,38788740
111770,영원무역,33450,32550,-900,-2.69,133462,4367407800
009970,영원무역홀딩스,65500,64800,-700,-1.07,1965,127690900
003520,영진약품,7250,7060,-190,-2.62,922966,6578348530
000670,영풍,854000,839000,-15000,-1.76,1433,1215398000
006740,영풍제지,3710,3515,-195,-5.26,256756,909205215
012280,영화금속,1440,1425,-15,-1.04,187620,266797665
012160,영흥철강,1255,1270,15,1.2,269852,340414705
015360,예스코홀딩스,40900,40950,50,0.12,1607,65866450
007310,오뚜기,771000,751000,-20000,-2.59,6939,5227626000
079440,오렌지라이프,37850,37200,-650,-1.72,133777,4990332100
002630,오리엔트바이오,500,499,-1,-0.2,4212124,2100206076
271560,오리온,100000,98500,-1500,-1.5,149326,14728421900
001800,오리온홀딩스,19450,18650,-800,-4.11,118194,2235282400
070960,용평리조트,7330,7170,-160,-2.18,311936,2260837950
316140,우리금융지주,15000,14650,-350,-2.33,1055925,15554555100
004720,우리들제약,9170,8980,-190,-2.07,64888,586799170
118000,우리들휴브레인,2525,2490,-35,-1.39,126536,314736840
010050,우리종금,770,770,0,0.0,1244979,960547560
006980,우성사료,2995,2960,-35,-1.17,2864405,8523017055
017370,우신시스템,6020,6020,0,0.0,38848,232041360
105840,우진,5310,5260,-50,-0.94,128905,680928940
010400,우진아이엔에스,10800,11150,350,3.24,182182,2040918150
049800,우진플라임,5990,5880,-110,-1.84,52686,308606420
016880,웅진,2600,2510,-90,-3.46,734482,1858884105
095720,웅진씽크빅,3575,3490,-85,-2.38,2088001,7477358100
103130,웅진에너지,1085,1040,-45,-4.15,933459,979385050
005820,원림,18100,18150,50,0.28,518,9333800
010600,웰바이오텍,4360,4150,-210,-4.82,1001860,4337419560
008600,윌비스,1400,1385,-15,-1.07,264343,366468450
033270,유나이티드제약,26100,26050,-50,-0.19,37058,967599500
014830,유니드,48350,48600,250,0.52,16013,779505800
000910,유니온,4115,4070,-45,-1.09,41552,169762445
047400,유니온머티리얼,1945,1940,-5,-0.26,51836,100878660
011330,유니켐,2260,2385,125,5.53,6544834,15309310390
077500,유니퀘스트,6620,6530,-90,-1.36,69328,456615110
002920,유성기업,2885,2925,40,1.39,29574,85662540
000700,유수홀딩스,7800,7830,30,0.38,48997,385721250
003470,유안타증권,3205,3195,-10,-0.31,277746,889682325
003475,유안타증권우,2190,2225,35,1.6,71680,160831830
011690,유양디앤유,7900,8000,100,1.27,269083,2125922850
072130,유엔젤,4160,4050,-110,-2.64,327962,1344733285
000220,유유제약,12650,12550,-100,-0.79,34497,434676000
000225,유유제약1우,7130,7200,70,0.98,5803,41718970
000227,유유제약2우B,18250,18700,450,2.47,1381,25767100
001200,유진투자증권,2620,2615,-5,-0.19,242369,632709995
000100,유한양행,250000,241000,-9000,-3.6,67379,16383768500
000105,유한양행우,214500,212000,-2500,-1.17,71,15037000
003460,유화증권,12850,12850,0,0.0,2389,30629900
003465,유화증권우,12650,12650,0,0.0,104,1320800
008730,율촌화학,13350,13100,-250,-1.87,103973,1381129800
008250,이건산업,10650,10500,-150,-1.41,84712,897330850
025820,이구산업,1920,1900,-20,-1.04,43873,83583470
214320,이노션,73300,72300,-1000,-1.36,58736,4210274900
088260,이리츠코크렙,4790,4820,30,0.63,76126,365683495
139480,이마트,181000,177500,-3500,-1.93,110505,19630998500
007660,이수페타시스,5420,5260,-160,-2.95,1334862,7077267680
005950,이수화학,9880,9850,-30,-0.3,15917,156179220
015020,이스타코,676,690,14,2.07,85716,59304379
093230,이아이디,189,189,0,0.0,538372,100113980
102460,이연제약,21650,21000,-650,-3.0,171470,3655344450
084680,이월드,2285,2295,10,0.44,218020,503916565
000760,이화산업,20450,20250,-200,-0.98,1739,34831950
014990,인디에프,2340,2235,-105,-4.49,859536,1945432180
006490,인스코비,5500,5350,-150,-2.73,1156976,6258450370
023800,인지컨트롤스,7270,7130,-140,-1.93,188504,1360408750
034590,인천도시가스,29400,29300,-100,-0.34,1457,42732800
129260,인터지스,2460,2450,-10,-0.41,73067,177544560
023810,인팩,4730,4685,-45,-0.95,24415,113326725
249420,일동제약,23450,23100,-350,-1.49,73076,1699626250
000230,일동홀딩스,12800,12750,-50,-0.39,1984,25337250
013360,일성건설,1440,1390,-50,-3.47,302952,426732545
003120,일성신약,93400,93200,-200,-0.21,716,66534200
003200,일신방직,99700,101000,1300,1.3,2391,240750200
007110,일신석재,2215,2170,-45,-2.03,1770066,3842326185
007570,일양약품,31450,30400,-1050,-3.34,67047,2064288350
007575,일양약품우,19800,19500,-300,-1.52,675,13100350
008500,일정실업,20800,20500,-300,-1.44,46,946950
081000,일진다이아,33450,31800,-1650,-4.93,291484,9499615550
020760,일진디스플,3795,3760,-35,-0.92,104690,395301020
020150,일진머티리얼즈,39150,41550,2400,6.13,1281314,53218955700
103590,일진전기,3370,3350,-20,-0.59,47618,160056805
015860,일진홀딩스,3740,3715,-25,-0.67,46917,176359635
226320,잇츠한불,32850,32450,-400,-1.22,63955,2082741600
033240,자화전자,14000,13750,-250,-1.79,86543,1200471750
000950,전방,18050,17900,-150,-0.83,951,16962400
194370,제이에스코퍼레이션,13950,13700,-250,-1.79,21504,295568000
025620,제이준코스메틱,11050,10700,-350,-3.17,532894,5772806950
030000,제일기획,23950,23800,-150,-0.63,187735,4464013300
271980,제일약품,46250,45400,-850,-1.84,51487,2342930800
001560,제일연마,6400,6360,-40,-0.63,1170,7392050
002620,제일파마홀딩스,26950,26850,-100,-0.37,8992,240143900
006220,제주은행,4930,4870,-60,-1.22,44737,218048360
089590,제주항공,40200,39450,-750,-1.87,132413,5136555200
004910,조광페인트,7190,7080,-110,-1.53,26190,185722020
004700,조광피혁,36750,36700,-50,-0.14,186,6837200
001550,조비,22100,21400,-700,-3.17,35783,773019350
000480,조선내화,82700,82900,200,0.24,1999,165476400
120030,조선선재,84400,82300,-2100,-2.49,3027,251209100
018470,조일알미늄,944,939,-5,-0.53,39382,36640217
002600,조흥,185000,185500,500,0.27,75,13882000
185750,종근당,106000,104000,-2000,-1.89,27738,2899375000
063160,종근당바이오,23800,23350,-450,-1.89,18383,432132050
001630,종근당홀딩스,68700,68400,-300,-0.44,9791,674742700
044380,주연테크,412,423,11,2.67,6445278,2781942011
013870,지엠비코리아,7920,7620,-300,-3.79,329311,2544329950
071320,지역난방공사,60400,61700,1300,2.15,8591,528788200
010580,지코,720,725,5,0.69,432695,309477538
035000,지투알,8080,7950,-130,-1.61,7860,62859500
088790,진도,4620,4605,-15,-0.32,4285,19709285
003780,진양산업,3730,3675,-55,-1.47,119518,439812950
010640,진양폴리,2125,2075,-50,-2.35,71755,148883935
100250,진양홀딩스,2590,2590,0,0.0,18868,48881845
051630,진양화학,4590,4400,-190,-4.14,181704,807807770
272450,진에어,23450,22650,-800,-3.41,270433,6107999800
011000,진원생명과학,4980,4835,-145,-2.91,120362,587320875
002780,진흥기업,1990,1960,-30,-1.51,93272,184223235
002787,진흥기업2우B,10450,10700,250,2.39,145895,1675459000
002785,진흥기업우B,4200,4180,-20,-0.48,123938,552747385
009310,참엔지니어링,1625,1640,15,0.92,58966,96127750
000650,천일고속,77500,77800,300,0.39,522,40685700
012600,청호컴넷,2560,2630,70,2.73,292615,821627870
033250,체시스,896,882,-14,-1.56,145794,129832900
035720,카카오,102000,102500,500,0.49,230173,23712890000
006380,카프로,4760,4725,-35,-0.74,127828,607858345
109070,컨버즈,3315,3325,10,0.3,568753,1826079870
029460,케이씨,15100,15950,850,5.63,288353,4591546550
281820,케이씨텍,17550,18700,1150,6.55,312530,5716670050
145270,케이탑리츠,970,953,-17,-1.75,312115,299009153
058860,케이티스,2785,2720,-65,-2.33,124925,342561295
007815,코리아써우,2870,2845,-25,-0.87,2215,6327565
007810,코리아써키트,6100,6190,90,1.48,22619,138714760
00781K,코리아써키트2우B,4140,4110,-30,-0.72,3,12330
152330,코리아오토글라스,15650,15700,50,0.32,62562,979631050
003690,코리안리,9390,9310,-80,-0.85,153775,1436497390
192820,코스맥스,152500,151000,-1500,-0.98,60458,9196988000
044820,코스맥스비티아이,25100,24500,-600,-2.39,43173,1055225650
005070,코스모신소재,16400,17000,600,3.66,1162141,19983734150
005420,코스모화학,15050,15900,850,5.65,284740,4482492350
071950,코아스,1315,1285,-30,-2.28,187194,242140075
002020,코오롱,34800,34950,150,0.43,9917,346426300
003070,코오롱글로벌,10700,10800,100,0.93,144898,1567646450
003075,코오롱글로벌우,14900,15300,400,2.68,14260,215542550
144620,코오롱머티리얼,2845,2750,-95,-3.34,372778,1037191585
002025,코오롱우,18000,18000,0,0.0,733,13177600
120110,코오롱인더,51800,51400,-400,-0.77,65615,3393308800
120115,코오롱인더우,22850,22750,-100,-0.44,600,13598150
138490,코오롱플라스틱,6660,6590,-70,-1.05,39514,258968580
021240,코웨이,96600,97000,400,0.41,156860,15134528900
031820,콤텍시스템,1530,1540,10,0.65,3668347,5768407885
192400,쿠쿠홀딩스,151000,144000,-7000,-4.64,8382,1229902500
284740,쿠쿠홈시스,193500,192500,-1000,-0.52,2563,491051500
015590,큐로,597,590,-7,-1.17,428192,253532272
264900,크라운제과,10300,10250,-50,-0.49,35100,358968750
26490K,크라운제과우,7960,7990,30,0.38,764,6089360
005740,크라운해태홀딩스,12150,11900,-250,-2.06,44083,527474400
005745,크라운해태홀딩스우,12250,12550,300,2.45,11678,145742700
020120,키다리스튜디오,2920,2850,-70,-2.4,26944,77957195
039490,키움증권,85100,86300,1200,1.41,264125,23132262400
012170,키위미디어그룹,308,301,-7,-2.27,1290916,387185613
015890,태경산업,5810,5840,30,0.52,90997,531953800
006890,태경화학,5400,5580,180,3.33,331167,1833186350
003240,태광산업,1697000,1677000,-20000,-1.18,866,1461732000
011280,태림포장,4670,4515,-155,-3.32,128549,589744165
004100,태양금속,1450,1400,-50,-3.45,122676,175836935
004105,태양금속우,3470,3515,45,1.3,160882,568165725
009410,태영건설,12300,11950,-350,-2.85,180934,2181440750
009415,태영건설우,5940,5790,-150,-2.53,24417,142869790
001420,태원물산,5760,5810,50,0.87,15216,88161160
007980,태평양물산,2610,2555,-55,-2.11,149715,383756395
055490,테이팩스,19400,19350,-50,-0.26,12042,233496800
078000,텔코웨어,14700,14500,-200,-1.36,33379,482258450
214420,토니모리,13750,13450,-300,-2.18,105657,1427241150
140890,트러스제7호,3500,3505,5,0.14,6,21005
019180,티에이치엔,2420,2460,40,1.65,80692,197030665
091810,티웨이항공,8010,8000,-10,-0.12,197314,1568483990
004870,티웨이홀딩스,2600,2535,-65,-2.5,405582,1031774085
005690,파미셀,12750,12450,-300,-2.35,759493,9503007550
036580,팜스코,8850,8560,-290,-3.28,85126,739865880
028670,팬오션,4290,4240,-50,-1.17,1154461,4944906410
010820,퍼스텍,2960,2905,-55,-1.86,760615,2235243870
016800,퍼시스,31950,31700,-250,-0.78,4341,138003650
001020,페이퍼코리아,952,963,11,1.16,408959,403361892
090080,평화산업,2200,2130,-70,-3.18,267002,577526465
010770,평화홀딩스,6180,5850,-330,-5.34,81749,488400800
058430,포스코강판,20750,20500,-250,-1.2,10575,218470100
047050,포스코대우,18500,18350,-150,-0.81,152366,2813386750
007630,폴루스바이오팜,2360,2295,-65,-2.75,7061633,16906489825
017810,풀무원,101500,102500,1000,0.99,8094,827606000
103140,풍산,30300,29800,-500,-1.65,95252,2851559200
005810,풍산홀딩스,40050,40600,550,1.37,4412,178969750
033180,필룩스,11400,10500,-900,-7.89,4553239,48739302900
086790,하나금융지주,37850,37250,-600,-1.59,732194,27434318500
099340,하나니켈1호,783,775,-8,-1.02,261320,203914294
099350,하나니켈2호,1140,1120,-20,-1.75,107296,120216090
293480,하나제약,26750,25750,-1000,-3.74,200764,5232551550
039130,하나투어,77400,75000,-2400,-3.1,151207,11439307800
172580,하이골드12호,2875,2860,-15,-0.52,44378,126084585
153360,하이골드3호,1850,1845,-5,-0.27,3009,5431600
159650,하이골드8호,1450,1460,10,0.69,27076,39945455
071090,하이스틸,22950,22700,-250,-1.09,9013,207064450
019490,하이트론,3720,3800,80,2.15,6299,23569040
000080,하이트진로,18500,18150,-350,-1.89,204843,3747378150
000087,하이트진로2우B,14950,14850,-100,-0.67,1536,22809450
000140,하이트진로홀딩스,8000,7960,-40,-0.5,2775,22132000
000145,하이트진로홀딩스우,8350,8340,-10,-0.12,105,876480
152550,한국ANKOR유전,1700,1700,0,0.0,106161,180458340
036460,한국가스공사,49100,48350,-750,-1.53,217322,10544576350
005430,한국공항,43600,42950,-650,-1.49,2149,92488800
071050,한국금융지주,65800,65500,-300,-0.46,204209,13372654800
071055,한국금융지주우,37250,37150,-100,-0.27,18333,680266100
010040,한국내화,5940,5900,-40,-0.67,367826,2193263020
025540,한국단자,66000,61500,-4500,-6.82,58581,3644814200
004090,한국석유,123000,122000,-1000,-0.81,1658,202012000
002960,한국쉘석유,328500,324500,-4000,-1.22,2941,959701500
123890,한국자산신탁,4190,4345,155,3.7,133099,569236410
015760,한국전력,32400,31900,-500,-1.54,1797470,57610077700
006200,한국전자홀딩스,815,811,-4,-0.49,94734,76493956
002300,한국제지,18200,18450,250,1.37,3745,68380400
023350,한국종합기술,5130,5060,-70,-1.36,73851,373329580
025890,한국주강,1890,1860,-30,-1.59,21317,39594480
000970,한국주철관,10450,10050,-400,-3.83,150683,1524423410
104700,한국철강,5970,6120,150,2.51,72518,434587280
017960,한국카본,8700,8550,-150,-1.72,310687,2642693500
161890,한국콜마,81200,80000,-1200,-1.48,82500,6647859900
024720,한국콜마홀딩스,39250,37900,-1350,-3.44,92983,3540452700
161390,한국타이어,43900,42250,-1650,-3.76,242592,10302763900
000240,한국타이어월드와이드,17000,16400,-600,-3.53,73293,1209237600
034830,한국토지신탁,2610,2685,75,2.87,741605,1969377605
007280,한국특수형강,2000,1970,-30,-1.5,83606,165793670
168490,한국패러랠,2460,2455,-5,-0.2,48098,117653470
010100,한국프랜지,1635,1580,-55,-3.36,30156,48322940
047810,한국항공우주,36650,35500,-1150,-3.14,469617,16869848600
123690,한국화장품,12650,12550,-100,-0.79,100541,1258463500
003350,한국화장품제조,37200,36550,-650,-1.75,17935,659803650
011500,한농화성,4115,4055,-60,-1.46,37013,149992825
002390,한독,31250,30300,-950,-3.04,81355,2490917300
014790,한라,4110,4055,-55,-1.34,136104,554630330
060980,한라홀딩스,43200,42100,-1100,-2.55,20513,870789600
053690,한미글로벌,11200,11000,-200,-1.79,111975,1240494950
042700,한미반도체,8170,8450,280,3.43,391274,3305826940
008930,한미사이언스,78900,77400,-1500,-1.9,49871,3893012400
128940,한미약품,466500,456000,-10500,-2.25,48598,22329206500
009240,한샘,91700,89600,-2100,-2.29,95777,8653454600
020000,한섬,42350,41700,-650,-1.53,80058,3334635850
003680,한성기업,5920,5810,-110,-1.86,43063,250112600
105630,한세실업,27450,25750,-1700,-6.19,329381,8537751250
069640,한세엠케이,7200,7330,130,1.81,33519,244469870
016450,한세예스24홀딩스,9130,8970,-160,-1.75,40537,362524200
010420,한솔PNS,1380,1395,15,1.09,76682,106716750
009180,한솔로지스틱스,1395,1365,-30,-2.15,152062,208873325
213500,한솔제지,16250,16100,-150,-0.92,163605,2642417550
014680,한솔케미칼,82300,81800,-500,-0.61,65152,5394653900
004710,한솔테크닉스,7650,7620,-30,-0.39,74104,565615100
004150,한솔홀딩스,4735,4700,-35,-0.74,101953,481233210
025750,한솔홈데코,1420,1405,-15,-1.06,584247,827923200
004960,한신공영,17850,17600,-250,-1.4,28606,505742400
011700,한신기계,2395,2395,0,0.0,77177,185906330
001750,한양증권,6860,6810,-50,-0.73,5548,37950790
001755,한양증권우,7800,7800,0,0.0,775,6027060
018880,한온시스템,11750,11550,-200,-1.7,541200,6284929900
009420,한올바이오파마,36150,33600,-2550,-7.05,850564,29264543900
014130,한익스프레스,4820,4810,-10,-0.21,10009,47998485
300720,한일시멘트,137500,135500,-2000,-1.45,6409,881589000
002220,한일철강,21050,21550,500,2.38,4470,95357800
006390,한일현대시멘트,41300,40750,-550,-1.33,24469,996732350
003300,한일홀딩스,54800,54900,100,0.18,20774,1151287400
051600,한전KPS,35700,34600,-1100,-3.08,281433,9856378450
052690,한전기술,25300,25450,150,0.59,74646,1894650150
130660,한전산업,3830,3790,-40,-1.04,35093,133077325
002320,한진,37400,36000,-1400,-3.74,205596,7408804800
097230,한진중공업,1190,1190,0,0.0,0,0
003480,한진중공업홀딩스,4795,4530,-265,-5.53,85465,394409600
180640,한진칼,26300,24700,-1600,-6.08,1727513,42581394900
18064K,한진칼우,17900,17000,-900,-5.03,27085,462480200
005110,한창,2965,2915,-50,-1.69,7518573,22468225870
009460,한창제지,2880,2820,-60,-2.08,2385248,6786688840
000880,한화,31450,31000,-450,-1.43,227563,7128570300
00088K,한화3우B,15250,15100,-150,-0.98,19343,294743450
027390,한화갤러리아타임월드,37750,36200,-1550,-4.11,42182,1546400900
088350,한화생명,4150,4110,-40,-0.96,1047724,4310120570
000370,한화손해보험,5430,5370,-60,-1.1,172959,932414850
012450,한화에어로스페이스,34450,33150,-1300,-3.77,303984,10224217900
000885,한화우,21200,21650,450,2.12,21895,469729900
009830,한화케미칼,22700,22550,-150,-0.66,482121,10926173950
009835,한화케미칼우,12200,12050,-150,-1.23,4660,56170700
003530,한화투자증권,2290,2280,-10,-0.44,223160,512934080
003535,한화투자증권우,2270,2290,20,0.88,61168,139893465
195870,해성디에스,14350,14050,-300,-2.09,71500,1020273100
101530,해태제과식품,11000,10650,-350,-3.18,40289,434856500
143210,핸즈코퍼레이션,6730,6730,0,0.0,10631,71327240
000720,현대건설,51100,50200,-900,-1.76,606051,30760140600
267270,현대건설기계,49600,48400,-1200,-2.42,185818,9041645200
000725,현대건설우,172500,170500,-2000,-1.16,2375,408698500
005440,현대그린푸드,14650,14200,-450,-3.07,168535,2421175450
086280,현대글로비스,128000,125500,-2500,-1.95,144824,18232590500
064350,현대로템,22250,21700,-550,-2.47,592293,12981280600
079430,현대리바트,21500,21150,-350,-1.63,50656,1077727150
012330,현대모비스,215000,213500,-1500,-0.7,153710,32689213500
010620,현대미포조선,58200,57600,-600,-1.03,147679,8527632700
069960,현대백화점,106000,104500,-1500,-1.42,45667,4761835000
004560,현대비앤지스틸,10300,10300,0,0.0,25225,262264400
004565,현대비앤지스틸우,61600,62800,1200,1.95,4806,300947200
011760,현대상사,25400,24650,-750,-2.95,106921,2680988300
011200,현대상선,3705,3665,-40,-1.08,665460,2449057645
004310,현대약품,5100,5040,-60,-1.18,228383,1168432410
126560,현대에이치씨엔,4205,4205,0,0.0,83795,352668895
017800,현대엘리베이,81300,80800,-500,-0.62,260692,21145681900
011210,현대위아,43700,42600,-1100,-2.52,134281,5761042550
267260,현대일렉트릭,26450,25850,-600,-2.27,84304,2181427400
004020,현대제철,46900,46000,-900,-1.92,316777,14736671300
009540,현대중공업,128000,127000,-1000,-0.78,181983,23064759000
267250,현대중공업지주,352000,345000,-7000,-1.99,33082,11440354500
005380,현대차,124000,124500,500,0.4,321599,39871775000
005387,현대차2우B,78000,79200,1200,1.54,77136,6074779300
005389,현대차3우B,67400,68000,600,0.89,7861,533043200
005385,현대차우,70200,71100,900,1.28,45660,3239601100
001500,현대차증권,9790,9800,10,0.1,20426,199236010
227840,현대코퍼레이션홀딩스,15000,14700,-300,-2.0,32499,481988150
001450,현대해상,38900,38350,-550,-1.41,193297,7434154250
057050,현대홈쇼핑,114000,111500,-2500,-2.19,24393,2740211500
093240,형지엘리트,1840,1820,-20,-1.09,206205,377003380
003010,혜인,5570,5390,-180,-3.23,143095,784893060
111110,호전실업,11400,11950,550,4.82,28563,335040450
008770,호텔신라,95300,92400,-2900,-3.04,1147340,106029048500
008775,호텔신라우,49850,48000,-1850,-3.71,10855,524277150
002460,화성산업,14150,14250,100,0.71,22033,313623550
013520,화승알앤에이,2330,2270,-60,-2.58,112823,257975025
241590,화승엔터프라이즈,11400,11150,-250,-2.19,131578,1475332050
006060,화승인더,8860,8610,-250,-2.82,327635,2811882810
010690,화신,2495,2620,125,5.01,220145,578284140
133820,화인베스틸,3030,2960,-70,-2.31,329852,988642035
010660,화천기계,21900,21900,0,0.0,2440,52958450
000850,화천기공,42650,43000,350,0.82,3172,135448100
016580,환인제약,18900,18900,0,0.0,25274,482102000
032560,황금에스티,9530,9410,-120,-1.26,69718,660810580
004800,효성,78300,75900,-2400,-3.07,88396,6760924000
094280,효성ITX,10800,10750,-50,-0.46,6464,69848800
298040,효성중공업,40450,40400,-50,-0.12,42718,1728090350
298050,효성첨단소재,137500,133500,-4000,-2.91,33056,4439963000
298020,효성티앤씨,189000,188500,-500,-0.26,18146,3406283500
298000,효성화학,152500,148000,-4500,-2.95,14211,2130311000
093370,후성,8090,8500,410,5.07,2817110,23919137210
081660,휠라코리아,70200,71000,800,1.14,554081,39104833100
005870,휴니드,9110,9110,0,0.0,19895,181068910
079980,휴비스,8030,7940,-90,-1.12,150659,1197447880
005010,휴스틸,12150,11950,-200,-1.65,15092,181161500
069260,휴켐스,20750,20400,-350,-1.69,94495,1936048150
000540,흥국화재,4900,4870,-30,-0.61,32156,157124665
000547,흥국화재2우B,24150,25250,1100,4.55,6954,174113500
000545,흥국화재우,5480,5730,250,4.56,21449,122134250
003280,흥아해운,375,376,1,0.27,710833,267145121
