티커,종목명,시가,종가,변동폭,등락률,거래량,거래대금
095570,AJ네트웍스,4825,4800,-25,-0.52,50452,240646050
068400,AJ렌터카,11800,11450,-350,-2.97,198762,2294772100
006840,AK홀딩스,53700,53400,-300,-0.56,15575,835546300
027410,BGF,8000,7950,-50,-0.63,121426,968374830
282330,BGF리테일,182500,185500,3000,1.64,21140,3902071000
138930,BNK금융지주,7250,7250,0,0.0,856012,6180115230
001460,BYC,241000,241000,0,0.0,457,110391500
001465,BYC우,112000,112000,0,0.0,134,14795000
001040,CJ,124500,125000,500,0.4,79213,9811413000
079160,CJCGV,41750,39400,-2350,-5.63,755739,30062375500
000120,CJ대한통운,178500,173000,-5500,-3.08,81747,14289460000
011150,CJ씨푸드,2465,2460,-5,-0.2,37664,92504420
011155,CJ씨푸드1우,28600,28300,-300,-1.05,336,9509250
001045,CJ우,54000,54600,600,1.11,5174,281077700
097950,CJ제일제당,338000,332000,-6000,-1.78,44392,14812410500
097955,CJ제일제당우,127000,126500,-500,-0.39,3545,449324500
037560,CJ헬로,11100,10900,-200,-1.8,1502494,16272972400
000590,CS홀딩스,67400,67700,300,0.45,2358,156543300
012030,DB,923,921,-2,-0.22,808316,743484717
016610,DB금융투자,4930,4960,30,0.61,77694,383674930
005830,DB손해보험,70500,70700,200,0.28,91943,6495213400
000990,DB하이텍,12450,12600,150,1.2,366624,4614830950
000995,DB하이텍1우,35650,35350,-300,-0.84,630,22352150
139130,DGB금융지주,8620,8820,200,2.32,823087,7215935830
004840,DRB동일,6820,6830,10,0.15,9024,61348640
155660,DSR,4240,5510,1270,29.95,2965779,15434438610
069730,DSR제강,4750,6170,1420,29.89,3442009,19801393285
017940,E1,60400,60200,-200,-0.33,7206,434773600
007700,FF,50600,50700,100,0.2,175250,8864672950
114090,GKL,23900,23000,-900,-3.77,759890,17358558750
078930,GS,52600,53400,800,1.52,157953,8390207200
006360,GS건설,46200,46100,-100,-0.22,245782,11374018100
001250,GS글로벌,2785,2815,30,1.08,288843,813845410
007070,GS리테일,35550,34950,-600,-1.69,172885,6075488250
078935,GS우,36100,36550,450,1.25,4722,169960250
012630,HDC,18400,18600,200,1.09,601395,11088046550
039570,HDC아이콘트롤스,10500,10550,50,0.48,34852,365002900
089470,HDC현대EP,4785,4960,175,3.66,109275,534116750
294870,HDC현대산업개발,48050,51400,3350,6.97,319240,16241303650
082740,HSD엔진,5390,5390,0,0.0,485148,2617813080
003560,IHQ,2535,2535,0,0.0,9824378,24697487455
175330,JB금융지주,6060,6080,20,0.33,373145,2275488690
234080,JW생명과학,22150,21900,-250,-1.13,73405,1603653400
001060,JW중외제약,41950,41400,-550,-1.31,50623,2098288950
001067,JW중외제약2우B,45300,45450,150,0.33,81,3663100
001065,JW중외제약우,26750,26450,-300,-1.12,803,21127100
096760,JW홀딩스,7270,7220,-50,-0.69,80078,579086550
105560,KB금융,46350,45500,-850,-1.83,2051271,93664077350
002380,KCC,320000,325500,5500,1.72,22716,7333589500
009070,KCTC,4150,4470,320,7.71,6045922,27485210680
009440,KC그린홀딩스,4115,4180,65,1.58,25682,106895365
119650,KC코트렐,5460,5550,90,1.65,114832,633817520
092220,KEC,1215,1210,-5,-0.41,805930,972799130
001390,KG케미칼,17200,17550,350,2.03,162895,2852965750
001940,KISCO홀딩스,13700,13700,0,0.0,4582,62621300
025000,KPX케미칼,54500,56000,1500,2.75,4493,249463100
092230,KPX홀딩스,60600,60600,0,0.0,214,12982600
000040,KR모터스,538,541,3,0.56,136587,73781868
044450,KSS해운,6810,6820,10,0.15,37797,257866310
030200,KT,28700,28450,-250,-0.87,834609,23945697746
033780,KTG,98400,97900,-500,-0.51,251522,24651750700
030210,KTB투자증권,3240,3285,45,1.39,230904,755661065
058850,KTcs,2650,2660,10,0.38,429290,1144597750
093050,LF,24200,24400,200,0.83,67455,1647892100
003550,LG,75400,76500,1100,1.46,313386,23952982450
034220,LG디스플레이,19100,19300,200,1.05,1128181,21698844150
001120,LG상사,16850,16650,-200,-1.19,143407,2398894950
051900,LG생활건강,1219000,1210000,-9000,-0.74,25149,30559676560
051905,LG생활건강우,708000,705000,-3000,-0.42,2651,1865686000
003555,LG우,43100,44050,950,2.2,8622,376300250
032640,LG유플러스,15100,14700,-400,-2.65,3306722,48570003200
011070,LG이노텍,104500,107000,2500,2.39,373136,40025640500
066570,LG전자,69300,71900,2600,3.75,2499697,180111706500
066575,LG전자우,27750,28750,1000,3.6,73446,2107477050
108670,LG하우시스,69300,69200,-100,-0.14,28076,1951165900
108675,LG하우시스우,31350,31400,50,0.16,1245,38945600
051910,LG화학,372000,371500,-500,-0.13,161623,59839894500
051915,LG화학우,207000,206000,-1000,-0.48,9243,1897507000
079550,LIG넥스원,35400,35100,-300,-0.85,114193,3991414700
006260,LS,54400,54600,200,0.37,55835,3047933600
000680,LS네트웍스,2880,2895,15,0.52,26028,75406285
010120,LS산전,50600,51100,500,0.99,87087,4466406400
229640,LS전선아시아,6040,6170,130,2.15,25403,155292590
023150,MH에탄올,5950,6050,100,1.68,8811,52974800
035420,NAVER,125500,123500,-2000,-1.59,1160217,141811138000
181710,NHN엔터테인먼트,64200,62500,-1700,-2.65,107509,6754256700
005940,NH투자증권,13550,13550,0,0.0,522906,7102263500
005945,NH투자증권우,8790,8790,0,0.0,9503,83458600
034310,NICE,18200,18400,200,1.1,35145,642906950
008260,NI스틸,2665,2810,145,5.44,886747,2478139005
004250,NPC,3805,3780,-25,-0.66,221933,946379960
004255,NPC우,2300,2355,55,2.39,15021,35143190
010060,OCI,103000,97300,-5700,-5.53,458017,44691969600
005490,POSCO,267000,265500,-1500,-0.56,177997,47253455560
100840,STC,12800,13150,350,2.73,15645,207825150
064960,ST모티브,34200,35250,1050,3.07,81030,2843837500
003570,ST중공업,7330,7320,-10,-0.14,14133,102279070
036530,ST홀딩스,12750,12900,150,1.18,3959,50598900
010950,S-Oil,103500,101500,-2000,-1.93,323825,32940462400
010955,S-Oil우,70200,69300,-900,-1.28,13972,972239900
034120,SBS,22800,23350,550,2.41,39234,913579450
101060,SBS미디어홀딩스,2355,2355,0,0.0,63499,149884115
004060,SG세계물산,806,801,-5,-0.62,267978,214662645
001380,SG충방,2635,2670,35,1.33,569162,1508413240
002360,SH에너지화학,1200,1220,20,1.67,995299,1207232165
009160,SIMPAC,2905,2865,-40,-1.38,34300,98497420
123700,SJM,3300,3315,15,0.45,5985,19664265
025530,SJM홀딩스,3300,3305,5,0.15,28135,93921000
034730,SK,263000,274500,11500,4.37,130509,35425069000
011790,SKC,39700,40250,550,1.39,103099,4119872500
018670,SK가스,82700,80900,-1800,-2.18,22879,1849173700
001740,SK네트웍스,6140,6080,-60,-0.98,1158627,7034781580
001745,SK네트웍스우,56300,55000,-1300,-2.31,659,36522000
006120,SK디스커버리,28950,28950,0,0.0,24421,705793450
006125,SK디스커버리우,15700,15750,50,0.32,422,6610950
210980,SK디앤디,30300,30350,50,0.17,12561,382184850
03473K,SK우,138000,141500,3500,2.54,3296,460894000
096770,SK이노베이션,185500,183500,-2000,-1.08,276980,50637616500
096775,SK이노베이션우,124500,124000,-500,-0.4,3664,454740000
001510,SK증권,738,736,-2,-0.27,1474534,1086086810
001515,SK증권우,3770,3620,-150,-3.98,185647,678322980
285130,SK케미칼,71400,72400,1000,1.4,88082,6379822500
28513K,SK케미칼우,25250,25650,400,1.58,3209,82394450
017670,SK텔레콤,261000,259500,-1500,-0.57,221733,57893146000
000660,SK하이닉스,74100,75900,1800,2.43,3526701,266900281990
005610,SPC삼립,118000,116000,-2000,-1.69,7764,904392500
011810,STX,16450,17200,750,4.56,1126467,20092363650
077970,STX엔진,7140,7260,120,1.68,59158,432398880
071970,STX중공업,7290,7260,-30,-0.41,131089,949316960
084870,TBH글로벌,2910,2900,-10,-0.34,42121,122905130
002710,TCC동양,2250,2230,-20,-0.89,31227,69784470
024070,WISCOM,2965,2950,-15,-0.51,1645,4864630
037270,YGPLUS,2085,2050,-35,-1.68,138386,283101650
000500,가온전선,18750,18700,-50,-0.27,2105,39402700
000860,강남제비스코,27000,26750,-250,-0.93,11218,299728550
035250,강원랜드,34050,33550,-500,-1.47,549299,18433362600
011420,갤럭시아에스엠,1970,1975,5,0.25,72757,143610745
002100,경농,20450,20350,-100,-0.49,444220,9116753500
009450,경동나비엔,44200,43500,-700,-1.58,49840,2184610200
267290,경동도시가스,36850,37500,650,1.76,7363,272513250
012320,경동인베스트,44050,44600,550,1.25,14784,666634550
000050,경방,10900,10950,50,0.46,3078,33675000
214390,경보제약,10550,10600,50,0.47,28632,300605700
012610,경인양행,6720,6850,130,1.93,402397,2716034320
009140,경인전자,30950,30200,-750,-2.42,5261,159134100
013580,계룡건설,25500,26150,650,2.55,45916,1211916350
012200,계양전기,3795,3790,-5,-0.13,52597,198716935
012205,계양전기우,10700,10150,-550,-5.14,131401,1363042400
004200,고려개발,5040,5060,20,0.4,3334,16741290
002140,고려산업,2525,2640,115,4.55,515749,1345248140
010130,고려아연,433000,435500,2500,0.58,60816,26319497000
002240,고려제강,26300,26200,-100,-0.38,9132,242874600
001290,골든브릿지증권,2495,2500,5,0.2,139739,348855485
009290,광동제약,7260,7260,0,0.0,67535,489923490
017040,광명전기,3300,3270,-30,-0.91,428049,1414695115
017900,광전자,2265,2305,40,1.77,180806,412159745
037710,광주신세계,203500,205000,1500,0.74,150,30555500
030610,교보증권,9480,9500,20,0.21,48629,461710210
007690,국도화학,49950,50200,250,0.5,11446,573376250
005320,국동,2765,2915,150,5.42,3280498,9972618770
001140,국보,14200,13950,-250,-1.76,56869,797439150
002720,국제약품,4780,4695,-85,-1.78,121886,572438125
083420,그린케미칼,3565,3590,25,0.7,9381,33721560
014530,극동유화,3550,3520,-30,-0.85,50278,177411265
014280,금강공업,22450,22000,-450,-2.0,6954,153877500
014285,금강공업우,35000,36150,1150,3.29,78,2762600
008870,금비,66400,67400,1000,1.51,628,42131800
001570,금양,2285,2330,45,1.97,63766,147878765
002990,금호산업,12050,12350,300,2.49,129634,1599319500
002995,금호산업우,26500,26150,-350,-1.32,2442,63580900
011780,금호석유,84200,84900,700,0.83,110461,9325322100
011785,금호석유우,31050,31350,300,0.97,3873,120317850
214330,금호에이치티,6950,6870,-80,-1.15,166504,1136685090
001210,금호전기,6250,6180,-70,-1.12,7323,45565150
073240,금호타이어,5050,5030,-20,-0.4,462405,2319930910
092440,기신정기,3715,3725,10,0.27,9562,35661445
000270,기아차,37000,37000,0,0.0,1150518,42606567050
024110,기업은행,13900,13900,0,0.0,605671,8406002400
013700,까뮤이앤씨,1445,1430,-15,-1.04,512805,739967025
004540,깨끗한나라,3340,3495,155,4.64,169642,582692495
004545,깨끗한나라우,20000,20250,250,1.25,3648,73802100
074610,나노메딕스,7180,6940,-240,-3.34,708045,4860244160
001260,남광토건,18800,18500,-300,-1.6,81572,1513374500
008350,남선알미늄,2765,2820,55,1.99,4207661,11858723550
008355,남선알미우,28150,27750,-400,-1.42,10242,287670050
004270,남성,1890,1905,15,0.79,130112,246523465
003920,남양유업,636000,625000,-11000,-1.73,604,381175000
003925,남양유업우,217000,213500,-3500,-1.61,317,67172500
002070,남영비비안,6480,6520,40,0.62,866,5613850
025860,남해화학,14300,13900,-400,-2.8,422443,5969016350
005720,넥센,6070,5980,-90,-1.48,13365,80395360
005725,넥센우,3700,3720,20,0.54,387,1443885
002350,넥센타이어,9810,9650,-160,-1.63,58990,573388190
002355,넥센타이어1우B,3875,3875,0,0.0,125,484365
003580,넥스트사이언스,7040,6850,-190,-2.7,267625,1848826320
251270,넷마블,119000,118000,-1000,-0.84,217809,25639410500
090350,노루페인트,9100,9100,0,0.0,66194,603430830
090355,노루페인트우,14250,14600,350,2.46,265017,3980803600
000320,노루홀딩스,13900,13850,-50,-0.36,3879,53749100
000325,노루홀딩스우,19300,19350,50,0.26,12688,248864950
006280,녹십자,146000,146000,0,0.0,57907,8412401500
005250,녹십자홀딩스,25450,25050,-400,-1.57,67384,1697349400
005257,녹십자홀딩스2우,17900,17750,-150,-0.84,1902,33460150
004370,농심,285000,271000,-14000,-4.91,28518,7824242500
072710,농심홀딩스,80800,80600,-200,-0.25,4570,368836400
058730,다스코,9390,9400,10,0.11,268428,2531334640
023590,다우기술,21450,21800,350,1.63,119707,2601877850
019680,대교,6570,6490,-80,-1.22,36403,237986050
019685,대교우B,4490,4480,-10,-0.22,626,2807635
006370,대구백화점,11450,11650,200,1.75,190824,2182555900
008060,대덕전자,10250,10450,200,1.95,396237,4151257750
00806K,대덕전자1우,5800,5810,10,0.17,4838,27956060
000490,대동공업,6850,6870,20,0.29,160679,1104095350
008110,대동전자,3480,3465,-15,-0.43,4375,15201405
005750,대림BCo,5140,5230,90,1.75,44477,230438970
000210,대림산업,98500,99200,700,0.71,113608,11242498600
000215,대림산업우,38750,38750,0,0.0,1686,65580300
004440,대림씨엔에스,12250,11650,-600,-4.9,62739,741707150
006570,대림통상,4425,4445,20,0.45,60,266160
001680,대상,26500,26300,-200,-0.75,90734,2397157900
001685,대상우,13250,13000,-250,-1.89,885,11508400
084690,대상홀딩스,8050,8120,70,0.87,49752,402132080
084695,대상홀딩스우,6000,5900,-100,-1.67,33,194300
128820,대성산업,5210,5130,-80,-1.54,93080,483232730
117580,대성에너지,5360,5370,10,0.19,3911,20938740
016710,대성홀딩스,6510,6510,0,0.0,5690,37223810
003540,대신증권,11600,11600,0,0.0,68771,799792800
003547,대신증권2우B,8240,8240,0,0.0,2783,22859120
003545,대신증권우,8730,8720,-10,-0.11,29215,254735750
009190,대양금속,4655,4655,0,0.0,14263,65708260
014160,대영포장,1480,1485,5,0.34,3027334,4491426200
047040,대우건설,5170,5130,-40,-0.77,1607520,8272718130
009320,대우부품,2880,2795,-85,-2.95,1672228,4805810060
042660,대우조선해양,33000,33050,50,0.15,594386,19755541600
003090,대웅,20100,20100,0,0.0,95705,1924644800
069620,대웅제약,207000,206000,-1000,-0.48,54869,11305003000
000430,대원강업,4560,4990,430,9.43,5374431,28790435330
006340,대원전선,2050,2055,5,0.24,1072878,2220148570
006345,대원전선우,4380,4265,-115,-2.63,39445,170328100
003220,대원제약,17000,17200,200,1.18,27732,474021350
024890,대원화성,1910,1900,-10,-0.52,190973,362586875
002880,대유에이텍,1190,1205,15,1.26,865113,1037921445
000300,대유플러스,922,985,63,6.83,1346998,1305782980
012800,대창,979,978,-1,-0.1,239104,234486679
015230,대창단조,42900,43100,200,0.47,3948,169361500
001070,대한방직,13450,13350,-100,-0.74,6530,86825900
006650,대한유화,162000,163500,1500,0.93,16818,2749158500
001440,대한전선,1145,1145,0,0.0,420735,484058610
084010,대한제강,6420,6490,70,1.09,45902,295858270
001790,대한제당,20000,19500,-500,-2.5,14396,282196250
001799,대한제당3우B,23350,23450,100,0.43,573,13427900
001795,대한제당우,11900,12050,150,1.26,270,3259050
001130,대한제분,185000,187000,2000,1.08,1796,331724000
003490,대한항공,35350,35550,200,0.57,313701,11206896700
003495,대한항공우,14600,14400,-200,-1.37,10667,154289850
005880,대한해운,22800,23000,200,0.88,54441,1248014150
003830,대한화섬,106000,109500,3500,3.3,302,32049500
016090,대현,2420,2400,-20,-0.83,143582,344020885
069460,대호에이엘,5420,5420,0,0.0,0,0
012510,더존비즈온,40500,39250,-1250,-3.09,277098,10971279150
004830,덕성,3385,3420,35,1.03,68356,230446865
004835,덕성우,4450,4415,-35,-0.79,18937,83488210
024900,덕양산업,1410,1430,20,1.42,225087,320558670
145720,덴티움,69700,71200,1500,2.15,33099,2358745500
002150,도화엔지니어링,13600,13600,0,0.0,559026,7660622250
001620,동국실업,975,963,-12,-1.23,107276,104180307
001230,동국제강,8190,8110,-80,-0.98,247604,2005761720
023450,동남합성,59000,61000,2000,3.39,571,34001900
004140,동방,2065,2030,-35,-1.69,2205734,4514651390
007590,동방아그로,7830,7700,-130,-1.66,40739,316523560
005960,동부건설,8830,8720,-110,-1.25,37279,326795760
005965,동부건설우,17200,17100,-100,-0.58,1632,27709350
016380,동부제철,10800,10400,-400,-3.7,210826,2261999300
016385,동부제철우,47500,45400,-2100,-4.42,24173,1109413650
083370,동북아12호,4970,4985,15,0.3,33,164505
083380,동북아13호,5030,5030,0,0.0,1,5030
026960,동서,18950,18900,-50,-0.26,66879,1266252550
002210,동성제약,18050,17650,-400,-2.22,546284,9729858400
102260,동성코퍼레이션,5290,5220,-70,-1.32,32671,171229390
005190,동성화학,14600,14850,250,1.71,4379,65349800
000640,동아쏘시오홀딩스,105000,104500,-500,-0.48,8158,858391500
170900,동아에스티,105500,102500,-3000,-2.84,28957,2992007500
028100,동아지질,20350,19900,-450,-2.21,165594,3355868500
282690,동아타이어,12000,11950,-50,-0.42,1276,15205200
001520,동양,2025,2000,-25,-1.23,358541,720154035
001527,동양2우B,11800,11600,-200,-1.69,956,10929850
001529,동양3우B,31400,31550,150,0.48,205,6427200
084670,동양고속,28000,28250,250,0.89,2797,79966400
030790,동양네트웍스,2325,2255,-70,-3.01,894882,2031730775
002900,동양물산,2265,2435,170,7.51,7071813,16981355250
082640,동양생명,5110,5070,-40,-0.78,58055,293464460
001525,동양우,9500,9550,50,0.53,586,5581460
008970,동양철관,1880,1900,20,1.06,4452599,8563127820
092780,동양피스톤,6870,6730,-140,-2.04,332746,2319104590
049770,동원FB,283000,275500,-7500,-2.65,7083,1968644000
018500,동원금속,891,895,4,0.45,65660,58671796
006040,동원산업,224000,220000,-4000,-1.79,4749,1045906500
030720,동원수산,9320,9290,-30,-0.32,29778,275317800
014820,동원시스템즈,29750,30050,300,1.01,18054,546497500
014825,동원시스템즈우,20850,21000,150,0.72,206,4314500
163560,동일고무벨트,6540,6600,60,0.92,13219,86247400
001530,동일방직,68700,68000,-700,-1.02,5872,397846500
004890,동일산업,59100,59100,0,0.0,1234,72921100
002690,동일제강,3730,3765,35,0.94,476176,1816049505
000020,동화약품,9990,10050,60,0.6,50533,506008610
000150,두산,112500,113000,500,0.44,46608,5280502000
000157,두산2우B,74000,74600,600,0.81,94,7000500
011160,두산건설,1810,1820,10,0.55,115080,212374470
241560,두산밥캣,33850,34550,700,2.07,228671,7873686400
000155,두산우,74900,75000,100,0.13,1718,128510500
042670,두산인프라코어,8530,8370,-160,-1.88,1368146,11494144030
034020,두산중공업,11100,10950,-150,-1.35,773897,8627981300
016740,두올,3210,3180,-30,-0.93,102655,327467200
024090,디씨엠,10900,10900,0,0.0,2707,29441500
003160,디아이,4105,4110,5,0.12,102032,419877245
092200,디아이씨,7280,7050,-230,-3.16,260283,1819844010
013570,디와이,6010,6140,130,2.16,88879,543697330
210540,디와이파워,15550,15300,-250,-1.61,98350,1511104600
007340,디티알오토모티브,30900,31000,100,0.32,1877,58289700
026890,디피씨,6410,6360,-50,-0.78,1129707,7209429200
115390,락앤락,19500,19550,50,0.26,73244,1432819700
032350,롯데관광개발,14950,14600,-350,-2.34,346558,5060351100
000400,롯데손해보험,2710,2700,-10,-0.37,205825,554312605
023530,롯데쇼핑,191000,193500,2500,1.31,50186,9666921500
004000,롯데정밀화학,45000,45350,350,0.78,91035,4151842500
286940,롯데정보통신,38550,38500,-50,-0.13,226272,8901189400
280360,롯데제과,170000,171500,1500,0.88,1269,218049000
004990,롯데지주,51700,52100,400,0.77,84396,4391521600
00499K,롯데지주우,51800,52000,200,0.39,1212,62866800
005300,롯데칠성,1433000,1441000,8000,0.56,1104,1593736000
005305,롯데칠성우,636000,635000,-1000,-0.16,20,12658000
011170,롯데케미칼,283500,284500,1000,0.35,132672,37470459000
002270,롯데푸드,635000,639000,4000,0.63,1168,747539000
071840,롯데하이마트,50300,50500,200,0.4,27812,1409768700
027740,마니커,825,829,4,0.48,969279,803210504
204320,만도,30750,32000,1250,4.07,964386,30758669550
001080,만호제강,18650,19400,750,4.02,28421,558589300
088980,맥쿼리인프라,9960,9980,20,0.2,766229,7644429900
094800,맵스리얼티1,3700,3720,20,0.54,45782,169428355
015540,메디파트너생명공학,7500,7310,-190,-2.53,21694,158478090
138040,메리츠금융지주,12400,12250,-150,-1.21,30201,370631700
008560,메리츠종금증권,4705,4765,60,1.28,1694119,8072271765
000060,메리츠화재,22750,23250,500,2.2,116544,2681344800
090370,메타랩스,1840,1800,-40,-2.17,249614,453005955
017180,명문제약,5700,5680,-20,-0.35,182177,1032970910
012690,모나리자,4095,4040,-55,-1.34,531413,2143450245
005360,모나미,2860,2860,0,0.0,19350,55247350
204210,모두투어리츠,3050,3070,20,0.66,1718,5241010
009680,모토닉,11800,11350,-450,-3.81,160431,1870563450
009580,무림PP,6100,6060,-40,-0.66,329696,2003596320
009200,무림페이퍼,3015,3010,-5,-0.17,43575,130828885
033920,무학,14050,13850,-200,-1.42,14648,203921200
008420,문배철강,3675,4010,335,9.12,14375206,59593473175
025560,미래산업,178,177,-1,-0.56,2452702,434869789
007120,미래아이앤지,536,522,-14,-2.61,306138,160819206
006800,미래에셋대우,7520,7540,20,0.27,1293735,9744148440
00680K,미래에셋대우2우B,3715,3730,15,0.4,107692,400534215
006805,미래에셋대우우,4090,4090,0,0.0,84388,345020745
085620,미래에셋생명,4850,4945,95,1.96,281954,1384494455
002840,미원상사,248000,248000,0,0.0,82,20306500
268280,미원에스씨,63800,64100,300,0.47,3510,224636000
107590,미원홀딩스,36900,36900,0,0.0,1641,60683950
134380,미원화학,40800,40800,0,0.0,937,37940050
003650,미창석유,76400,77700,1300,1.7,725,55435400
155900,바다로19호,2900,2905,5,0.17,1030,2984000
003610,방림,2455,2450,-5,-0.2,79421,194457495
001340,백광산업,2740,2735,-5,-0.18,153727,419684830
014580,백광소재,3130,3200,70,2.24,286875,917202375
035150,백산,6820,6920,100,1.47,148559,1028901060
002410,범양건영,2015,1915,-100,-4.96,230178,448867960
096300,베트남개발1,368,368,0,0.0,91282,33583409
007210,벽산,2675,2685,10,0.37,109514,292957715
002760,보락,2400,2385,-15,-0.63,329238,787312460
003850,보령제약,10100,9970,-130,-1.29,109380,1092882030
000890,보해양조,1935,1955,20,1.03,11188257,22143792585
003000,부광약품,24100,23800,-300,-1.24,150613,3599523000
001270,부국증권,21100,21050,-50,-0.24,2437,51267450
001275,부국증권우,19650,19700,50,0.25,341,6717300
026940,부국철강,3445,3620,175,5.08,3953952,14606359105
015350,부산가스,39650,39550,-100,-0.25,2401,94954550
011390,부산산업,183000,180500,-2500,-1.37,25161,4590294500
005030,부산주공,567,573,6,1.06,154053,88006985
100220,비상교육,7040,7240,200,2.84,36141,259279260
005180,빙그레,70100,69400,-700,-1.0,13821,966352000
003960,사조대림,23050,23000,-50,-0.22,7054,161800000
008040,사조동아원,1325,1340,15,1.13,223001,300349635
007160,사조산업,59300,59600,300,0.51,9377,558653000
014710,사조씨푸드,6480,6590,110,1.7,45956,299222850
006090,사조오양,9730,9680,-50,-0.51,34190,329859960
079660,사조해표,10300,10150,-150,-1.46,34832,354928850
005090,삼광글라스,33750,33900,150,0.44,9259,311420900
001470,삼부토건,5180,5080,-100,-1.93,151791,769587140
006400,삼성SDI,236500,236500,0,0.0,360752,85409807500
006405,삼성SDI우,95700,95600,-100,-0.1,3538,337894900
006660,삼성공조,9620,9730,110,1.14,7414,71495770
028260,삼성물산,116500,117000,500,0.43,167821,19680628500
02826K,삼성물산우B,73000,73100,100,0.14,241,17629900
207940,삼성바이오로직스,378500,377000,-1500,-0.4,76581,28905549000
032830,삼성생명,88100,88800,700,0.79,211206,18678657200
018260,삼성에스디에스,222500,220000,-2500,-1.12,97382,21569024500
028050,삼성엔지니어링,16100,15750,-350,-2.17,1438590,22682918600
009150,삼성전기,107000,113000,6000,5.61,2711585,301244194000
009155,삼성전기우,44000,45350,1350,3.07,13505,609331000
005930,삼성전자,45000,46050,1050,2.33,13184367,604234331980
005935,삼성전자우,36000,37150,1150,3.19,1309115,48077532600
001360,삼성제약,2785,2750,-35,-1.26,201604,552686340
010140,삼성중공업,8560,8810,250,2.92,6415719,56240668620
010145,삼성중공우,50500,50500,0,0.0,7428,374457850
016360,삼성증권,33250,33650,400,1.2,173409,5823956000
068290,삼성출판사,16800,16450,-350,-2.08,287875,4781736300
029780,삼성카드,33350,33200,-150,-0.45,40698,1348210400
000810,삼성화재,285500,286000,500,0.18,62555,17860837500
000815,삼성화재우,179000,179000,0,0.0,13893,2483237000
006110,삼아알미늄,4700,4810,110,2.34,328641,1626445035
145990,삼양사,61900,60600,-1300,-2.1,9893,604556300
145995,삼양사우,37200,37300,100,0.27,92,3430000
003230,삼양식품,70200,69100,-1100,-1.57,38223,2665798400
002170,삼양통상,44700,43850,-850,-1.9,1530,67805700
272550,삼양패키징,18950,19800,850,4.49,117625,2289426800
000070,삼양홀딩스,83000,84700,1700,2.05,21308,1817452600
000075,삼양홀딩스우,48100,48200,100,0.21,165,7948950
002810,삼영무역,14600,14800,200,1.37,8694,127810450
005680,삼영전자,12400,12450,50,0.4,23348,290072250
003720,삼영화학,824,825,1,0.12,117912,96364926
023000,삼원강재,2970,3045,75,2.53,67501,205505870
004380,삼익THK,13300,13900,600,4.51,133330,1858182650
002450,삼익악기,1905,1905,0,0.0,316746,602541130
000520,삼일제약,22500,22000,-500,-2.22,41455,917616050
009770,삼정펄프,34800,34650,-150,-0.43,2273,78763550
005500,삼진제약,42000,42000,0,0.0,94138,3937481600
004690,삼천리,99700,99600,-100,-0.1,2804,278784900
001880,삼호,16400,16400,0,0.0,3161,51718800
010960,삼호개발,5910,5870,-40,-0.68,88351,520981070
004450,삼화왕관,45900,46500,600,1.31,362,16620800
009470,삼화전기,23350,23750,400,1.71,97932,2339450500
011230,삼화전자,2965,2940,-25,-0.84,80458,239466815
001820,삼화콘덴서,63500,65000,1500,2.36,287146,18602946800
000390,삼화페인트,6880,6820,-60,-0.87,13642,93038690
041650,상신브레이크,4280,4315,35,0.82,27943,119449390
075180,새론오토모티브,5290,5290,0,0.0,2237,11874770
007540,샘표,37400,37700,300,0.8,26258,978590400
248170,샘표식품,31250,31800,550,1.76,15323,484541700
007860,서연,4235,4235,0,0.0,7102,29958135
200880,서연이화,5040,5070,30,0.6,60021,303950840
017390,서울가스,83400,82500,-900,-1.08,236,19502000
004410,서울식품,185,183,-2,-1.08,936336,172392895
004415,서울식품우,3890,3880,-10,-0.26,31399,122331815
021050,서원,1230,1220,-10,-0.81,93108,111978530
008490,서흥,24950,24500,-450,-1.8,17200,422489650
007610,선도전기,5870,5800,-70,-1.19,271145,1588173630
136490,선진,11750,11500,-250,-2.13,22401,257457150
002820,선창산업,6250,6140,-110,-1.76,7978,49134510
014910,성문전자,3260,3565,305,9.36,2533068,8769851375
014915,성문전자우,18000,18850,850,4.72,128299,2386987250
003080,성보화학,5720,5690,-30,-0.52,14102,80193400
004980,성신양회,14150,13850,-300,-2.12,512859,7208043150
004987,성신양회2우B,18500,17700,-800,-4.32,13338,239279250
004989,성신양회3우B,12250,12000,-250,-2.04,1506,17792350
004985,성신양회우,14550,13950,-600,-4.12,64636,914517800
011300,성안,640,650,10,1.56,455987,294470222
000180,성창기업지주,2180,2170,-10,-0.46,65582,141280860
002420,세기상사,70200,79300,9100,12.96,13736,1081974300
004360,세방,13150,13150,0,0.0,17419,228952450
004365,세방우,6500,6500,0,0.0,1839,11944830
004490,세방전지,37900,38450,550,1.45,42213,1617309900
001430,세아베스틸,18050,17800,-250,-1.39,27693,496711750
306200,세아제강,65400,65700,300,0.46,2175,142151100
003030,세아제강지주,53900,52800,-1100,-2.04,7130,377358900
019440,세아특수강,15050,15150,100,0.66,3098,46727200
058650,세아홀딩스,96100,95800,-300,-0.31,382,36556400
013000,세우글로벌,2160,2005,-155,-7.18,7713767,16095103760
091090,세원셀론텍,3775,3900,125,3.31,2184873,8699216305
021820,세원정공,7700,7530,-170,-2.21,6559,49728270
067830,세이브존IC,3905,3985,80,2.05,79482,317086195
033530,세종공업,7490,7320,-170,-2.27,534161,4018606500
075580,세진중공업,4400,4535,135,3.07,235789,1056027835
027970,세하,1460,1455,-5,-0.34,83665,124559770
145210,세화아이엠씨,2990,2990,0,0.0,0,0
068270,셀트리온,215500,212500,-3000,-1.39,455550,96778522500
004430,송원산업,20750,21250,500,2.41,176704,3739319150
017550,수산중공업,2015,2065,50,2.48,3812230,7885204665
002200,수출포장,19550,19650,100,0.51,5748,111863100
053210,스카이라이프,11500,11650,150,1.3,57344,665640050
134790,시디즈,41000,40250,-750,-1.83,3608,143789650
016590,신대양제지,66400,66200,-200,-0.3,25301,1667747100
029530,신도리코,48850,48650,-200,-0.41,6212,302931250
004970,신라교역,14100,14100,0,0.0,8284,116356900
011930,신성이엔지,1085,1090,5,0.46,430132,463721705
005390,신성통상,969,977,8,0.83,317516,306943995
004170,신세계,251500,256500,5000,1.99,57147,14508743500
035510,신세계IC,127000,128500,1500,1.18,11258,1437097000
034300,신세계건설,25700,26000,300,1.17,5979,154706000
031430,신세계인터내셔날,210000,203000,-7000,-3.33,54763,11137837500
031440,신세계푸드,89500,89300,-200,-0.22,17608,1553043200
006880,신송홀딩스,4730,4730,0,0.0,1842,8668180
005800,신영와코루,134000,137500,3500,2.61,183,24640000
001720,신영증권,59900,59600,-300,-0.5,5549,331609000
001725,신영증권우,55800,55700,-100,-0.18,1198,66687900
009270,신원,2950,2945,-5,-0.17,2680711,7952399020
009275,신원우,68100,68300,200,0.29,922,63259500
002700,신일산업,1495,1500,5,0.33,414362,618145600
019170,신풍제약,8010,8050,40,0.5,1281439,10282637090
019175,신풍제약우,6760,6810,50,0.74,15384,103661860
002870,신풍제지,1395,1410,15,1.08,114278,160535140
005450,신한,4945,4945,0,0.0,0,0
293940,신한알파리츠,5660,5710,50,0.88,65312,371554720
055550,신한지주,43300,42450,-850,-1.96,1452233,61895293750
001770,신화실업,21500,21900,400,1.86,1976,43012950
004080,신흥,10150,10150,0,0.0,4290,43258050
102280,쌍방울,1130,1130,0,0.0,533190,599486765
003410,쌍용양회,6890,6820,-70,-1.02,773673,5313769780
003415,쌍용양회우,7000,6560,-440,-6.29,225014,1521750250
003620,쌍용차,5220,5020,-200,-3.83,255075,1297390260
004770,써니전자,3020,3040,20,0.66,5076590,15747059510
004920,씨아이테크,561,571,10,1.78,2586191,1529350353
112610,씨에스윈드,29800,29300,-500,-1.68,32677,963024550
008700,아남전자,2830,2760,-70,-2.47,1440308,4006373025
002790,아모레G,63900,62900,-1000,-1.56,128263,8081341400
002795,아모레G우,28000,28100,100,0.36,6534,182478100
090430,아모레퍼시픽,171500,170000,-1500,-0.87,163002,27789791000
090435,아모레퍼시픽우,95700,95600,-100,-0.1,5423,516630600
002030,아세아,129000,130500,1500,1.16,2798,362939500
183190,아세아시멘트,136000,135000,-1000,-0.74,13343,1788542000
002310,아세아제지,32550,32350,-200,-0.61,37798,1210078600
267850,아시아나IDT,14750,14500,-250,-1.69,68520,1005534050
020560,아시아나항공,4370,4325,-45,-1.03,282479,1226079365
122900,아이마켓코리아,7660,7850,190,2.48,65722,506253760
010780,아이에스동서,30850,31000,150,0.49,48564,1491966750
033660,아주캐피탈,8690,8890,200,2.3,98812,874050730
101140,아티스,4715,4850,135,2.86,348723,1670776955
001780,알루코,3150,3180,30,0.95,185679,589171860
002250,알보젠코리아,28400,28550,150,0.53,3902,111116800
018250,애경산업,39450,39900,450,1.14,119982,4795255550
161000,애경유화,9180,9400,220,2.4,145756,1363918620
011090,에넥스,1395,1400,5,0.36,450566,634868690
005850,에스엘,19950,19300,-650,-3.26,70793,1383828700
012750,에스원,104500,103000,-1500,-1.44,44072,4546984500
023960,에쓰씨엔지니어링,1665,1695,30,1.8,38268,64795760
298690,에어부산,4520,4580,60,1.33,289876,1332020770
140910,에이리츠,5770,5770,0,0.0,18853,108364270
078520,에이블씨엔씨,11550,11550,0,0.0,65222,751806100
015260,에이엔피,410,410,0,0.0,146591,60018245
007460,에이프로젠KIC,2830,2695,-135,-4.77,6457788,17443651865
003060,에이프로젠제약,2560,2520,-40,-1.56,432858,1095413630
036570,엔씨소프트,452500,433500,-19000,-4.2,313420,136575685500
138250,엔에스쇼핑,13350,13200,-150,-1.12,22828,301661200
085310,엔케이,2060,2060,0,0.0,4440412,9540386495
009810,엔케이물산,910,789,-121,-13.3,6900162,5675513164
900140,엘브이엠씨홀딩스,2930,2870,-60,-2.05,267889,776230775
014440,영보화학,3910,3905,-5,-0.13,14730,57100025
111770,영원무역,34300,34450,150,0.44,66738,2305187700
009970,영원무역홀딩스,60800,60800,0,0.0,1824,110792500
003520,영진약품,6590,6440,-150,-2.28,718223,4650516200
000670,영풍,757000,752000,-5000,-0.66,606,456520000
006740,영풍제지,3615,3585,-30,-0.83,55458,198942210
012280,영화금속,1585,1680,95,5.99,6212298,10330482200
012160,영흥철강,1410,1650,240,17.02,23539671,38778938000
015360,예스코홀딩스,41950,42100,150,0.36,714,29986550
007310,오뚜기,788000,778000,-10000,-1.27,2699,2102429000
079440,오렌지라이프,30750,33500,2750,8.94,765075,25967065850
002630,오리엔트바이오,572,564,-8,-1.4,1376741,780125132
271560,오리온,110500,111500,1000,0.9,62352,6955496000
001800,오리온홀딩스,18350,18200,-150,-0.82,50374,922521500
070960,용평리조트,11200,10800,-400,-3.57,2997061,32818061250
004720,우리들제약,8570,8460,-110,-1.28,185863,1567929300
118000,우리들휴브레인,2920,2900,-20,-0.68,294041,859101115
000030,우리은행,14800,14800,0,0.0,0,0
010050,우리종금,802,811,9,1.12,3924208,3157819812
006980,우성사료,2970,2970,0,0.0,63328,187935700
017370,우신시스템,6740,6740,0,0.0,19102,128470980
105840,우진,6970,6800,-170,-2.44,1542461,10633771810
010400,우진아이엔에스,10700,10700,0,0.0,60873,643325050
049800,우진플라임,6790,6720,-70,-1.03,274668,1850169350
016880,웅진,2330,2315,-15,-0.64,205910,476809970
095720,웅진씽크빅,3165,3090,-75,-2.37,1020379,3180662760
103130,웅진에너지,1735,1695,-40,-2.31,256409,432419195
005820,원림,18400,18650,250,1.36,1346,24799650
010600,웰바이오텍,4990,4935,-55,-1.1,215291,1070300250
008600,윌비스,1390,1410,20,1.44,293883,412477600
033270,유나이티드제약,24550,24600,50,0.2,48850,1200253950
014830,유니드,46250,45950,-300,-0.65,14958,687386200
000910,유니온,5150,5370,220,4.27,2090902,11421540570
047400,유니온머티리얼,2055,2050,-5,-0.24,182745,379468450
011330,유니켐,1775,1835,60,3.38,4164799,7665808180
077500,유니퀘스트,7060,7180,120,1.7,42277,302404100
002920,유성기업,2920,2870,-50,-1.71,12676,36544845
000700,유수홀딩스,8200,8330,130,1.59,65317,539791000
003470,유안타증권,3360,3360,0,0.0,143036,480466050
003475,유안타증권우,2280,2270,-10,-0.44,8705,19915155
011690,유양디앤유,8490,8390,-100,-1.18,166186,1402122930
072130,유엔젤,4280,4140,-140,-3.27,129744,544011260
000220,유유제약,12000,11900,-100,-0.83,35875,428023400
000225,유유제약1우,7290,7290,0,0.0,4249,30972300
000227,유유제약2우B,19250,18950,-300,-1.56,776,14740400
001200,유진투자증권,2755,2780,25,0.91,127407,352931865
000100,유한양행,244000,244000,0,0.0,51852,12680860500
000105,유한양행우,213500,212000,-1500,-0.7,169,36130000
003460,유화증권,12750,12800,50,0.39,5314,67902000
003465,유화증권우,12450,12450,0,0.0,931,11548400
008730,율촌화학,14500,15350,850,5.86,238997,3509121350
008250,이건산업,12500,13000,500,4.0,496818,6387596050
025820,이구산업,2155,2195,40,1.86,199599,435896010
214320,이노션,71700,67500,-4200,-5.86,802741,54522944350
088260,이리츠코크렙,4825,4800,-25,-0.52,50726,243685045
139480,이마트,175500,172500,-3000,-1.71,191758,33107701500
007660,이수페타시스,6410,6250,-160,-2.5,1022212,6400550380
005950,이수화학,10050,9980,-70,-0.7,60399,604618520
015020,이스타코,696,704,8,1.15,109370,76034634
093230,이아이디,201,202,1,0.5,324341,65383384
102460,이연제약,16000,15900,-100,-0.63,21662,343170900
084680,이월드,2645,2730,85,3.21,3075611,8365602950
000760,이화산업,20400,20900,500,2.45,964,19992350
014990,인디에프,3860,3750,-110,-2.85,832993,3182688660
006490,인스코비,5740,5740,0,0.0,1022073,5856878330
023800,인지컨트롤스,8630,8210,-420,-4.87,792761,6717310480
034590,인천도시가스,29000,29100,100,0.34,1449,42152900
129260,인터지스,2830,2800,-30,-1.06,216194,603916905
023810,인팩,3565,3970,405,11.36,1431008,5923927420
249420,일동제약,20000,19850,-150,-0.75,58113,1151836750
000230,일동홀딩스,12600,12850,250,1.98,3447,43943550
013360,일성건설,2295,2185,-110,-4.79,2197459,4905022000
003120,일성신약,94900,95200,300,0.32,408,38711600
003200,일신방직,96900,97300,400,0.41,815,79061900
007110,일신석재,3715,3590,-125,-3.36,6252718,22717685350
007570,일양약품,29900,29250,-650,-2.17,38695,1139454150
007575,일양약품우,19250,19400,150,0.78,778,14977150
008500,일정실업,20850,20950,100,0.48,1236,25867700
081000,일진다이아,40200,38850,-1350,-3.36,533897,21516933300
020760,일진디스플,3805,3785,-20,-0.53,131876,500699670
020150,일진머티리얼즈,42600,42950,350,0.82,380524,16415271750
103590,일진전기,3690,3710,20,0.54,96883,359047465
015860,일진홀딩스,4120,4030,-90,-2.18,172669,708811810
226320,잇츠한불,26700,27050,350,1.31,62478,1683285050
033240,자화전자,13500,13800,300,2.22,175694,2424108250
000950,전방,18850,18450,-400,-2.12,893,16620800
194370,제이에스코퍼레이션,12600,12450,-150,-1.19,12437,155471800
025620,제이준코스메틱,10300,10350,50,0.49,269231,2777561560
030000,제일기획,25000,24650,-350,-1.4,243166,5996019550
271980,제일약품,46200,45500,-700,-1.52,37072,1687285900
001560,제일연마,6520,6530,10,0.15,1515,9872120
002620,제일파마홀딩스,25900,25300,-600,-2.32,9608,244063600
006220,제주은행,4855,4850,-5,-0.1,14088,68360675
089590,제주항공,32750,32900,150,0.46,56586,1847523200
004910,조광페인트,7470,7450,-20,-0.27,33358,249879540
004700,조광피혁,37450,37150,-300,-0.8,1346,50270300
001550,조비,30800,30650,-150,-0.49,97673,3037746050
000480,조선내화,82900,84400,1500,1.81,1782,150457800
120030,조선선재,92700,97400,4700,5.07,13539,1312192100
018470,조일알미늄,1060,1060,0,0.0,372968,399950145
002600,조흥,180500,180500,0,0.0,0,0
185750,종근당,105500,104000,-1500,-1.42,29239,3044412000
063160,종근당바이오,21500,21950,450,2.09,12504,274180700
001630,종근당홀딩스,64000,64300,300,0.47,6127,396475100
044380,주연테크,392,390,-2,-0.51,549786,214350283
013870,지엠비코리아,8670,8560,-110,-1.27,649923,5718187730
071320,지역난방공사,57400,57100,-300,-0.52,4192,239455400
010580,지코,785,788,3,0.38,262546,205736849
035000,지투알,8010,8000,-10,-0.12,14556,115968950
088790,진도,4900,4905,5,0.1,6827,33463690
003780,진양산업,4350,4290,-60,-1.38,1221724,5492187265
010640,진양폴리,2415,2495,80,3.31,279704,701081940
100250,진양홀딩스,2670,2700,30,1.12,59621,161074150
051630,진양화학,5920,6010,90,1.52,2580640,16127187350
272450,진에어,20550,20850,300,1.46,120971,2495757700
011000,진원생명과학,5030,4970,-60,-1.19,197666,987957330
002780,진흥기업,2090,2090,0,0.0,99138,209115780
002787,진흥기업2우B,11800,12300,500,4.24,52921,653318000
002785,진흥기업우B,4920,4970,50,1.02,41147,206730350
009310,참엔지니어링,1660,1690,30,1.81,218071,366560270
000650,천일고속,75800,75200,-600,-0.79,1216,91731800
012600,청호컴넷,2790,2800,10,0.36,4296,12093105
033250,체시스,958,951,-7,-0.73,133804,127757054
035720,카카오,95600,96000,400,0.42,599314,56677483100
006380,카프로,4980,5020,40,0.8,127477,635287960
109070,컨버즈,4195,4100,-95,-2.26,95037,392812340
029460,케이씨,13600,13900,300,2.21,133231,1847452200
281820,케이씨텍,12500,13450,950,7.6,184201,2400632950
145270,케이탑리츠,1045,1030,-15,-1.44,805121,833725770
058860,케이티스,2955,2995,40,1.35,990720,2982721055
007815,코리아써우,2795,2795,0,0.0,222,620420
007810,코리아써키트,6030,6250,220,3.65,127711,798931860
00781K,코리아써키트2우B,4235,4235,0,0.0,411,1740935
152330,코리아오토글라스,13400,13400,0,0.0,64911,876061100
003690,코리안리,8740,8710,-30,-0.34,207043,1812733060
192820,코스맥스,126500,126500,0,0.0,38773,4943571500
044820,코스맥스비티아이,19500,19250,-250,-1.28,19784,384437500
005070,코스모신소재,15500,15950,450,2.9,555022,8921940950
005420,코스모화학,15900,16850,950,5.97,1123555,18822838450
071950,코아스,1760,1740,-20,-1.14,2210721,4008183450
002020,코오롱,33650,33700,50,0.15,9041,303738150
003070,코오롱글로벌,8180,8230,50,0.61,9139,75183490
003075,코오롱글로벌우,15450,15300,-150,-0.97,2079,31674300
144620,코오롱머티리얼,3565,3400,-165,-4.63,670864,2372661615
002025,코오롱우,18200,18100,-100,-0.55,240,4321850
120110,코오롱인더,58900,59100,200,0.34,122198,7214824200
120115,코오롱인더우,25300,25350,50,0.2,1368,34417400
138490,코오롱플라스틱,6550,6500,-50,-0.76,39929,259240750
021240,코웨이,83600,83200,-400,-0.48,188943,15658067900
031820,콤텍시스템,1525,1565,40,2.62,1167439,1817608175
192400,쿠쿠홀딩스,124000,125000,1000,0.81,3775,475833000
284740,쿠쿠홈시스,172000,171500,-500,-0.29,2935,504748500
015590,큐로,548,550,2,0.36,155050,84734419
264900,크라운제과,10900,10750,-150,-1.38,40792,435381750
26490K,크라운제과우,8070,8040,-30,-0.37,2386,19207120
005740,크라운해태홀딩스,14400,14000,-400,-2.78,244242,3444384400
005745,크라운해태홀딩스우,14400,14100,-300,-2.08,65984,927947950
020120,키다리스튜디오,2485,2590,105,4.23,64778,165712530
039490,키움증권,83700,83000,-700,-0.84,91916,7655684100
012170,키위미디어그룹,368,346,-22,-5.98,5572930,1966281912
015890,태경산업,5880,5880,0,0.0,154670,919004630
006890,태경화학,5200,5240,40,0.77,70870,372484740
003240,태광산업,1445000,1454000,9000,0.62,1140,1667340000
011280,태림포장,4120,4390,270,6.55,4233666,19510186185
004100,태양금속,1625,1570,-55,-3.38,588294,936226300
004105,태양금속우,3570,3555,-15,-0.42,31627,112856135
009410,태영건설,12350,13050,700,5.67,706018,9074454050
009415,태영건설우,6370,6490,120,1.88,43731,280346490
001420,태원물산,6400,6380,-20,-0.31,32593,206928760
007980,태평양물산,2565,2605,40,1.56,85304,220296735
055490,테이팩스,22950,22800,-150,-0.65,20759,479548200
078000,텔코웨어,13700,13950,250,1.82,61429,854840100
214420,토니모리,12000,11900,-100,-0.83,41696,499401450
140890,트러스제7호,3015,3015,0,0.0,2937,8831770
019180,티에이치엔,2755,2730,-25,-0.91,130172,358906565
091810,티웨이항공,7280,7250,-30,-0.41,116233,843611340
004870,티웨이홀딩스,2605,2585,-20,-0.77,156777,406335150
005690,파미셀,11650,11950,300,2.58,5791554,69164209700
036580,팜스코,7970,7850,-120,-1.51,46391,365458490
028670,팬오션,4240,4225,-15,-0.35,1140700,4829064355
010820,퍼스텍,3430,3405,-25,-0.73,496777,1708106490
016800,퍼시스,30950,30950,0,0.0,1302,40246150
001020,페이퍼코리아,1055,1040,-15,-1.42,100792,104586985
090080,평화산업,2695,2700,5,0.19,506852,1370385575
010770,평화홀딩스,7150,7000,-150,-2.1,167057,1207960250
058430,포스코강판,20550,20550,0,0.0,3330,68274650
047050,포스코대우,19350,19100,-250,-1.29,236553,4519621350
007630,폴루스바이오팜,4245,4180,-65,-1.53,464733,1945137040
017810,풀무원,82500,81300,-1200,-1.45,5762,471286300
103140,풍산,28450,28550,100,0.35,82461,2349526650
005810,풍산홀딩스,38000,38200,200,0.53,2811,106934250
033180,필룩스,12150,11850,-300,-2.47,857824,10278054900
086790,하나금융지주,40200,39750,-450,-1.12,1201997,47754645800
099340,하나니켈1호,1170,1165,-5,-0.43,11870,13761175
099350,하나니켈2호,1530,1515,-15,-0.98,11227,16891470
293480,하나제약,24550,24450,-100,-0.41,69561,1692572050
039130,하나투어,65800,65900,100,0.15,83166,5491946700
172580,하이골드12호,2890,2885,-5,-0.17,10623,30602725
153360,하이골드3호,1880,1880,0,0.0,31817,59820740
159650,하이골드8호,1265,1320,55,4.35,1027043,1429551270
071090,하이스틸,32450,32550,100,0.31,19923,649498050
019490,하이트론,3710,3745,35,0.94,3984,14688550
000080,하이트진로,17300,17200,-100,-0.58,148417,2567863350
000087,하이트진로2우B,14650,14550,-100,-0.68,200,2919950
000140,하이트진로홀딩스,7820,7780,-40,-0.51,4306,33486850
000145,하이트진로홀딩스우,8110,8250,140,1.73,265,2159490
152550,한국ANKOR유전,1755,1750,-5,-0.28,22647,39555915
036460,한국가스공사,53900,53300,-600,-1.11,122381,6522788200
005430,한국공항,46100,46150,50,0.11,1815,83553000
071050,한국금융지주,61700,62300,600,0.97,150458,9316813550
071055,한국금융지주우,35700,35650,-50,-0.14,6303,222839600
010040,한국내화,9320,9260,-60,-0.64,2965882,28271983920
025540,한국단자,43900,47050,3150,7.18,110134,5271178500
004090,한국석유,162000,161500,-500,-0.31,4514,724245000
002960,한국쉘석유,329000,328500,-500,-0.15,663,219190500
123890,한국자산신탁,4425,4400,-25,-0.56,32293,142124755
015760,한국전력,34350,34050,-300,-0.87,1002254,34171580800
006200,한국전자홀딩스,826,814,-12,-1.45,98405,80384358
002300,한국제지,19350,19500,150,0.78,8965,172949650
023350,한국종합기술,6970,6860,-110,-1.58,260283,1805610670
025890,한국주강,2300,2305,5,0.22,82721,192479590
000970,한국주철관,10600,11200,600,5.66,401790,4409137050
104700,한국철강,5710,5660,-50,-0.88,48808,276802850
017960,한국카본,7700,7980,280,3.64,611654,4830438030
161890,한국콜마,65900,65900,0,0.0,57091,3777796300
024720,한국콜마홀딩스,29850,29900,50,0.17,23134,694525650
161390,한국타이어,41250,41000,-250,-0.61,307839,12681035377
000240,한국타이어월드와이드,15650,15900,250,1.6,85626,1361888050
034830,한국토지신탁,2585,2575,-10,-0.39,237192,612554905
007280,한국특수형강,2280,2330,50,2.19,69149,160145550
168490,한국패러랠,2450,2460,10,0.41,6127,15022430
010100,한국프랜지,1795,1760,-35,-1.95,49318,86681540
047810,한국항공우주,33950,33150,-800,-2.36,566768,18917420700
123690,한국화장품,11850,11750,-100,-0.84,92643,1091223900
003350,한국화장품제조,36850,36900,50,0.14,15930,587648850
011500,한농화성,4290,4300,10,0.23,11636,49915420
002390,한독,27800,27200,-600,-2.16,51119,1395195000
014790,한라,5330,5220,-110,-2.06,253603,1332655390
060980,한라홀딩스,41300,42800,1500,3.63,27297,1164399250
053690,한미글로벌,13050,13800,750,5.75,2048749,28532996350
042700,한미반도체,7830,8510,680,8.68,514909,4250783430
008930,한미사이언스,77300,76100,-1200,-1.55,48677,3704145900
128940,한미약품,467000,459500,-7500,-1.61,42738,19766546500
009240,한샘,75800,75800,0,0.0,197564,15080429900
020000,한섬,37200,35550,-1650,-4.44,90643,3288607550
003680,한성기업,6340,6270,-70,-1.1,9213,57790140
105630,한세실업,20150,20100,-50,-0.25,62437,1263026500
069640,한세엠케이,7890,7750,-140,-1.77,24003,185714710
016450,한세예스24홀딩스,8150,8300,150,1.84,54959,454335700
010420,한솔PNS,1500,1545,45,3.0,313357,484458040
009180,한솔로지스틱스,1590,1590,0,0.0,355494,562496920
213500,한솔제지,17200,16950,-250,-1.45,114268,1943774300
014680,한솔케미칼,85700,86900,1200,1.4,49365,4281717700
004710,한솔테크닉스,7310,8100,790,10.81,571402,4537900450
004150,한솔홀딩스,4980,4985,5,0.1,74206,368376135
025750,한솔홈데코,1610,1630,20,1.24,1477922,2396679830
004960,한신공영,18800,19000,200,1.06,34172,649377200
011700,한신기계,2450,2495,45,1.84,1454376,3878721805
001750,한양증권,7040,7090,50,0.71,11428,80095940
001755,한양증권우,7820,7730,-90,-1.15,797,6198400
018880,한온시스템,12300,12350,50,0.41,684961,8489334950
009420,한올바이오파마,38600,36650,-1950,-5.05,917167,33972408250
014130,한익스프레스,4900,5060,160,3.27,52094,261755525
300720,한일시멘트,141000,138000,-3000,-2.13,7206,998043000
002220,한일철강,21000,21650,650,3.1,3208,68790150
006390,한일현대시멘트,55700,54300,-1400,-2.51,59896,3291212200
003300,한일홀딩스,64900,61500,-3400,-5.24,12373,774003100
051600,한전KPS,33800,33600,-200,-0.59,123714,4170912100
052690,한전기술,25800,25700,-100,-0.39,67313,1746926350
130660,한전산업,4055,4150,95,2.34,281154,1167959700
002320,한진,42750,43650,900,2.11,145853,6359041550
097230,한진중공업,1190,1195,5,0.42,4051078,4937207575
003480,한진중공업홀딩스,2935,2890,-45,-1.53,98297,283428620
180640,한진칼,26600,26850,250,0.94,316356,8479695000
18064K,한진칼우,16700,16700,0,0.0,10382,172537100
005110,한창,2405,2390,-15,-0.62,3547622,8492199340
009460,한창제지,3380,3565,185,5.47,13568841,47901987670
000880,한화,33350,33450,100,0.3,176156,5834948300
00088K,한화3우B,15300,15200,-100,-0.65,25321,386239200
027390,한화갤러리아타임월드,28350,28550,200,0.71,8899,254253950
088350,한화생명,4185,4250,65,1.55,1320264,5577301625
000370,한화손해보험,5390,5360,-30,-0.56,84354,452672930
012450,한화에어로스페이스,32350,31700,-650,-2.01,212293,6758752150
000885,한화우,21650,21100,-550,-2.54,6221,132080700
009830,한화케미칼,21700,21350,-350,-1.61,1002925,21270705400
009835,한화케미칼우,12100,11900,-200,-1.65,6377,76211600
003530,한화투자증권,2430,2435,5,0.21,177462,430527785
003535,한화투자증권우,2375,2395,20,0.84,11153,26537595
195870,해성디에스,13500,13550,50,0.37,27606,374443050
101530,해태제과식품,10850,10850,0,0.0,29382,317254700
143210,핸즈코퍼레이션,6700,6830,130,1.94,9909,66900390
000720,현대건설,64000,63000,-1000,-1.56,598606,38033918900
267270,현대건설기계,55300,55100,-200,-0.36,95716,5303010400
000725,현대건설우,238000,227000,-11000,-4.62,4557,1050442500
005440,현대그린푸드,13800,13600,-200,-1.45,435503,5887697500
086280,현대글로비스,138000,140000,2000,1.45,54703,7597985500
064350,현대로템,28800,28500,-300,-1.04,927003,26727689650
079430,현대리바트,19300,18800,-500,-2.59,205402,3879288450
012330,현대모비스,219500,222000,2500,1.14,211222,47021308000
010620,현대미포조선,61400,61500,100,0.16,241678,14921213200
069960,현대백화점,91100,92400,1300,1.43,89215,8215486300
004560,현대비앤지스틸,10800,10900,100,0.93,33915,365851050
004565,현대비앤지스틸우,68000,67000,-1000,-1.47,4069,268211800
011760,현대상사,33450,33000,-450,-1.35,159168,5314206300
011200,현대상선,4410,4265,-145,-3.29,1697278,7313676585
004310,현대약품,5300,5130,-170,-3.21,314112,1621889820
126560,현대에이치씨엔,4165,4265,100,2.4,134999,575669510
017800,현대엘리베이,120000,119000,-1000,-0.83,517135,62286620000
011210,현대위아,42300,42650,350,0.83,83031,3546513900
267260,현대일렉트릭,29850,29800,-50,-0.17,118149,3516742250
004020,현대제철,49400,50100,700,1.42,250213,12525899150
009540,현대중공업,131500,130500,-1000,-0.76,299199,39424287500
267250,현대중공업지주,356500,356500,0,0.0,43794,15627641000
005380,현대차,127500,128500,1000,0.78,443035,56812181500
005387,현대차2우B,85500,87600,2100,2.46,70605,6090784500
005389,현대차3우B,72000,72700,700,0.97,2196,158713500
005385,현대차우,77500,78700,1200,1.55,25486,1981649100
001500,현대차증권,10000,10000,0,0.0,26280,262207190
227840,현대코퍼레이션홀딩스,17900,18000,100,0.56,50190,894268950
001450,현대해상,37600,38450,850,2.26,249818,9504118050
057050,현대홈쇼핑,101500,103000,1500,1.48,18169,1882144500
093240,형지엘리트,2005,2350,345,17.21,7265484,17631042300
003010,혜인,7750,7660,-90,-1.16,479655,3764152120
111110,호전실업,10600,10650,50,0.47,11307,119498850
008770,호텔신라,72400,72900,500,0.69,534740,38946067800
008775,호텔신라우,44100,43950,-150,-0.34,8967,394144900
002460,화성산업,15200,15100,-100,-0.66,18054,273471450
013520,화승알앤에이,2045,2070,25,1.22,44327,91069970
241590,화승엔터프라이즈,9520,9730,210,2.21,186741,1827480370
006060,화승인더,6660,6780,120,1.8,420492,2818877340
010690,화신,2650,2630,-20,-0.75,43828,114941950
133820,화인베스틸,3180,3280,100,3.14,1820003,5986078310
010660,화천기계,20700,20250,-450,-2.17,25592,521596850
000850,화천기공,42500,42700,200,0.47,8796,376132800
016580,환인제약,19450,19100,-350,-1.8,13863,266427650
032560,황금에스티,11400,11450,50,0.44,178035,2019168800
004800,효성,68800,69000,200,0.29,153239,10672929400
094280,효성ITX,10700,10750,50,0.47,6137,65399600
298040,효성중공업,46950,46000,-950,-2.02,81828,3850760600
298050,효성첨단소재,116000,122000,6000,5.17,32760,3949912000
298020,효성티앤씨,165500,165000,-500,-0.3,11062,1833162000
298000,효성화학,151000,153500,2500,1.66,10283,1561474000
093370,후성,8130,8160,30,0.37,361876,2963198710
081660,휠라코리아,44250,44300,50,0.11,295569,13147502950
005870,휴니드,8720,8700,-20,-0.23,11020,95836450
079980,휴비스,7610,7650,40,0.53,79069,604306700
005010,휴스틸,12800,12800,0,0.0,35391,458988200
069260,휴켐스,21700,21750,50,0.23,81179,1763572650
000540,흥국화재,4925,4920,-5,-0.1,32748,159580645
000547,흥국화재2우B,24850,25000,150,0.6,845,21039800
000545,흥국화재우,5570,5520,-50,-0.9,4017,22451140
003280,흥아해운,428,422,-6,-1.4,485028,205017938
