티커,종목명,시가,종가,변동폭,등락률,거래량,거래대금
095570,AJ네트웍스,5390,5430,40,0.74,51558,278741310
068400,AJ렌터카,10250,10100,-150,-1.46,131002,1317320510
006840,AK홀딩스,52700,50900,-1800,-3.42,70104,3611144500
027410,BGF,7690,7400,-290,-3.77,381918,2858433740
282330,BGF리테일,200500,190500,-10000,-4.99,27869,5374802390
138930,BNK금융지주,7020,6930,-90,-1.28,861367,5988463160
001460,BYC,237000,233500,-3500,-1.48,1375,320779500
001465,BYC우,138500,133500,-5000,-3.61,204,27405000
001040,CJ,101000,100500,-500,-0.5,63514,6369970400
079160,CJCGV,36300,35300,-1000,-2.75,100431,3573922500
000120,CJ대한통운,152000,152000,0,0.0,36431,5522518500
011150,CJ씨푸드,2705,2735,30,1.11,905388,2449752150
011155,CJ씨푸드1우,33050,32900,-150,-0.45,10759,351305150
001045,CJ우,52700,51700,-1000,-1.9,7159,367475800
097950,CJ제일제당,284500,282500,-2000,-0.7,19861,5598124500
097955,CJ제일제당우,124500,123500,-1000,-0.8,1113,137649500
037560,CJ헬로,7440,7160,-280,-3.76,279578,2024569840
000590,CS홀딩스,62800,62600,-200,-0.32,127,7896800
012030,DB,932,915,-17,-1.82,827419,761640415
016610,DB금융투자,4895,4840,-55,-1.12,48266,233608395
005830,DB손해보험,62300,61400,-900,-1.44,94120,5763215700
000990,DB하이텍,15000,14450,-550,-3.67,422175,6156133900
000995,DB하이텍1우,43400,42500,-900,-2.07,1965,84012400
139130,DGB금융지주,8130,8050,-80,-0.98,3163908,25472649235
001530,DI동일,87600,86200,-1400,-1.6,4685,401399400
004840,DRB동일,5940,5920,-20,-0.34,11193,65374730
155660,DSR,4715,4695,-20,-0.42,241577,1144214835
069730,DSR제강,4660,4590,-70,-1.5,119234,550082355
017940,E1,55300,56400,1100,1.99,9119,512852500
007700,FF,82600,81400,-1200,-1.45,151686,12283132800
114090,GKL,20350,20150,-200,-0.98,96027,1935398550
078930,GS,49950,49400,-550,-1.1,176576,8749638900
006360,GS건설,40400,39700,-700,-1.73,391483,15504281800
001250,GS글로벌,2690,2675,-15,-0.56,170874,455293490
007070,GS리테일,35300,34500,-800,-2.27,158437,5517931700
078935,GS우,36850,36600,-250,-0.68,3191,116661750
012630,HDC,15850,15600,-250,-1.58,496431,7659065400
039570,HDC아이콘트롤스,9940,9820,-120,-1.21,13198,128909730
089470,HDC현대EP,5160,5140,-20,-0.39,108207,562241300
294870,HDC현대산업개발,41300,42000,700,1.69,164351,6837089950
082740,HSD엔진,3835,3725,-110,-2.87,123072,459128340
003560,IHQ,1990,1885,-105,-5.28,2101274,4029896785
175330,JB금융지주,5310,5450,140,2.64,687372,3719180620
234080,JW생명과학,25550,25150,-400,-1.57,98655,2512893900
001060,JW중외제약,32550,31600,-950,-2.92,50793,1612394550
001067,JW중외제약2우B,45500,44500,-1000,-2.2,95,4247950
001065,JW중외제약우,27200,26850,-350,-1.29,1642,43836150
096760,JW홀딩스,6320,6230,-90,-1.42,63192,395462300
105560,KB금융,45800,45150,-650,-1.42,1160785,52179178899
002380,KCC,257000,254500,-2500,-0.97,26727,6841287500
009070,KCTC,3210,3100,-110,-3.43,84737,263747670
009440,KC그린홀딩스,4620,4430,-190,-4.11,101377,453848650
119650,KC코트렐,6910,6760,-150,-2.17,166931,1128116130
092220,KEC,1205,1160,-45,-3.73,5251759,6121946570
001390,KG케미칼,12350,11850,-500,-4.05,79665,950249450
001940,KISCO홀딩스,13700,13700,0,0.0,8963,122153450
025000,KPX케미칼,55600,54700,-900,-1.62,1990,109025400
092230,KPX홀딩스,57600,57600,0,0.0,480,27703300
000040,KR모터스,527,535,8,1.52,245875,130649047
044450,KSS해운,6720,6620,-100,-1.49,46846,307033160
030200,KT,28050,27900,-150,-0.53,1658203,46168388520
033780,KTG,99400,98500,-900,-0.91,258276,25482974500
030210,KTB투자증권,2920,2840,-80,-2.74,134987,384266300
058850,KTcs,2250,2230,-20,-0.89,46701,103854095
058860,KTis,2400,2375,-25,-1.04,42050,99687105
093050,LF,21900,21700,-200,-0.91,100017,2158050700
003550,LG,72200,71100,-1100,-1.52,199326,14262865200
034220,LG디스플레이,16900,16450,-450,-2.66,1524018,25181562750
001120,LG상사,16150,15700,-450,-2.79,197717,3128141650
051900,LG생활건강,1259000,1291000,32000,2.54,38539,49684084000
051905,LG생활건강우,737000,729000,-8000,-1.09,2837,2065194000
003555,LG우,43650,43300,-350,-0.8,2026,88101400
032640,LG유플러스,13800,14050,250,1.81,1427064,19889632400
011070,LG이노텍,98700,96800,-1900,-1.93,81755,7944679500
066570,LG전자,77500,77000,-500,-0.65,566640,43642801900
066575,LG전자우,31500,31500,0,0.0,34913,1089221600
108670,LG하우시스,56100,55600,-500,-0.89,21916,1221658800
108675,LG하우시스우,30550,29850,-700,-2.29,1625,48464200
051910,LG화학,326000,323000,-3000,-0.92,159476,51804876000
051915,LG화학우,188000,185500,-2500,-1.33,15573,2875116000
079550,LIG넥스원,34100,33550,-550,-1.61,47955,1611271350
006260,LS,47100,45800,-1300,-2.76,93661,4301292050
000680,LS네트웍스,3200,3095,-105,-3.28,28257,87630880
010120,LS산전,48050,47150,-900,-1.87,102704,4913884550
229640,LS전선아시아,7180,7170,-10,-0.14,216811,1563098920
023150,MH에탄올,6790,6770,-20,-0.29,11274,75371460
035420,NAVER,108500,109500,1000,0.92,515196,56529874000
181710,NHN,73000,73600,600,0.82,53647,3966300500
005940,NH투자증권,13350,13100,-250,-1.87,551047,7239884400
005945,NH투자증권우,9010,8910,-100,-1.11,35566,317672640
034310,NICE,21000,20850,-150,-0.71,68060,1411400750
008260,NI스틸,2880,2835,-45,-1.56,275230,777765485
004250,NPC,3645,3665,20,0.55,618,2257555
004255,NPC우,2300,2315,15,0.65,5157,11645060
010060,OCI,88900,88000,-900,-1.01,76807,6770686400
005490,POSCO,234500,236500,2000,0.85,283241,66682627000
100840,STC,12450,12250,-200,-1.61,2006,24744700
064960,ST모티브,38800,41750,2950,7.6,348983,15013108950
003570,ST중공업,7160,7120,-40,-0.56,4685,33225940
036530,ST홀딩스,12250,12350,100,0.82,8165,99981600
010950,S-Oil,81300,81300,0,0.0,230444,18771915900
010955,S-Oil우,60600,60700,100,0.17,8856,532831600
034120,SBS,22200,21000,-1200,-5.41,166205,3508200400
101060,SBS미디어홀딩스,2315,2125,-190,-8.21,391461,863155245
004060,SG세계물산,891,879,-12,-1.35,551994,486306703
001380,SG충방,2000,1995,-5,-0.25,281867,560856655
002360,SH에너지화학,1180,1160,-20,-1.69,3806143,4478024005
009160,SIMPAC,2835,2760,-75,-2.65,245955,680739845
123700,SJM,3405,3405,0,0.0,4098,13916635
025530,SJM홀딩스,3275,3255,-20,-0.61,1913,6220325
034730,SK,239000,229000,-10000,-4.18,148233,34091691000
011790,SKC,31650,30550,-1100,-3.48,82686,2545490500
018670,SK가스,76600,79000,2400,3.13,27424,2168534300
001740,SK네트웍스,4915,4780,-135,-2.75,917394,4417168415
001745,SK네트웍스우,84600,84000,-600,-0.71,7248,600594500
006120,SK디스커버리,25650,24250,-1400,-5.46,82095,2015816600
006125,SK디스커버리우,16450,16050,-400,-2.43,16421,263435000
210980,SK디앤디,29050,29650,600,2.07,17725,520190500
03473K,SK우,141000,140000,-1000,-0.71,2176,302144500
096770,SK이노베이션,161000,162500,1500,0.93,445189,72395505000
096775,SK이노베이션우,117000,118500,1500,1.28,5214,611530500
001510,SK증권,684,676,-8,-1.17,1770394,1194394930
001515,SK증권우,3510,3425,-85,-2.42,29078,100401160
285130,SK케미칼,58300,57000,-1300,-2.23,25538,1467379200
28513K,SK케미칼우,23200,22550,-650,-2.8,4093,93079750
017670,SK텔레콤,253500,252000,-1500,-0.59,101213,25467215000
000660,SK하이닉스,65900,66100,200,0.3,6056903,398147731712
005610,SPC삼립,104000,99600,-4400,-4.23,33226,3320926600
011810,STX,12300,11950,-350,-2.85,78220,938948500
077970,STX엔진,7030,7140,110,1.56,18939,133547470
071970,STX중공업,4060,3900,-160,-3.94,49220,194968380
084870,TBH글로벌,2580,2500,-80,-3.1,24283,61050300
002710,TCC스틸,2585,2525,-60,-2.32,19292,49184235
024070,WISCOM,2725,2650,-75,-2.75,32377,85914050
037270,YGPLUS,1340,1335,-5,-0.37,252712,332893445
000500,가온전선,17850,17850,0,0.0,2815,50127950
000860,강남제비스코,25000,24900,-100,-0.4,4617,114953550
035250,강원랜드,31250,30700,-550,-1.76,270072,8277939550
011420,갤럭시아에스엠,1780,1775,-5,-0.28,116028,211834200
002100,경농,15900,15500,-400,-2.52,166820,2584571800
009450,경동나비엔,46900,46200,-700,-1.49,37691,1724251300
267290,경동도시가스,31000,30200,-800,-2.58,8905,269674150
012320,경동인베스트,38350,38000,-350,-0.91,2855,108195800
000050,경방,10650,10500,-150,-1.41,11527,121365950
214390,경보제약,9740,9480,-260,-2.67,19845,189264490
012610,경인양행,6400,6190,-210,-3.28,329084,2060431240
009140,경인전자,36950,36900,-50,-0.14,3803,136691350
013580,계룡건설,27600,27300,-300,-1.09,16267,438670350
012200,계양전기,3460,3355,-105,-3.03,72840,245548280
012205,계양전기우,8720,8410,-310,-3.56,36136,304482330
004200,고려개발,4850,4845,-5,-0.1,6645,32007630
002140,고려산업,2200,2190,-10,-0.45,48850,107170980
010130,고려아연,435500,434000,-1500,-0.34,27934,12116121000
002240,고려제강,24300,23350,-950,-3.91,8800,208597950
009290,광동제약,7100,6960,-140,-1.97,63988,444320340
017040,광명전기,2445,2410,-35,-1.43,121383,291159705
017900,광전자,2430,2360,-70,-2.88,67056,159621580
037710,광주신세계,185500,180500,-5000,-2.7,1236,223405000
030610,교보증권,10850,10750,-100,-0.92,104066,1111229700
007690,국도화학,46000,45450,-550,-1.2,3420,156076700
005320,국동,1745,1710,-35,-2.01,59875,102475205
001140,국보,2035,1995,-40,-1.97,599976,1226873570
002720,국제약품,4630,4490,-140,-3.02,199592,899151275
083420,그린케미칼,3700,3705,5,0.14,12668,46526170
014530,극동유화,3420,3400,-20,-0.58,56206,190527875
014280,금강공업,4135,4035,-100,-2.42,45987,187146425
014285,금강공업우,9680,9820,140,1.45,19983,192025640
008870,금비,67800,66700,-1100,-1.62,579,38797200
001570,금양,2195,2170,-25,-1.14,48377,104786680
002990,금호산업,13800,14000,200,1.45,278644,3836404600
002995,금호산업우,54600,51600,-3000,-5.49,209327,11626513600
011780,금호석유,92800,92400,-400,-0.43,72088,6668823700
011785,금호석유우,36200,35550,-650,-1.8,16148,575893850
214330,금호에이치티,5210,5000,-210,-4.03,29024,145808525
001210,금호전기,3520,3395,-125,-3.55,45045,154505145
073240,금호타이어,4055,3905,-150,-3.7,547505,2167090410
092440,기신정기,3985,3935,-50,-1.25,8232,32484875
000270,기아차,40900,40900,0,0.0,1319436,53775429750
024110,기업은행,13750,13650,-100,-0.73,732218,10019821850
013700,까뮤이앤씨,1300,1285,-15,-1.15,109007,138418705
004540,깨끗한나라,2475,2445,-30,-1.21,30596,75013630
004545,깨끗한나라우,17100,16700,-400,-2.34,1315,22074650
074610,나노메딕스,5630,5770,140,2.49,1442680,8351028290
001260,남광토건,11150,10900,-250,-2.24,13260,145425400
008350,남선알미늄,3915,3795,-120,-3.07,4533437,17539029675
008355,남선알미우,42000,40900,-1100,-2.62,11844,487727650
004270,남성,2990,3090,100,3.34,3954186,12036116095
003920,남양유업,591000,584000,-7000,-1.18,407,238161000
003925,남양유업우,212500,208500,-4000,-1.88,11,2293500
002070,남영비비안,6500,6430,-70,-1.08,3706,23654590
025860,남해화학,10150,10000,-150,-1.48,129288,1293538430
005720,넥센,6090,6210,120,1.97,20562,127068060
005725,넥센우,3755,3775,20,0.53,6115,23006015
002350,넥센타이어,10150,10100,-50,-0.49,77351,787295800
002355,넥센타이어1우B,4170,4145,-25,-0.6,2249,9144030
003580,넥스트사이언스,5250,5090,-160,-3.05,115903,591609680
251270,넷마블,112500,109500,-3000,-2.67,275228,29994552000
090350,노루페인트,7540,7440,-100,-1.33,16190,120729620
090355,노루페인트우,12700,12400,-300,-2.36,8728,109465400
000320,노루홀딩스,12150,12100,-50,-0.41,2680,32376800
000325,노루홀딩스우,19850,19000,-850,-4.28,1062,20376100
006280,녹십자,124000,120500,-3500,-2.82,38572,4675683500
005250,녹십자홀딩스,22000,21750,-250,-1.14,54238,1175396750
005257,녹십자홀딩스2우,16900,17100,200,1.18,1634,28050500
004370,농심,247500,245000,-2500,-1.01,9297,2292286500
072710,농심홀딩스,79600,80400,800,1.01,3935,316763100
058730,다스코,6520,6400,-120,-1.84,42439,270755420
023590,다우기술,20200,20250,50,0.25,138769,2799594000
019680,대교,6220,6070,-150,-2.41,50862,309871780
019685,대교우B,4560,4625,65,1.43,8416,39195995
006370,대구백화점,6770,6700,-70,-1.03,2920,19522470
008060,대덕전자,12450,12200,-250,-2.01,1105130,13536154100
00806K,대덕전자1우,6490,6400,-90,-1.39,30404,194318190
000490,대동공업,5730,5680,-50,-0.87,28587,161683540
008110,대동전자,3660,3655,-5,-0.14,12735,46219600
005750,대림BCo,4505,4405,-100,-2.22,18247,81343945
000210,대림산업,103000,102000,-1000,-0.97,106911,10908678000
000215,대림산업우,42950,42600,-350,-0.81,3893,164492950
004440,대림씨엔에스,9420,9230,-190,-2.02,19573,178956730
006570,대림통상,4245,4280,35,0.82,2498,10633445
001680,대상,25950,25500,-450,-1.73,100357,2567848200
001685,대상우,13200,13050,-150,-1.14,1899,24862700
084690,대상홀딩스,7640,7500,-140,-1.83,61164,455610700
084695,대상홀딩스우,5830,5760,-70,-1.2,4029,23353420
128820,대성산업,4870,4880,10,0.21,59018,287440980
117580,대성에너지,5400,5390,-10,-0.19,10161,54759820
016710,대성홀딩스,7910,7880,-30,-0.38,8547,67256780
003540,대신증권,13400,13300,-100,-0.75,225946,3013168400
003547,대신증권2우B,8500,8490,-10,-0.12,5806,49075810
003545,대신증권우,9190,9120,-70,-0.76,30524,278436000
009190,대양금속,7370,8230,860,11.67,326748,2591511440
014160,대영포장,1305,1290,-15,-1.15,28770983,39655258550
047040,대우건설,4920,4825,-95,-1.93,624042,3015276205
009320,대우부품,2205,2180,-25,-1.13,238962,521025615
042660,대우조선해양,29050,28950,-100,-0.34,118831,3432521400
003090,대웅,18150,17300,-850,-4.68,163863,2826698650
069620,대웅제약,156000,148500,-7500,-4.81,91372,13619993000
000430,대원강업,4380,4435,55,1.26,51369,225777695
006340,대원전선,1285,1250,-35,-2.72,372904,472714455
006345,대원전선우,3330,3295,-35,-1.05,16356,53646045
003220,대원제약,16050,15900,-150,-0.93,61777,977058150
024890,대원화성,1810,1795,-15,-0.83,181014,324669140
002880,대유에이텍,1115,1100,-15,-1.35,399821,440201980
000300,대유플러스,871,905,34,3.9,709339,632472857
012800,대창,1395,1310,-85,-6.09,11772304,16741420205
015230,대창단조,38800,38500,-300,-0.77,4812,186198650
001070,대한방직,20350,20400,50,0.25,21250,433969950
006650,대한유화,138000,132000,-6000,-4.35,47543,6325359500
001440,대한전선,836,810,-26,-3.11,2569382,2103867809
084010,대한제강,7600,7820,220,2.89,108211,835203840
001790,대한제당,20300,20300,0,0.0,2772,56003800
001799,대한제당3우B,23900,23800,-100,-0.42,12076,307399350
001795,대한제당우,12250,12150,-100,-0.82,24177,303864850
001130,대한제분,209000,214000,5000,2.39,5127,1088028000
003490,대한항공,31950,31700,-250,-0.78,315399,9951166250
003495,대한항공우,20450,20200,-250,-1.22,40052,819130750
005880,대한해운,22650,22400,-250,-1.1,25751,576680700
003830,대한화섬,106000,103500,-2500,-2.36,1836,190328500
016090,대현,2455,2400,-55,-2.24,62655,150761855
069460,대호에이엘,3855,3725,-130,-3.37,286304,1062525680
192080,더블유게임즈,67900,67100,-800,-1.18,69873,4659047400
012510,더존비즈온,65000,66500,1500,2.31,78045,5134954700
004830,덕성,2840,2965,125,4.4,18734,53289070
004835,덕성우,3890,3790,-100,-2.57,17734,66776605
024900,덕양산업,1480,1465,-15,-1.01,2464809,3747783390
145720,덴티움,68200,69000,800,1.17,29121,2025291400
002150,도화엔지니어링,9470,9400,-70,-0.74,336494,3230326630
001230,동국제강,6630,6480,-150,-2.26,246254,1605750260
023450,동남합성,23950,24000,50,0.21,327,7828350
004140,동방,1870,1780,-90,-4.81,405734,729885450
007590,동방아그로,7120,7090,-30,-0.42,6633,46667940
005960,동부건설,8010,7830,-180,-2.25,9420,73874630
005965,동부건설우,16850,16500,-350,-2.08,2678,44530400
016380,동부제철,8460,7850,-610,-7.21,108372,868401800
016385,동부제철우,37950,38000,50,0.13,10697,402457050
083370,동북아12호,5010,5010,0,0.0,0,0
083380,동북아13호,5010,5010,0,0.0,0,0
026960,동서,20450,19350,-1100,-5.38,215735,4237181850
002210,동성제약,19050,17850,-1200,-6.3,1060627,19207059200
102260,동성코퍼레이션,5790,5650,-140,-2.42,67543,382710310
005190,동성화학,16150,16350,200,1.24,14387,232031800
000640,동아쏘시오홀딩스,100000,97500,-2500,-2.5,9702,952576400
170900,동아에스티,98500,97700,-800,-0.81,21909,2134025800
028100,동아지질,22750,22050,-700,-3.08,308458,6804360400
282690,동아타이어,13100,13100,0,0.0,3062,40190300
001520,동양,1830,1800,-30,-1.64,205770,370518390
001527,동양2우B,10150,10050,-100,-0.99,1054,10733750
001529,동양3우B,31000,30900,-100,-0.32,652,20149050
084670,동양고속,26600,26450,-150,-0.56,670,17764950
030790,동양네트웍스,1910,1895,-15,-0.79,1564380,2997555355
002900,동양물산,1765,1750,-15,-0.85,1260854,2240407205
082640,동양생명,4160,4100,-60,-1.44,81938,337328095
001525,동양우,8360,8270,-90,-1.08,705,5850450
008970,동양철관,1215,1185,-30,-2.47,530618,632626785
092780,동양피스톤,5010,4905,-105,-2.1,103367,505304520
049770,동원FB,259500,259000,-500,-0.19,5578,1447499000
018500,동원금속,860,860,0,0.0,88021,74054868
006040,동원산업,242000,248000,6000,2.48,4745,1166108000
030720,동원수산,8470,8310,-160,-1.89,54932,457469810
014820,동원시스템즈,37900,37500,-400,-1.06,88635,3323878950
014825,동원시스템즈우,28700,28600,-100,-0.35,1306,37151200
163560,동일고무벨트,6630,6550,-80,-1.21,7372,48311010
004890,동일산업,61400,61000,-400,-0.65,6756,409299500
002690,동일제강,2850,2835,-15,-0.53,25128,70897895
000020,동화약품,9300,9310,10,0.11,42534,395502910
000150,두산,94900,93500,-1400,-1.48,91811,8586742000
000157,두산2우B,74200,74700,500,0.67,507,37487500
011160,두산건설,1130,1120,-10,-0.88,202988,225993485
241560,두산밥캣,33500,33050,-450,-1.34,169129,5604399700
000155,두산우,73300,73100,-200,-0.27,1814,131983400
042670,두산인프라코어,6500,6410,-90,-1.38,1128633,7217778850
034020,두산중공업,6240,5980,-260,-4.17,2044631,12325659920
016740,두올,3270,3165,-105,-3.21,114588,364432460
192650,드림텍,11450,11900,450,3.93,1552675,18480986600
024090,디씨엠,12150,11950,-200,-1.65,4021,48614600
003160,디아이,4170,3975,-195,-4.68,454779,1831603555
092200,디아이씨,5320,5320,0,0.0,96595,499723340
013570,디와이,5600,5440,-160,-2.86,42241,230950820
210540,디와이파워,13550,13100,-450,-3.32,101018,1322020050
007340,디티알오토모티브,32800,32950,150,0.46,2473,81310450
026890,디피씨,5620,5470,-150,-2.67,728223,4019414740
115390,락앤락,15850,15600,-250,-1.58,133809,2096611900
032350,롯데관광개발,12600,12050,-550,-4.37,91424,1120002700
000400,롯데손해보험,2480,2400,-80,-3.23,337280,808914885
023530,롯데쇼핑,160000,159000,-1000,-0.63,41177,6543905500
004000,롯데정밀화학,50700,49350,-1350,-2.66,96582,4810922350
286940,롯데정보통신,45200,44750,-450,-1.0,44935,2023673200
280360,롯데제과,163500,160500,-3000,-1.83,4098,665969000
004990,롯데지주,42500,42000,-500,-1.18,125269,5282340500
00499K,롯데지주우,51800,51700,-100,-0.19,3610,186957800
005300,롯데칠성,183500,180000,-3500,-1.91,20763,3714996500
005305,롯데칠성우,77000,76600,-400,-0.52,188,14317300
011170,롯데케미칼,258000,254500,-3500,-1.36,104817,26641403500
002270,롯데푸드,553000,541000,-12000,-2.17,1893,1031268000
071840,롯데하이마트,43450,42650,-800,-1.84,39434,1691740750
027740,마니커,1085,1085,0,0.0,5963138,6567488055
204320,만도,30000,28850,-1150,-3.83,400854,11638658850
001080,만호제강,19350,19050,-300,-1.55,2916,55164450
088980,맥쿼리인프라,12150,12150,0,0.0,1576010,19216871399
094800,맵스리얼티1,4375,4365,-10,-0.23,50231,219077655
015540,메디파트너생명공학,6370,6540,170,2.67,78333,532935150
138040,메리츠금융지주,15100,14400,-700,-4.64,167850,2423204600
008560,메리츠종금증권,4690,4660,-30,-0.64,2809335,13160203080
000060,메리츠화재,21550,21500,-50,-0.23,99803,2158873600
090370,메타랩스,2450,2475,25,1.02,2011186,4900423765
017180,명문제약,5120,5030,-90,-1.76,221844,1119356195
012690,모나리자,3475,3350,-125,-3.6,145622,491360695
005360,모나미,2580,2545,-35,-1.36,20416,51995370
204210,모두투어리츠,3005,3005,0,0.0,15866,46958910
009680,모토닉,10900,10850,-50,-0.46,64321,694659300
009580,무림PP,5100,5000,-100,-1.96,161224,810086865
009200,무림페이퍼,3165,3055,-110,-3.48,117210,360857550
033920,무학,10600,10750,150,1.42,109166,1164116900
008420,문배철강,2935,2895,-40,-1.36,55234,159640220
025560,미래산업,149,147,-2,-1.34,2858139,422296229
007120,미래아이앤지,329,328,-1,-0.3,389746,123745607
006800,미래에셋대우,7510,7400,-110,-1.46,1552507,11483192290
00680K,미래에셋대우2우B,3825,3760,-65,-1.7,180080,678681930
006805,미래에셋대우우,4405,4370,-35,-0.79,18114,79058280
085620,미래에셋생명,4990,4715,-275,-5.51,123228,594594870
002840,미원상사,42750,42750,0,0.0,876,37330850
268280,미원에스씨,72700,72400,-300,-0.41,1693,122388800
107590,미원홀딩스,43050,42800,-250,-0.58,1485,63366600
134380,미원화학,41700,41700,0,0.0,105,4376900
003650,미창석유,78500,79300,800,1.02,220,17279200
155900,바다로19호,3010,3005,-5,-0.17,8569,25756120
003610,방림,2310,2295,-15,-0.65,21716,49095950
001340,백광산업,2860,2835,-25,-0.87,77967,221041775
014580,백광소재,2845,2770,-75,-2.64,85178,237543050
035150,백산,10450,10100,-350,-3.35,288539,2925652060
002410,범양건영,1790,1755,-35,-1.96,90251,159079865
096300,베트남개발1,415,417,2,0.48,370874,154791504
007210,벽산,2330,2290,-40,-1.72,99439,228914435
002760,보락,2350,2310,-40,-1.7,218969,510060490
003850,보령제약,12200,11600,-600,-4.92,277006,3288294850
000890,보해양조,1345,1315,-30,-2.23,10151544,13037327830
003000,부광약품,16850,16350,-500,-2.97,207897,3402724000
001270,부국증권,20550,20550,0,0.0,646,13228150
001275,부국증권우,19250,19000,-250,-1.3,3830,72605000
026940,부국철강,3340,3430,90,2.69,90235,303898060
015350,부산가스,37400,37500,100,0.27,4390,162525950
011390,부산산업,117000,117500,500,0.43,13387,1550509500
005030,부산주공,611,590,-21,-3.44,273142,163656926
100220,비상교육,8640,8520,-120,-1.39,141768,1195884210
101140,비티원,3680,3590,-90,-2.45,101805,365149020
005180,빙그레,74500,73400,-1100,-1.48,18167,1334449600
003960,사조대림,19500,19400,-100,-0.51,8418,164280900
008040,사조동아원,1290,1260,-30,-2.33,1175925,1487861550
007160,사조산업,55100,54500,-600,-1.09,3698,200911900
014710,사조씨푸드,6050,5940,-110,-1.82,12122,72390960
006090,사조오양,8080,7870,-210,-2.6,11269,88863380
079660,사조해표,8420,8380,-40,-0.48,284124,2411425210
005090,삼광글라스,39300,38400,-900,-2.29,12417,474432800
001470,삼부토건,844,826,-18,-2.13,217898,181335109
006400,삼성SDI,208500,203500,-5000,-2.4,367761,74882649100
006405,삼성SDI우,82100,80800,-1300,-1.58,2205,179239200
006660,삼성공조,10350,10300,-50,-0.48,11602,117489600
028260,삼성물산,93600,91500,-2100,-2.24,407203,37263920400
02826K,삼성물산우B,69300,68400,-900,-1.3,1528,104922400
207940,삼성바이오로직스,294000,289500,-4500,-1.53,81952,23791423000
032830,삼성생명,81300,79900,-1400,-1.72,250426,20037616100
018260,삼성에스디에스,204000,204500,500,0.25,85281,17452772500
028050,삼성엔지니어링,16700,16600,-100,-0.6,721344,11973827300
009150,삼성전기,96900,96900,0,0.0,492249,47453449000
009155,삼성전기우,42300,42100,-200,-0.47,2691,112946600
005930,삼성전자,42550,41800,-750,-1.76,14930618,623333158995
005935,삼성전자우,33900,33450,-450,-1.33,1794255,60036007850
001360,삼성제약,2665,2625,-40,-1.5,151579,395338120
010140,삼성중공업,7600,7480,-120,-1.58,2021525,15156171390
010145,삼성중공우,60700,59100,-1600,-2.64,2105,125266500
016360,삼성증권,34700,34300,-400,-1.15,175388,6032971800
068290,삼성출판사,16750,16350,-400,-2.39,101903,1674165200
029780,삼성카드,36700,36700,0,0.0,79099,2905770250
000810,삼성화재,275500,271000,-4500,-1.63,71436,19367352000
000815,삼성화재우,186500,187500,1000,0.54,6550,1225839500
006110,삼아알미늄,5610,5270,-340,-6.06,135726,731637820
145990,삼양사,53800,51800,-2000,-3.72,17541,910364600
145995,삼양사우,35800,36150,350,0.98,199,7126050
003230,삼양식품,73800,73700,-100,-0.14,25150,1843267600
002170,삼양통상,63200,63700,500,0.79,13359,845516200
272550,삼양패키징,17550,17200,-350,-1.99,23758,410085000
000070,삼양홀딩스,75700,74200,-1500,-1.98,9658,722038100
000075,삼양홀딩스우,47250,47500,250,0.53,342,16317750
002810,삼영무역,16000,15900,-100,-0.63,8405,134016550
005680,삼영전자,11650,11650,0,0.0,152391,1739837700
003720,삼영화학,982,966,-16,-1.63,73942,71448207
023000,삼원강재,3045,3030,-15,-0.49,4201,12691650
004380,삼익THK,10950,10600,-350,-3.2,34180,367336100
002450,삼익악기,1960,1910,-50,-2.55,240336,460086655
000520,삼일제약,26700,26000,-700,-2.62,28918,755890250
009770,삼정펄프,35150,34000,-1150,-3.27,2315,79266800
005500,삼진제약,31450,30700,-750,-2.38,85076,2630202400
004690,삼천리,91600,91300,-300,-0.33,9932,907008300
001880,삼호,20000,20500,500,2.5,74552,1573966950
010960,삼호개발,4690,4580,-110,-2.35,41218,189000475
004450,삼화왕관,45950,46000,50,0.11,432,19767700
009470,삼화전기,16450,16200,-250,-1.52,23082,372984950
011230,삼화전자,2880,2870,-10,-0.35,68729,199518155
001820,삼화콘덴서,53900,52500,-1400,-2.6,90435,4757221700
000390,삼화페인트,5530,5430,-100,-1.81,8816,47707680
001290,상상인증권,2275,2215,-60,-2.64,130060,288152405
041650,상신브레이크,3875,3970,95,2.45,20366,78950535
075180,새론오토모티브,5450,5450,0,0.0,2994,16281580
007540,샘표,43400,44500,1100,2.53,305690,13875135300
248170,샘표식품,29800,29750,-50,-0.17,51855,1544463750
007860,서연,4265,4210,-55,-1.29,16904,70609860
200880,서연이화,6200,6420,220,3.55,122409,759915220
017390,서울가스,82600,79500,-3100,-3.75,604,48528000
004410,서울식품,187,188,1,0.53,1547048,286038290
004415,서울식품우,3975,4005,30,0.75,10461,41944020
021050,서원,1230,1225,-5,-0.41,1872676,2334566015
008490,서흥,31700,32500,800,2.52,36819,1169308600
007610,선도전기,3565,3470,-95,-2.66,87075,302594080
136490,선진,12650,12250,-400,-3.16,15130,187446050
002820,선창산업,4915,4760,-155,-3.15,8420,40428395
014910,성문전자,2780,2700,-80,-2.88,92914,250911655
014915,성문전자우,14150,14000,-150,-1.06,16132,223939000
003080,성보화학,5020,5000,-20,-0.4,11918,59383150
004980,성신양회,8890,8730,-160,-1.8,102717,896308460
004985,성신양회우,10650,10300,-350,-3.29,6180,63875050
011300,성안,555,557,2,0.36,26320,14605807
000180,성창기업지주,1900,1880,-20,-1.05,91979,172613315
002420,세기상사,71200,70800,-400,-0.56,1618,113380400
004360,세방,13650,13600,-50,-0.37,8767,118483250
004365,세방우,6850,6860,10,0.15,425,2904160
004490,세방전지,43250,41650,-1600,-3.7,47152,1972125250
001430,세아베스틸,18000,17450,-550,-3.06,51543,910884200
306200,세아제강,66700,66200,-500,-0.75,2779,182652500
003030,세아제강지주,55100,54300,-800,-1.45,4965,267413100
019440,세아특수강,14900,14800,-100,-0.67,3234,47686300
058650,세아홀딩스,91700,90600,-1100,-1.2,1518,137653000
013000,세우글로벌,1880,1865,-15,-0.8,1173532,2182801235
091090,세원셀론텍,3420,3335,-85,-2.49,213156,712162360
021820,세원정공,8030,8010,-20,-0.25,5592,44223680
067830,세이브존IC,3655,3695,40,1.09,16979,62376215
033530,세종공업,6210,6140,-70,-1.13,111309,684533340
075580,세진중공업,4990,4900,-90,-1.8,80225,393721985
027970,세하,1380,1360,-20,-1.45,13452,18302130
145210,세화아이엠씨,2990,2990,0,0.0,0,0
068270,셀트리온,186000,185500,-500,-0.27,573479,105766147000
004430,송원산업,19800,20200,400,2.02,194222,3909091700
017550,수산중공업,1695,1685,-10,-0.59,611956,1023158980
002200,수출포장,21050,20600,-450,-2.14,7032,144632950
053210,스카이라이프,10550,10400,-150,-1.42,90248,932015600
134790,시디즈,42900,41600,-1300,-3.03,4898,205710350
016590,신대양제지,80000,79100,-900,-1.13,20950,1661899100
029530,신도리코,45600,45600,0,0.0,10256,463373150
004970,신라교역,13800,13700,-100,-0.72,3313,45397950
011930,신성이엔지,1135,1100,-35,-3.08,861967,950664000
005390,신성통상,972,968,-4,-0.41,435555,418149553
004170,신세계,291000,298000,7000,2.41,51914,15309290500
035510,신세계IC,124000,120500,-3500,-2.82,6867,835094500
034300,신세계건설,27600,32450,4850,17.57,707811,23504603650
031430,신세계인터내셔날,280500,283000,2500,0.89,27375,7809297500
031440,신세계푸드,91000,91800,800,0.88,9587,878144900
006880,신송홀딩스,4780,4790,10,0.21,52373,251478925
005800,신영와코루,120000,119500,-500,-0.42,136,16273500
001720,신영증권,59200,57700,-1500,-2.53,2358,136388500
001725,신영증권우,52000,52000,0,0.0,2588,134034700
009270,신원,1920,1905,-15,-0.78,762972,1444409080
009275,신원우,51100,51500,400,0.78,2167,110161600
002700,신일산업,2560,2430,-130,-5.08,9690235,23882506885
019170,신풍제약,7010,6840,-170,-2.43,223140,1532786250
019175,신풍제약우,6340,6260,-80,-1.26,3691,22991370
002870,신풍제지,1285,1275,-10,-0.78,53991,68581065
005450,신한,4945,4945,0,0.0,0,0
293940,신한알파리츠,6380,6390,10,0.16,69343,440221730
055550,신한지주,48000,45700,-2300,-4.79,2069839,95348479934
001770,신화실업,22900,22700,-200,-0.87,3379,76929350
004080,신흥,10050,10000,-50,-0.5,1074,10702590
102280,쌍방울,1105,1030,-75,-6.79,11716600,12758215580
003410,쌍용양회,5860,5920,60,1.02,924052,5461575830
003415,쌍용양회우,6210,6170,-40,-0.64,11597,71315250
003620,쌍용차,4200,4120,-80,-1.9,203554,840037525
004770,써니전자,3110,3220,110,3.54,1291475,4073343415
004920,씨아이테크,484,473,-11,-2.27,61178,29113626
112610,씨에스윈드,38500,36600,-1900,-4.94,82570,3044888500
008700,아남전자,2930,2930,0,0.0,2335760,6865622455
002790,아모레G,65200,64700,-500,-0.77,95936,6208489600
002795,아모레G우,28150,27700,-450,-1.6,2798,77492550
090430,아모레퍼시픽,181500,180000,-1500,-0.83,109653,19848601000
090435,아모레퍼시픽우,99100,100500,1400,1.41,10199,1000059000
002030,아세아,116000,114500,-1500,-1.29,1606,181492000
183190,아세아시멘트,94900,91400,-3500,-3.69,4592,420368000
002310,아세아제지,38000,36550,-1450,-3.82,54743,2030091000
267850,아시아나IDT,16650,17000,350,2.1,266430,4434002750
020560,아시아나항공,5960,5910,-50,-0.84,3099124,18353101990
122900,아이마켓코리아,10700,10550,-150,-1.4,123519,1331109900
010780,아이에스동서,33600,33800,200,0.6,34325,1153781500
033660,아주캐피탈,10500,10300,-200,-1.9,23397,242474950
001780,알루코,2620,2745,125,4.77,490637,1329546455
018250,애경산업,46000,44050,-1950,-4.24,412137,18467085650
161000,애경유화,8150,7900,-250,-3.07,1746036,14157128670
011090,에넥스,1345,1305,-40,-2.97,255306,331385125
005850,에스엘,24400,23300,-1100,-4.51,163987,3870895700
012750,에스원,96400,95100,-1300,-1.35,44798,4251933400
023960,에쓰씨엔지니어링,1640,1570,-70,-4.27,47528,75441725
298690,에어부산,6200,6310,110,1.77,1735913,10931915750
140910,에이리츠,6020,6010,-10,-0.17,3844,23044060
078520,에이블씨엔씨,10300,10200,-100,-0.97,72801,737860850
015260,에이엔피,466,441,-25,-5.36,1192416,535086703
007460,에이프로젠KIC,3685,3355,-330,-8.96,11520573,39782878440
003060,에이프로젠제약,2100,1915,-185,-8.81,2252919,4436095275
036570,엔씨소프트,474500,480000,5500,1.16,74685,35767537000
138250,엔에스쇼핑,11750,11900,150,1.28,89432,1067385550
085310,엔케이,1365,1340,-25,-1.83,294934,394014850
009810,엔케이물산,827,829,2,0.24,457396,378180661
900140,엘브이엠씨홀딩스,2280,2250,-30,-1.32,29949,67429120
014440,영보화학,3995,3930,-65,-1.63,14165,55181245
111770,영원무역,40100,40250,150,0.37,116067,4652919150
009970,영원무역홀딩스,62300,61800,-500,-0.8,4200,261550100
003520,영진약품,5700,5540,-160,-2.81,587628,3276360110
000670,영풍,723000,710000,-13000,-1.8,1727,1225630000
006740,영풍제지,3620,3620,0,0.0,21146,76239220
012280,영화금속,1400,1370,-30,-2.14,158220,218839265
012160,영흥철강,1405,1330,-75,-5.34,793776,1076211670
015360,예스코홀딩스,42150,41800,-350,-0.83,992,41558650
007310,오뚜기,706000,719000,13000,1.84,3267,2328908000
079440,오렌지라이프,32700,32800,100,0.31,51271,1677966150
002630,오리엔트바이오,543,518,-25,-4.6,2996795,1572710821
271560,오리온,88900,86100,-2800,-3.15,81611,7046509800
001800,오리온홀딩스,17200,16300,-900,-5.23,66389,1089168450
070960,용평리조트,6500,6350,-150,-2.31,166709,1056216520
316140,우리금융지주,14150,14000,-150,-1.06,1059910,14857483550
004720,우리들제약,6800,6690,-110,-1.62,38048,254818780
118000,우리들휴브레인,2290,2230,-60,-2.62,83694,188747705
010050,우리종금,745,730,-15,-2.01,1358402,1000097704
006980,우성사료,3370,3430,60,1.78,5776586,20527987165
017370,우신시스템,5930,5960,30,0.51,3424,20359360
105840,우진,5870,5820,-50,-0.85,147195,849395940
010400,우진아이엔에스,10550,10300,-250,-2.37,25188,258831900
049800,우진플라임,5050,4905,-145,-2.87,36966,181660430
016880,웅진,2135,2070,-65,-3.04,113112,234416095
095720,웅진씽크빅,2590,2545,-45,-1.74,633210,1607513310
103130,웅진에너지,914,914,0,0.0,0,0
021240,웅진코웨이,79500,76700,-2800,-3.52,177895,13787807882
005820,원림,18250,18000,-250,-1.37,662,11852900
010600,웰바이오텍,3140,2960,-180,-5.73,907243,2798172230
008600,윌비스,1230,1195,-35,-2.85,196503,235618365
033270,유나이티드제약,23100,22800,-300,-1.3,60578,1377846100
014830,유니드,50100,49450,-650,-1.3,20940,1043139100
000910,유니온,6200,6550,350,5.65,17350074,121394052920
047400,유니온머티리얼,3120,3275,155,4.97,3708171,12095108505
011330,유니켐,2530,2505,-25,-0.99,1906356,4851728780
077500,유니퀘스트,6480,6410,-70,-1.08,50979,326460840
002920,유성기업,3010,2960,-50,-1.66,29904,88097465
000700,유수홀딩스,8060,8000,-60,-0.74,15436,123728750
003470,유안타증권,3035,3030,-5,-0.16,256238,776886845
003475,유안타증권우,2170,2145,-25,-1.15,8102,17185315
011690,유양디앤유,7900,7900,0,0.0,434819,3401875530
072130,유엔젤,4525,4440,-85,-1.88,48928,215991255
000220,유유제약,11600,11350,-250,-2.16,30130,341106200
000225,유유제약1우,7280,7200,-80,-1.1,1117,8036700
000227,유유제약2우B,19400,18650,-750,-3.87,1666,31594600
001200,유진투자증권,2555,2495,-60,-2.35,196925,493827365
000100,유한양행,249500,241500,-8000,-3.21,41734,10160772000
000105,유한양행우,213500,211000,-2500,-1.17,100,20879500
003460,유화증권,12750,12700,-50,-0.39,1871,23566900
003465,유화증권우,12700,12700,0,0.0,1041,13119200
008730,율촌화학,12650,12950,300,2.37,42814,550353250
008250,이건산업,9160,8820,-340,-3.71,113372,1006807610
025820,이구산업,2040,2005,-35,-1.72,778819,1584292960
214320,이노션,71600,71300,-300,-0.42,26947,1921053700
088260,이리츠코크렙,5360,5380,20,0.37,68644,368925010
139480,이마트,146500,142500,-4000,-2.73,153649,22000114588
007660,이수페타시스,4640,4410,-230,-4.96,888260,3964665375
005950,이수화학,9740,9690,-50,-0.51,12529,121182280
015020,이스타코,668,664,-4,-0.6,40208,26573089
093230,이아이디,242,226,-16,-6.61,3534227,810978544
102460,이연제약,16750,16300,-450,-2.69,24852,406476100
084680,이월드,2720,2760,40,1.47,2748525,7706888570
000760,이화산업,16800,16850,50,0.3,1995,35271950
014990,인디에프,2365,2380,15,0.63,1548010,3597960200
006490,인스코비,3365,3210,-155,-4.61,826127,2700334500
023800,인지컨트롤스,6220,6100,-120,-1.93,82742,504694270
034590,인천도시가스,29400,29300,-100,-0.34,297,8699200
129260,인터지스,2505,2470,-35,-1.4,128239,314999575
023810,인팩,4055,4030,-25,-0.62,6396,25597505
249420,일동제약,19700,19400,-300,-1.52,43792,853275100
000230,일동홀딩스,13000,12650,-350,-2.69,8555,109012750
013360,일성건설,1275,1260,-15,-1.18,103021,128491985
003120,일성신약,87900,88800,900,1.02,214,18767800
003200,일신방직,93200,91700,-1500,-1.61,787,72068200
007110,일신석재,2270,2220,-50,-2.2,931011,2066378400
007570,일양약품,26350,25750,-600,-2.28,37056,954215400
007575,일양약품우,19800,19800,0,0.0,553,10959000
008500,일정실업,20000,19850,-150,-0.75,17,334550
081000,일진다이아,29150,28700,-450,-1.54,108706,3133678200
020760,일진디스플,4245,4120,-125,-2.94,159193,652259380
020150,일진머티리얼즈,32950,32100,-850,-2.58,171507,5515903850
103590,일진전기,3085,3060,-25,-0.81,37910,114715720
015860,일진홀딩스,3200,3140,-60,-1.88,37430,117157170
226320,잇츠한불,22750,23550,800,3.52,49073,1138913100
033240,자화전자,12400,12250,-150,-1.21,81224,994437850
000950,전방,17150,16750,-400,-2.33,665,11215150
194370,제이에스코퍼레이션,18000,18500,500,2.78,90460,1613538250
025620,제이준코스메틱,6540,6320,-220,-3.36,264226,1684202890
030000,제일기획,26750,26600,-150,-0.56,228408,6102659700
271980,제일약품,35300,35250,-50,-0.14,33794,1201304650
001560,제일연마,6460,6450,-10,-0.15,726,4652540
002620,제일파마홀딩스,21750,21600,-150,-0.69,18565,394289450
006220,제주은행,4715,4655,-60,-1.27,26078,122053840
089590,제주항공,36500,34750,-1750,-4.79,72042,2526834300
004910,조광페인트,6340,6270,-70,-1.1,7705,48319020
004700,조광피혁,35750,38700,2950,8.25,8939,325419650
001550,조비,24400,24050,-350,-1.43,106576,2531248000
000480,조선내화,88500,87700,-800,-0.9,3624,318525200
120030,조선선재,81300,81100,-200,-0.25,2080,166491400
018470,조일알미늄,900,884,-16,-1.78,77274,67893533
002600,조흥,174500,175500,1000,0.57,23,4009000
185750,종근당,93300,91700,-1600,-1.71,34453,3171522400
063160,종근당바이오,24850,24300,-550,-2.21,12908,316171100
001630,종근당홀딩스,111500,111500,0,0.0,55952,6127263000
044380,주연테크,476,489,13,2.73,2960278,1397291785
013870,지엠비코리아,7510,7530,20,0.27,212906,1593107430
071320,지역난방공사,52300,51700,-600,-1.15,4828,251777000
010580,지코,781,783,2,0.26,352141,275822019
035000,지투알,7670,7740,70,0.91,11156,85076480
088790,진도,4050,3985,-65,-1.6,9755,38897325
003780,진양산업,3445,3405,-40,-1.16,109390,371936595
010640,진양폴리,2350,2300,-50,-2.13,31292,72255665
100250,진양홀딩스,2560,2540,-20,-0.78,57701,146199865
051630,진양화학,4870,4610,-260,-5.34,523372,2477711885
272450,진에어,20450,20050,-400,-1.96,79662,1609085800
011000,진원생명과학,4525,4330,-195,-4.31,194414,847967410
002780,진흥기업,2300,2295,-5,-0.22,221125,506222580
002787,진흥기업2우B,13700,13200,-500,-3.65,13177,176425900
002785,진흥기업우B,4810,4690,-120,-2.49,18572,87485800
009310,참엔지니어링,1430,1385,-45,-3.15,87459,121265095
000650,천일고속,74300,74000,-300,-0.4,124,9160400
012600,청호컴넷,3850,3720,-130,-3.38,59211,221831645
033250,체시스,1770,1710,-60,-3.39,386668,665500205
035720,카카오,123000,121500,-1500,-1.22,323116,39350236000
006380,카프로,4025,3980,-45,-1.12,72892,290848895
109070,컨버즈,3260,3260,0,0.0,0,0
001620,케이비아이동국실업,852,836,-16,-1.88,104489,86985337
029460,케이씨,14350,13800,-550,-3.83,82657,1146956650
281820,케이씨텍,13400,12450,-950,-7.09,227673,2884681050
145270,케이탑리츠,913,910,-3,-0.33,143562,130345756
007815,코리아써우,2645,2675,30,1.13,590,1562350
007810,코리아써키트,5310,5240,-70,-1.32,11681,60858420
00781K,코리아써키트2우B,4545,4540,-5,-0.11,303,1376635
152330,코리아오토글라스,18250,18850,600,3.29,114560,2162963100
003690,코리안리,8400,8380,-20,-0.24,216829,1813450930
192820,코스맥스,113500,110500,-3000,-2.64,62639,6958101500
044820,코스맥스비티아이,17900,17750,-150,-0.84,25775,450818150
005070,코스모신소재,12400,12150,-250,-2.02,109128,1327972400
005420,코스모화학,10550,10350,-200,-1.9,76916,805318900
071950,코아스,1425,1475,50,3.51,332368,478963700
002020,코오롱,17200,16400,-800,-4.65,375043,6176270150
003070,코오롱글로벌,8710,8420,-290,-3.33,146389,1248050200
003075,코오롱글로벌우,15000,15800,800,5.33,11736,176898750
144620,코오롱머티리얼,1965,1850,-115,-5.85,290075,540772950
002025,코오롱우,11100,10200,-900,-8.11,37626,395087450
120110,코오롱인더,41700,39550,-2150,-5.16,346212,13830958300
120115,코오롱인더우,19700,19300,-400,-2.03,17185,329705300
138490,코오롱플라스틱,5120,4995,-125,-2.44,87670,438811600
031820,콤텍시스템,1590,1540,-50,-3.14,700628,1083505540
192400,쿠쿠홀딩스,149000,139500,-9500,-6.38,7616,1075548000
284740,쿠쿠홈시스,52900,50700,-2200,-4.16,25665,1324234000
015590,큐로,1030,998,-32,-3.11,1809359,1852401351
264900,크라운제과,9680,9700,20,0.21,3481,33666630
26490K,크라운제과우,7880,7820,-60,-0.76,976,7719770
005740,크라운해태홀딩스,10600,10500,-100,-0.94,13980,145983450
005745,크라운해태홀딩스우,13250,13100,-150,-1.13,1952,25386700
020120,키다리스튜디오,2870,2810,-60,-2.09,23163,65365800
039490,키움증권,80300,79500,-800,-1.0,77151,6159392500
012170,키위미디어그룹,151,149,-2,-1.32,3047834,457483908
015890,태경산업,5920,5810,-110,-1.86,127016,742725690
006890,태경화학,6070,6040,-30,-0.49,163583,982730710
003240,태광산업,1462000,1404000,-58000,-3.97,1059,1503135000
011280,태림포장,7830,7600,-230,-2.94,4763460,37340683160
004100,태양금속,1150,1165,15,1.3,127773,148497140
004105,태양금속우,3305,3310,5,0.15,9797,32353915
009410,태영건설,14500,14100,-400,-2.76,421909,6005734950
009415,태영건설우,7670,7690,20,0.26,145468,1107894100
001420,태원물산,4850,4905,55,1.13,27957,138336730
007980,태평양물산,3190,3090,-100,-3.13,189479,583310155
055490,테이팩스,19700,19800,100,0.51,11269,220955000
078000,텔코웨어,17650,17250,-400,-2.27,76558,1319528550
214420,토니모리,9880,9750,-130,-1.32,43209,423856770
019180,티에이치엔,3375,3335,-40,-1.19,309406,1042566335
091810,티웨이항공,7090,6950,-140,-1.97,135453,938920660
004870,티웨이홀딩스,2075,2015,-60,-2.89,220856,445085050
005690,파미셀,9480,9070,-410,-4.32,582407,5317999110
036580,팜스코,6950,6780,-170,-2.45,125539,864852240
028670,팬오션,4300,4220,-80,-1.86,608166,2565168910
010820,퍼스텍,2530,2495,-35,-1.38,222797,556676530
016800,퍼시스,33350,33450,100,0.3,787,26364050
001020,페이퍼코리아,887,888,1,0.11,90115,80105651
090080,평화산업,1835,1805,-30,-1.63,93501,168342115
010770,평화홀딩스,4240,4160,-80,-1.89,18721,77673490
058430,포스코강판,19050,19100,50,0.26,5615,106279850
047050,포스코인터내셔널,17200,16850,-350,-2.03,115461,1949643900
003670,포스코케미칼,52900,53100,200,0.38,169785,8938499100
007630,폴루스바이오팜,2125,2110,-15,-0.71,610174,1280175260
017810,풀무원,12250,12250,0,0.0,135444,1646955150
103140,풍산,24750,24450,-300,-1.21,93116,2289566850
005810,풍산홀딩스,37950,38050,100,0.26,2160,81273700
033180,필룩스,6490,6260,-230,-3.54,1213095,7689553830
086790,하나금융지주,37300,36800,-500,-1.34,877544,32406895600
099340,하나니켈1호,817,828,11,1.35,2218645,1881464644
099350,하나니켈2호,1775,1835,60,3.38,4022236,7656883615
293480,하나제약,24700,24250,-450,-1.82,58990,1429579500
039130,하나투어,58700,59000,300,0.51,55152,3247033500
172580,하이골드12호,2860,2860,0,0.0,8501,24290695
153360,하이골드3호,1830,1835,5,0.27,1111,2016655
159650,하이골드8호,1735,1710,-25,-1.44,23310,39876905
071090,하이스틸,20650,20200,-450,-2.18,4751,95755750
019490,하이트론,4215,4345,130,3.08,2274,9807570
000080,하이트진로,20500,20100,-400,-1.95,295704,5939699800
000087,하이트진로2우B,16050,15950,-100,-0.62,2443,38839750
000140,하이트진로홀딩스,8880,8880,0,0.0,6751,60399360
000145,하이트진로홀딩스우,9350,9450,100,1.07,2219,20714170
152550,한국ANKOR유전,1810,1810,0,0.0,14251,25520410
036460,한국가스공사,40200,40600,400,1.0,181650,7381588550
005430,한국공항,47450,47200,-250,-0.53,4958,233507450
071050,한국금융지주,71200,71000,-200,-0.28,170968,12117708200
071055,한국금융지주우,42650,42500,-150,-0.35,1554,65909950
010040,한국내화,5200,5130,-70,-1.35,305355,1587977790
025540,한국단자,65000,64500,-500,-0.77,15632,1009764500
004090,한국석유,112500,110000,-2500,-2.22,1310,146907000
002960,한국쉘석유,315000,318500,3500,1.11,3949,1259960500
123890,한국자산신탁,3970,3890,-80,-2.02,42083,164608450
015760,한국전력,25100,24700,-400,-1.59,1433905,35415399050
006200,한국전자홀딩스,788,777,-11,-1.4,158398,122691999
002300,한국제지,17850,17500,-350,-1.96,3786,66277250
023350,한국종합기술,4320,4285,-35,-0.81,18248,77927840
025890,한국주강,1835,1855,20,1.09,23796,47597395
000970,한국주철관,9630,9840,210,2.18,57741,567651380
104700,한국철강,6170,6150,-20,-0.32,48370,296538280
017960,한국카본,7880,7790,-90,-1.14,244637,1895264160
161890,한국콜마,63800,63700,-100,-0.16,76000,4837076600
024720,한국콜마홀딩스,31900,30850,-1050,-3.29,28275,876870300
161390,한국타이어앤테크놀로지,36550,35600,-950,-2.6,248132,8851444150
000240,한국테크놀로지그룹,16900,16600,-300,-1.78,54239,902462100
034830,한국토지신탁,2280,2310,30,1.32,473219,1088852600
007280,한국특수형강,1765,1735,-30,-1.7,53747,92908775
168490,한국패러랠,2285,2280,-5,-0.22,56390,128604250
010100,한국프랜지,1660,1660,0,0.0,31159,51618970
047810,한국항공우주,32550,32850,300,0.92,278544,9068970500
123690,한국화장품,10300,10100,-200,-1.94,35035,352714650
003350,한국화장품제조,29550,29000,-550,-1.86,10285,298897650
011500,한농화성,4125,4130,5,0.12,11642,47771205
002390,한독,27750,26000,-1750,-6.31,106549,2787324350
014790,한라,3575,3535,-40,-1.12,61370,214794230
060980,한라홀딩스,40050,40200,150,0.37,11294,455436550
053690,한미글로벌,10250,10350,100,0.98,68644,703708150
042700,한미반도체,7260,6980,-280,-3.86,219590,1542631360
008930,한미사이언스,69100,68600,-500,-0.72,27765,1902394400
128940,한미약품,403000,397000,-6000,-1.49,26656,10606378500
009240,한샘,91300,84100,-7200,-7.89,240705,20602725700
020000,한섬,43300,42050,-1250,-2.89,43891,1853849750
003680,한성기업,6620,6400,-220,-3.32,67510,441861120
105630,한세실업,23700,23950,250,1.05,166334,3995366300
069640,한세엠케이,5670,5520,-150,-2.65,7970,44310980
016450,한세예스24홀딩스,8360,8320,-40,-0.48,17703,146604230
010420,한솔PNS,1370,1360,-10,-0.73,127114,173474965
009180,한솔로지스틱스,1395,1370,-25,-1.79,86775,119213975
213500,한솔제지,14300,13750,-550,-3.85,110613,1528245450
014680,한솔케미칼,83800,82500,-1300,-1.55,34812,2866035000
004710,한솔테크닉스,6450,6590,140,2.17,158185,1034909320
004150,한솔홀딩스,4395,4345,-50,-1.14,78987,344944155
025750,한솔홈데코,1335,1310,-25,-1.87,365621,480073105
004960,한신공영,18000,17800,-200,-1.11,22019,391258100
011700,한신기계,2040,2005,-35,-1.72,51104,102005225
001750,한양증권,7440,7330,-110,-1.48,24105,175159850
001755,한양증권우,8380,8450,70,0.84,116,977760
018880,한온시스템,11850,11550,-300,-2.53,415592,4818395050
009420,한올바이오파마,28550,26300,-2250,-7.88,487660,13061038750
014130,한익스프레스,6950,6730,-220,-3.17,297727,2011771130
300720,한일시멘트,129000,131000,2000,1.55,2078,274846000
002220,한일철강,2020,2030,10,0.5,6236,12530890
006390,한일현대시멘트,31900,31650,-250,-0.78,21644,683109250
003300,한일홀딩스,53500,51300,-2200,-4.11,8936,465006800
051600,한전KPS,31250,31000,-250,-0.8,103003,3195776600
052690,한전기술,21050,20400,-650,-3.09,88517,1811330050
130660,한전산업,3475,3450,-25,-0.72,33973,116749270
002320,한진,42150,43100,950,2.25,110655,4720021600
097230,한진중공업,7240,7360,120,1.66,1387444,10551712310
003480,한진중공업홀딩스,3550,3550,0,0.0,60144,215984510
180640,한진칼,43150,42600,-550,-1.27,1021752,43970689900
18064K,한진칼우,56900,54200,-2700,-4.75,100482,5496243500
005110,한창,2980,2940,-40,-1.34,571482,1671591920
009460,한창제지,3260,3185,-75,-2.3,1756816,5684466145
000880,한화,25800,25350,-450,-1.74,196087,4983847900
00088K,한화3우B,13550,13400,-150,-1.11,60695,811788050
027390,한화갤러리아타임월드,24100,23400,-700,-2.9,19419,458019500
088350,한화생명,3275,3190,-85,-2.6,6444611,20595493675
000370,한화손해보험,4065,4035,-30,-0.74,252051,1017260440
012450,한화에어로스페이스,30900,30300,-600,-1.94,152670,4630215100
000885,한화우,31000,28950,-2050,-6.61,59605,1767068950
009830,한화케미칼,21050,20400,-650,-3.09,604691,12390235900
009835,한화케미칼우,13200,12800,-400,-3.03,31706,409387750
003530,한화투자증권,2165,2155,-10,-0.46,229816,497083865
003535,한화투자증권우,2350,2270,-80,-3.4,33703,77444850
195870,해성디에스,15000,14650,-350,-2.33,44081,649035550
101530,해태제과식품,9140,9210,70,0.77,39264,358426220
143210,핸즈코퍼레이션,6250,6170,-80,-1.28,28729,175664750
000720,현대건설,50700,49600,-1100,-2.17,260463,12961894400
267270,현대건설기계,40450,40450,0,0.0,78556,3176413400
000725,현대건설우,161000,163000,2000,1.24,1248,199814500
005440,현대그린푸드,12050,12000,-50,-0.41,217537,2606232900
086280,현대글로비스,158000,159000,1000,0.63,91034,14488413000
064350,현대로템,20300,19600,-700,-3.45,385242,7609947650
079430,현대리바트,18550,18150,-400,-2.16,35177,641819850
012330,현대모비스,217000,217500,500,0.23,204658,44695592500
010620,현대미포조선,48550,47850,-700,-1.44,89480,4289419800
069960,현대백화점,85100,84900,-200,-0.24,44288,3755707200
004560,현대비앤지스틸,8810,8590,-220,-2.5,57794,496230300
004565,현대비앤지스틸우,65800,65600,-200,-0.3,781,50920600
011760,현대상사,21800,21100,-700,-3.21,64038,1362368800
011200,현대상선,3370,3310,-60,-1.78,1045968,3445096045
004310,현대약품,4690,4570,-120,-2.56,280928,1285116650
126560,현대에이치씨엔,4065,3960,-105,-2.58,61101,243907670
017800,현대엘리베이,80300,79700,-600,-0.75,98355,7843401700
307950,현대오토에버,61000,59600,-1400,-2.3,17037,1018702300
011210,현대위아,42500,41650,-850,-2.0,66857,2796941200
267260,현대일렉트릭,18500,17600,-900,-4.86,46177,818257400
004020,현대제철,41150,40500,-650,-1.58,190691,7736623250
009540,현대중공업,114000,111000,-3000,-2.63,218180,24196533500
267250,현대중공업지주,314500,307000,-7500,-2.38,36152,11132699500
005380,현대차,136500,134000,-2500,-1.83,637263,85120663000
005387,현대차2우B,81500,82000,500,0.61,154197,12482336180
005389,현대차3우B,73000,73200,200,0.27,1956,141841400
005385,현대차우,74900,75900,1000,1.34,63647,4744877700
001500,현대차증권,9810,9690,-120,-1.22,27281,263718440
227840,현대코퍼레이션홀딩스,14150,14000,-150,-1.06,24234,338763750
001450,현대해상,31200,30350,-850,-2.72,257666,7838526850
057050,현대홈쇼핑,94100,92400,-1700,-1.81,13057,1210431300
093240,형지엘리트,1755,1775,20,1.14,2233210,4093207905
003010,혜인,5010,5070,60,1.2,928907,4784764710
111110,호전실업,13000,13200,200,1.54,11974,155309100
008770,호텔신라,92400,93600,1200,1.3,305139,28402751800
008775,호텔신라우,57500,57500,0,0.0,12717,722684000
002460,화성산업,13450,13100,-350,-2.6,40387,532450100
013520,화승알앤에이,2215,2220,5,0.23,49495,108497640
241590,화승엔터프라이즈,15400,14900,-500,-3.25,177551,2642124650
006060,화승인더,9890,10200,310,3.13,195690,1985760820
010690,화신,2800,2810,10,0.36,16775,46994290
133820,화인베스틸,3550,3410,-140,-3.94,552274,1898141410
010660,화천기계,2470,2475,5,0.2,799462,1940078475
000850,화천기공,42800,42400,-400,-0.93,1149,48596800
016580,환인제약,18400,18150,-250,-1.36,35854,653186050
032560,황금에스티,7920,7810,-110,-1.39,33632,262426000
004800,효성,78500,75000,-3500,-4.46,99408,7569641100
094280,효성ITX,10200,10150,-50,-0.49,9064,91567950
298040,효성중공업,35950,34650,-1300,-3.62,23821,831468000
298050,효성첨단소재,112500,110000,-2500,-2.22,15845,1749847000
298020,효성티앤씨,142000,139000,-3000,-2.11,17237,2395393000
298000,효성화학,142000,141000,-1000,-0.7,12493,1763611500
093370,후성,7340,7160,-180,-2.45,405293,2915425990
081660,휠라코리아,80700,80300,-400,-0.5,313625,25324206900
005870,휴니드,8520,8230,-290,-3.4,33289,276390590
079980,휴비스,7300,7180,-120,-1.64,55797,401792050
005010,휴스틸,11500,11300,-200,-1.74,12250,138373000
069260,휴켐스,21250,20600,-650,-3.06,76320,1588024300
000540,흥국화재,4385,4350,-35,-0.8,33251,144892455
000547,흥국화재2우B,23000,23250,250,1.09,430,9931150
000545,흥국화재우,5820,5770,-50,-0.86,2852,16282640
003280,흥아해운,345,303,-42,-12.17,12906346,4084887897
