티커,종목명,시가,종가,변동폭,등락률,거래량,거래대금
095570,AJ네트웍스,5320,5350,30,0.56,27976,148544210
068400,AJ렌터카,11050,11150,100,0.9,240421,2704305650
006840,AK홀딩스,44500,44400,-100,-0.22,17615,781700500
027410,BGF,7340,7230,-110,-1.5,117133,850380570
282330,BGF리테일,206500,206500,0,0.0,10014,2060620500
138930,BNK금융지주,7470,7510,40,0.54,624877,4667134420
001460,BYC,234500,234500,0,0.0,467,109181000
001465,BYC우,135000,137500,2500,1.85,59,8008500
001040,CJ,101000,101000,0,0.0,35135,3555771000
079160,CJCGV,36900,36450,-450,-1.22,99888,3670244400
000120,CJ대한통운,136000,132500,-3500,-2.57,73249,9768603000
011150,CJ씨푸드,2615,2620,5,0.19,355255,928978440
011155,CJ씨푸드1우,31850,32400,550,1.73,2936,95530000
001045,CJ우,54800,55200,400,0.73,2784,152171800
097950,CJ제일제당,298000,292500,-5500,-1.85,24991,7337042000
097955,CJ제일제당우,128500,128000,-500,-0.39,1539,195441500
037560,CJ헬로,6910,6860,-50,-0.72,145531,1001450650
000590,CS홀딩스,63100,63500,400,0.63,192,12100600
012030,DB,911,899,-12,-1.32,826522,744960042
016610,DB금융투자,5180,5190,10,0.19,30178,156393780
005830,DB손해보험,59300,57500,-1800,-3.04,150088,8658282500
000990,DB하이텍,14900,15900,1000,6.71,1647526,25625839850
000995,DB하이텍1우,39400,42100,2700,6.85,62622,2770916050
139130,DGB금융지주,8170,8160,-10,-0.12,987155,8027137200
001530,DI동일,87500,86600,-900,-1.03,1554,133996600
004840,DRB동일,6050,6060,10,0.17,7069,42793780
155660,DSR,5110,5130,20,0.39,80339,415223200
069730,DSR제강,5270,5260,-10,-0.19,211553,1126112030
017940,E1,58700,58700,0,0.0,4422,259168000
007700,FF,92100,90500,-1600,-1.74,59667,5395053500
114090,GKL,20700,21100,400,1.93,214660,4520802550
078930,GS,51300,51500,200,0.39,106880,5480448000
006360,GS건설,40500,40050,-450,-1.11,167110,6750000350
001250,GS글로벌,2935,2915,-20,-0.68,353986,1030914190
007070,GS리테일,38700,39100,400,1.03,98038,3794718600
078935,GS우,37100,37050,-50,-0.13,2418,88487750
012630,HDC,15400,15250,-150,-0.97,162804,2494317300
039570,HDC아이콘트롤스,10300,10100,-200,-1.94,22263,225662000
089470,HDC현대EP,5610,5510,-100,-1.78,38198,210804470
294870,HDC현대산업개발,43750,43750,0,0.0,42796,1869500400
082740,HSD엔진,3830,3760,-70,-1.83,87159,327673950
003560,IHQ,1945,1970,25,1.29,880996,1737254860
175330,JB금융지주,6010,6000,-10,-0.17,115171,688851690
234080,JW생명과학,23200,24000,800,3.45,61674,1460652900
001060,JW중외제약,31900,31950,50,0.16,24441,779157350
001067,JW중외제약2우B,42350,42700,350,0.83,56,2378900
001065,JW중외제약우,26850,26800,-50,-0.19,2601,69230200
096760,JW홀딩스,6150,6220,70,1.14,35641,220078150
105560,KB금융,46700,46050,-650,-1.39,735629,33961047200
002380,KCC,276000,278000,2000,0.72,9581,2659950000
009070,KCTC,3500,3545,45,1.29,100031,355618970
009440,KC그린홀딩스,4270,4220,-50,-1.17,38980,164196700
119650,KC코트렐,6560,6560,0,0.0,116476,762773470
092220,KEC,1185,1185,0,0.0,1474656,1742536460
001390,KG케미칼,12550,12600,50,0.4,16582,208490850
001940,KISCO홀딩스,14200,14200,0,0.0,2705,38278950
025000,KPX케미칼,58800,58200,-600,-1.02,3654,212748600
092230,KPX홀딩스,59200,59200,0,0.0,114,6726200
000040,KR모터스,531,531,0,0.0,100866,53655358
044450,KSS해운,7180,7110,-70,-0.97,18862,133879230
030200,KT,28200,28250,50,0.18,245424,6933831510
033780,KTG,98200,98000,-200,-0.2,147116,14428560500
030210,KTB투자증권,3165,3100,-65,-2.05,251748,783380670
058850,KTcs,2255,2245,-10,-0.44,30015,67451875
058860,KTis,2410,2430,20,0.83,80115,193904595
093050,LF,23100,23050,-50,-0.22,28009,647136000
003550,LG,76700,76600,-100,-0.13,123203,9441929000
034220,LG디스플레이,17500,17500,0,0.0,839140,14648366450
001120,LG상사,17900,18450,550,3.07,189126,3458796850
051900,LG생활건강,1314000,1276000,-38000,-2.89,28388,36413678000
051905,LG생활건강우,801000,804000,3000,0.37,3576,2854842000
003555,LG우,49100,49150,50,0.1,2474,121305650
032640,LG유플러스,14700,14800,100,0.68,670936,9876603550
011070,LG이노텍,114000,112500,-1500,-1.32,89180,10100342000
066570,LG전자,76700,77400,700,0.91,559142,43126018100
066575,LG전자우,32400,32650,250,0.77,8172,265594350
108670,LG하우시스,62000,62100,100,0.16,14727,914844900
108675,LG하우시스우,30350,30450,100,0.33,289,8770950
051910,LG화학,355000,348500,-6500,-1.83,105241,36975080500
051915,LG화학우,196500,196500,0,0.0,4369,856388000
079550,LIG넥스원,30650,30650,0,0.0,122205,3717696100
006260,LS,49600,49650,50,0.1,114387,5695515550
000680,LS네트웍스,3305,3340,35,1.06,20226,67023160
010120,LS산전,51500,50800,-700,-1.36,72826,3712670400
229640,LS전선아시아,8560,9200,640,7.48,557225,5003897930
023150,MH에탄올,6360,6470,110,1.73,2186,14116900
035420,NAVER,114500,115000,500,0.44,273980,31233797000
181710,NHN,72300,72400,100,0.14,117718,8414856300
005940,NH투자증권,14700,14900,200,1.36,761196,11301603650
005945,NH투자증권우,9440,9460,20,0.21,40418,382229360
034310,NICE,22250,21900,-350,-1.57,100238,2174970550
008260,NI스틸,2800,2890,90,3.21,94723,268627435
004250,NPC,3730,3595,-135,-3.62,47113,170852800
004255,NPC우,2275,2275,0,0.0,628,1418770
010060,OCI,96200,96300,100,0.1,88565,8496783800
005490,POSCO,252000,247500,-4500,-1.79,194690,48227255500
100840,STC,15200,14950,-250,-1.64,51889,777973800
064960,ST모티브,43600,45100,1500,3.44,52486,2369070750
003570,ST중공업,7090,7080,-10,-0.14,2364,16718040
036530,ST홀딩스,14450,14950,500,3.46,34344,506991100
010950,S-Oil,84300,86500,2200,2.61,415020,35449043000
010955,S-Oil우,59200,59800,600,1.01,6809,404528800
034120,SBS,20150,20050,-100,-0.5,72403,1450253100
101060,SBS미디어홀딩스,2265,2290,25,1.1,16424,37361330
004060,SG세계물산,1085,1080,-5,-0.46,4440822,4817616750
001380,SG충방,2300,2265,-35,-1.52,306210,696401135
002360,SH에너지화학,1235,1240,5,0.4,1195262,1482688675
009160,SIMPAC,3240,3315,75,2.31,262204,865695760
123700,SJM,3480,3530,50,1.44,10257,35770465
025530,SJM홀딩스,3280,3310,30,0.91,3261,10750985
034730,SK,232000,233000,1000,0.43,56316,13072507500
011790,SKC,39100,38400,-700,-1.79,233433,8907555200
018670,SK가스,79100,79000,-100,-0.13,3620,286806000
001740,SK네트웍스,5220,5150,-70,-1.34,698597,3601918460
001745,SK네트웍스우,90500,92500,2000,2.21,4631,442681000
006120,SK디스커버리,27450,27550,100,0.36,20207,555938900
006125,SK디스커버리우,17800,17900,100,0.56,17761,321946250
210980,SK디앤디,28050,27550,-500,-1.78,14454,397464900
03473K,SK우,144500,144500,0,0.0,277,39837000
096770,SK이노베이션,161500,165000,3500,2.17,358513,58915535000
096775,SK이노베이션우,119500,119500,0,0.0,3286,394868000
001510,SK증권,725,722,-3,-0.41,917332,662749865
001515,SK증권우,3415,3405,-10,-0.29,39675,134579020
285130,SK케미칼,58300,57800,-500,-0.86,14295,826741700
28513K,SK케미칼우,24500,24350,-150,-0.61,6761,164774200
017670,SK텔레콤,257000,260500,3500,1.36,98501,25628393000
000660,SK하이닉스,70000,71400,1400,2.0,2495399,176911763000
005610,SPC삼립,99900,99800,-100,-0.1,3812,381329400
011810,STX,11550,11700,150,1.3,52086,611201800
077970,STX엔진,7470,7660,190,2.54,42980,324716300
071970,STX중공업,3905,3885,-20,-0.51,65537,253358700
084870,TBH글로벌,3040,3135,95,3.13,160785,492790100
002710,TCC스틸,2410,2420,10,0.41,31303,75595415
024070,WISCOM,2685,2680,-5,-0.19,5045,13547705
037270,YGPLUS,1360,1390,30,2.21,136509,187026945
000500,가온전선,19450,19450,0,0.0,4477,86705100
000860,강남제비스코,26050,25700,-350,-1.34,3220,82857300
035250,강원랜드,30300,30600,300,0.99,183205,5569999050
011420,갤럭시아에스엠,2160,2360,200,9.26,1344690,3073767030
002100,경농,18000,18050,50,0.28,403743,7218685250
009450,경동나비엔,42050,42600,550,1.31,25859,1089589000
267290,경동도시가스,30700,30850,150,0.49,4122,127609400
012320,경동인베스트,40850,40400,-450,-1.1,6384,258156250
000050,경방,10400,10450,50,0.48,3515,36741200
214390,경보제약,9830,9800,-30,-0.31,10031,98457430
012610,경인양행,6700,6400,-300,-4.48,1999061,13344418620
009140,경인전자,24400,26600,2200,9.02,50254,1355059850
013580,계룡건설,28150,27800,-350,-1.24,2892,80744100
012200,계양전기,3510,3500,-10,-0.28,19501,68059605
012205,계양전기우,8720,8700,-20,-0.23,11584,100624400
004200,고려개발,4930,4980,50,1.01,13852,68634370
002140,고려산업,3165,3910,745,23.54,35099144,133042689425
010130,고려아연,455000,457000,2000,0.44,47674,21746192000
002240,고려제강,26900,26800,-100,-0.37,8776,237187250
009290,광동제약,7470,7640,170,2.28,842195,6401052370
017040,광명전기,2585,2605,20,0.77,244098,635291940
017900,광전자,2630,2650,20,0.76,115430,306481795
037710,광주신세계,184000,185000,1000,0.54,513,94589500
030610,교보증권,10850,10800,-50,-0.46,20170,217449550
007690,국도화학,46150,47650,1500,3.25,17618,832564100
005320,국동,2125,2150,25,1.18,2033427,4171730965
001140,국보,5200,5260,60,1.15,2274316,11778585615
002720,국제약품,4480,4480,0,0.0,282258,1286431090
083420,그린케미칼,3680,3720,40,1.09,17878,66283760
014530,극동유화,3600,3700,100,2.78,334714,1229743355
014280,금강공업,4480,4730,250,5.58,1364872,6552075105
014285,금강공업우,11500,11500,0,0.0,96186,1145207950
008870,금비,67700,68100,400,0.59,507,34593400
001570,금양,2335,2285,-50,-2.14,28506,65805880
002990,금호산업,14050,14000,-50,-0.36,107218,1528037850
002995,금호산업우,56000,55700,-300,-0.54,19957,1133722800
011780,금호석유,96800,94600,-2200,-2.27,113430,10730147800
011785,금호석유우,37500,37550,50,0.13,4238,157742950
214330,금호에이치티,5480,5320,-160,-2.92,72593,388759850
001210,금호전기,3460,3435,-25,-0.72,38673,132794165
073240,금호타이어,3990,3990,0,0.0,256909,1027030080
092440,기신정기,4480,4540,60,1.34,169836,764114695
000270,기아차,42900,42950,50,0.12,727011,31088833350
024110,기업은행,14100,14050,-50,-0.35,510904,7148884150
013700,까뮤이앤씨,1315,1305,-10,-0.76,116361,151416600
004540,깨끗한나라,2260,2300,40,1.77,482388,1127727110
004545,깨끗한나라우,15300,15500,200,1.31,16049,249853800
074610,나노메딕스,9310,9530,220,2.36,2727743,26237306970
001260,남광토건,14200,14000,-200,-1.41,41675,586240700
008350,남선알미늄,3580,3645,65,1.82,3324153,12012870390
008355,남선알미우,36200,36000,-200,-0.55,10548,381093750
004270,남성,3565,3800,235,6.59,15025320,57226610645
003920,남양유업,562000,565000,3000,0.53,275,155108000
003925,남양유업우,208500,208500,0,0.0,2,417000
002070,남영비비안,6870,6850,-20,-0.29,384,2617360
025860,남해화학,11200,11200,0,0.0,113818,1269032450
005720,넥센,6470,6460,-10,-0.15,10340,66600850
005725,넥센우,3865,3860,-5,-0.13,281,1086155
002350,넥센타이어,9620,9590,-30,-0.31,63284,609079770
002355,넥센타이어1우B,4165,4165,0,0.0,6,24940
003580,넥스트사이언스,4180,4055,-125,-2.99,395340,1627992790
251270,넷마블,100500,101500,1000,1.0,627641,63485366000
090350,노루페인트,7920,7920,0,0.0,33857,267725790
090355,노루페인트우,11800,11450,-350,-2.97,9636,111602350
000320,노루홀딩스,12350,12350,0,0.0,3898,48086350
000325,노루홀딩스우,19350,19450,100,0.52,1192,22916400
006280,녹십자,125500,123500,-2000,-1.59,15079,1866102000
005250,녹십자홀딩스,21900,21900,0,0.0,31413,689253200
005257,녹십자홀딩스2우,17000,17250,250,1.47,5085,87732750
004370,농심,250000,246500,-3500,-1.4,6522,1618617000
072710,농심홀딩스,89900,90000,100,0.11,1014,91098600
058730,다스코,7020,7050,30,0.43,34959,245128810
023590,다우기술,21800,22250,450,2.06,100533,2229044050
019680,대교,6210,6300,90,1.45,26560,166773800
019685,대교우B,4560,4560,0,0.0,534,2434400
006370,대구백화점,6970,6890,-80,-1.15,7988,55232660
008060,대덕전자,10850,11100,250,2.3,988351,10887452550
00806K,대덕전자1우,6290,6330,40,0.64,8656,54534070
000490,대동공업,6130,6040,-90,-1.47,37430,224704630
008110,대동전자,4945,4840,-105,-2.12,22982,110915965
005750,대림BCo,4615,4640,25,0.54,5046,23213760
000210,대림산업,114000,114500,500,0.44,79850,9119038000
000215,대림산업우,45450,45400,-50,-0.11,831,37670300
004440,대림씨엔에스,10100,10050,-50,-0.5,4144,41465040
006570,대림통상,4285,4325,40,0.93,413,1777625
001680,대상,24400,24850,450,1.84,176228,4424088800
001685,대상우,13500,13750,250,1.85,10720,146604050
084690,대상홀딩스,7360,7420,60,0.82,19576,144957800
084695,대상홀딩스우,6060,5970,-90,-1.49,34575,203910250
128820,대성산업,5100,5010,-90,-1.76,76042,383490875
117580,대성에너지,5560,5550,-10,-0.18,3913,21745910
016710,대성홀딩스,7850,7970,120,1.53,3588,28280240
003540,대신증권,13950,13900,-50,-0.36,78153,1083780050
003547,대신증권2우B,8810,8800,-10,-0.11,12715,111794490
003545,대신증권우,9510,9510,0,0.0,26148,248248020
009190,대양금속,7830,7940,110,1.4,32062,253538980
014160,대영포장,1340,1365,25,1.87,2373862,3207751000
047040,대우건설,5010,5040,30,0.6,577221,2900620215
009320,대우부품,2380,2450,70,2.94,1199032,2916670695
042660,대우조선해양,32450,32750,300,0.92,177066,5797568000
003090,대웅,16850,17350,500,2.97,37167,641009800
069620,대웅제약,151500,157500,6000,3.96,49924,7806930000
000430,대원강업,4535,4470,-65,-1.43,50870,228281575
006340,대원전선,1435,1415,-20,-1.39,293878,418382170
006345,대원전선우,3450,3420,-30,-0.87,12169,41233245
003220,대원제약,15900,16100,200,1.26,14292,229578250
024890,대원화성,1755,1750,-5,-0.28,65168,113633650
002880,대유에이텍,1075,1085,10,0.93,223075,241830345
000300,대유플러스,907,917,10,1.1,260028,236572307
012800,대창,1345,1420,75,5.58,4675611,6555855065
015230,대창단조,40600,40200,-400,-0.99,941,37857250
001070,대한방직,21150,20800,-350,-1.65,4531,94582300
006650,대한유화,129500,132000,2500,1.93,26056,3421558500
001440,대한전선,712,714,2,0.28,1227161,871069876
084010,대한제강,8000,7960,-40,-0.5,35871,284186120
001790,대한제당,22100,22000,-100,-0.45,2463,54031100
001799,대한제당3우B,23500,23400,-100,-0.43,736,17339000
001795,대한제당우,13000,12950,-50,-0.38,4520,58071150
001130,대한제분,199000,199500,500,0.25,672,133442500
003490,대한항공,29000,29300,300,1.03,313513,9167620300
003495,대한항공우,16550,17050,500,3.02,35255,591608050
005880,대한해운,27000,26100,-900,-3.33,267463,6924162150
003830,대한화섬,106500,106500,0,0.0,105,11124500
016090,대현,2525,2490,-35,-1.39,59823,149007965
069460,대호에이엘,4855,5000,145,2.99,499719,2422331740
192080,더블유게임즈,61100,61400,300,0.49,64210,3934916200
012510,더존비즈온,61100,61000,-100,-0.16,167199,10184541180
004830,덕성,3225,3355,130,4.03,656285,2132591875
004835,덕성우,3975,4055,80,2.01,102644,410972235
024900,덕양산업,1565,1495,-70,-4.47,1603719,2453797235
145720,덴티움,74500,75400,900,1.21,28651,2157254500
002150,도화엔지니어링,11450,11150,-300,-2.62,129512,1457722100
001230,동국제강,6780,6740,-40,-0.59,126273,851980180
023450,동남합성,24100,24300,200,0.83,1698,41056500
004140,동방,2035,2100,65,3.19,633216,1312029510
007590,동방아그로,7310,7260,-50,-0.68,14312,104249590
005960,동부건설,10750,11300,550,5.12,193891,2153734550
005965,동부건설우,19150,19100,-50,-0.26,4571,87291500
016380,동부제철,6910,7000,90,1.3,8781,61282770
016385,동부제철우,34950,34700,-250,-0.72,1673,57883200
083370,동북아12호,5030,5010,-20,-0.4,0,0
083380,동북아13호,5030,5030,0,0.0,0,0
026960,동서,19050,18850,-200,-1.05,39741,751641600
002210,동성제약,20850,20850,0,0.0,754972,15854919450
102260,동성코퍼레이션,5910,5910,0,0.0,32281,190400760
005190,동성화학,16850,16750,-100,-0.59,9081,151612400
000640,동아쏘시오홀딩스,97700,96300,-1400,-1.43,7475,722426400
170900,동아에스티,102500,101000,-1500,-1.46,9588,970789500
028100,동아지질,27500,27550,50,0.18,575761,15906731300
282690,동아타이어,13300,13300,0,0.0,384,5085600
001520,동양,1805,1810,5,0.28,130644,236146240
001527,동양2우B,10600,10500,-100,-0.94,1017,10681500
001529,동양3우B,30800,31000,200,0.65,223,6905750
084670,동양고속,25950,25950,0,0.0,432,11215200
030790,동양네트웍스,1910,1900,-10,-0.52,727986,1380043455
002900,동양물산,1860,1865,5,0.27,393010,730528005
082640,동양생명,4400,4445,45,1.02,80425,354425195
001525,동양우,8660,8490,-170,-1.96,566,4758190
008970,동양철관,1550,1465,-85,-5.48,2393504,3565571840
092780,동양피스톤,5190,5180,-10,-0.19,93737,484181000
049770,동원FB,277000,280000,3000,1.08,5333,1493968500
018500,동원금속,859,899,40,4.66,402947,355727748
006040,동원산업,242500,242000,-500,-0.21,1830,443027000
030720,동원수산,8510,8590,80,0.94,25141,213870670
014820,동원시스템즈,43350,44150,800,1.85,89064,3955472750
014825,동원시스템즈우,31000,31950,950,3.06,1689,53545900
163560,동일고무벨트,6440,6480,40,0.62,6940,44683300
004890,동일산업,61500,61700,200,0.33,1691,104576000
002690,동일제강,3095,3060,-35,-1.13,11078,33969840
000020,동화약품,9710,9750,40,0.41,22238,216597070
000150,두산,99500,98500,-1000,-1.01,34708,3436840600
000157,두산2우B,77100,77600,500,0.65,52,3999800
011160,두산건설,1435,1455,20,1.39,154480,223284715
241560,두산밥캣,36250,36100,-150,-0.41,120764,4325763950
000155,두산우,75400,75300,-100,-0.13,2236,167841700
042670,두산인프라코어,6250,6210,-40,-0.64,1202464,7476688960
034020,두산중공업,6300,6290,-10,-0.16,553351,3483074370
016740,두올,3480,3600,120,3.45,170664,610695050
192650,드림텍,8030,8000,-30,-0.37,585044,4676601520
024090,디씨엠,12350,12400,50,0.4,1492,18459950
003160,디아이,3980,4010,30,0.75,136115,538951105
092200,디아이씨,3120,3180,60,1.92,195302,615002915
013570,디와이,5790,5940,150,2.59,152785,905955440
210540,디와이파워,13900,13500,-400,-2.88,122291,1665933450
007340,디티알오토모티브,33450,33350,-100,-0.3,1414,47154250
026890,디피씨,5240,5220,-20,-0.38,468223,2454857820
115390,락앤락,15550,15350,-200,-1.29,86911,1343050225
032350,롯데관광개발,13200,13200,0,0.0,54695,719249200
000400,롯데손해보험,2370,2365,-5,-0.21,200991,472750255
023530,롯데쇼핑,165500,163500,-2000,-1.21,58826,9672625000
004000,롯데정밀화학,53100,53500,400,0.75,89945,4830416200
286940,롯데정보통신,40050,40250,200,0.5,41036,1657814600
280360,롯데제과,172500,173000,500,0.29,789,135848500
004990,롯데지주,44150,44300,150,0.34,88502,3898595300
00499K,롯데지주우,52100,53700,1600,3.07,7703,408722200
005300,롯데칠성,170000,171000,1000,0.59,9942,1694892000
005305,롯데칠성우,80000,80300,300,0.38,283,22634500
011170,롯데케미칼,256000,260500,4500,1.76,87625,22748734500
002270,롯데푸드,581000,575000,-6000,-1.03,1454,837706000
071840,롯데하이마트,44200,43600,-600,-1.36,34304,1499041050
027740,마니커,1085,1005,-80,-7.37,27127810,27226354828
204320,만도,29850,29700,-150,-0.5,155102,4588305600
001080,만호제강,19050,19500,450,2.36,11471,222101000
088980,맥쿼리인프라,11750,11800,50,0.43,500185,5898344100
094800,맵스리얼티1,4400,4450,50,1.14,53592,237627330
015540,메디파트너생명공학,7300,7240,-60,-0.82,21380,153885480
138040,메리츠금융지주,14450,14600,150,1.04,38701,557805450
008560,메리츠종금증권,5450,5520,70,1.28,1200005,6602095990
000060,메리츠화재,20400,19850,-550,-2.7,231981,4662712100
090370,메타랩스,1740,1805,65,3.74,536477,956756805
017180,명문제약,5230,5270,40,0.76,109718,575768530
012690,모나리자,3305,3345,40,1.21,70484,235365655
005360,모나미,2590,2570,-20,-0.77,73785,188177675
204210,모두투어리츠,2995,2995,0,0.0,3959,11867060
009680,모토닉,10650,10700,50,0.47,47835,515714450
009580,무림PP,5180,5180,0,0.0,132362,682229110
009200,무림페이퍼,3190,3180,-10,-0.31,113997,360576525
033920,무학,11200,11100,-100,-0.89,13402,149467550
008420,문배철강,3295,3330,35,1.06,216275,709623575
025560,미래산업,176,175,-1,-0.57,18173662,3194660923
007120,미래아이앤지,366,365,-1,-0.27,718546,261640121
006800,미래에셋대우,8180,8200,20,0.24,1036111,8488843000
00680K,미래에셋대우2우B,4130,4125,-5,-0.12,202349,833987670
006805,미래에셋대우우,4895,4905,10,0.2,87598,430327235
085620,미래에셋생명,4465,4445,-20,-0.45,93275,413232370
002840,미원상사,47400,45550,-1850,-3.9,823,38267450
268280,미원에스씨,75600,74700,-900,-1.19,2248,168882500
107590,미원홀딩스,42750,42600,-150,-0.35,187,7957850
134380,미원화학,41600,41700,100,0.24,90,3770500
003650,미창석유,78700,78300,-400,-0.51,320,25058100
155900,바다로19호,3000,2985,-15,-0.5,16084,47946015
003610,방림,2225,2220,-5,-0.22,24494,54743440
001340,백광산업,2985,3010,25,0.84,195840,587301350
014580,백광소재,3830,3890,60,1.57,1608068,6252372460
035150,백산,8700,9220,520,5.98,318316,2930812360
002410,범양건영,1830,1830,0,0.0,49046,89232235
096300,베트남개발1,420,420,0,0.0,91727,38526629
007210,벽산,2320,2325,5,0.22,127431,295617740
002760,보락,2290,2285,-5,-0.22,151095,345684880
003850,보령제약,11800,11550,-250,-2.12,144808,1683098500
000890,보해양조,1275,1305,30,2.35,1702221,2191195115
003000,부광약품,17750,17550,-200,-1.13,132269,2322324000
001270,부국증권,21150,21150,0,0.0,3040,63872700
001275,부국증권우,19150,19200,50,0.26,108,2072950
026940,부국철강,4095,4135,40,0.98,416898,1729749760
015350,부산가스,37500,37600,100,0.27,1388,51939650
011390,부산산업,137000,133000,-4000,-2.92,21182,2853908000
005030,부산주공,602,607,5,0.83,188387,113685695
100220,비상교육,9880,9270,-610,-6.17,254904,2397179100
101140,비티원,4120,4195,75,1.82,138614,575374200
005180,빙그레,68500,69600,1100,1.61,13782,957721000
003960,사조대림,20000,20400,400,2.0,22587,453678050
008040,사조동아원,1385,1385,0,0.0,1012627,1401437495
007160,사조산업,51600,52200,600,1.16,4866,251480000
014710,사조씨푸드,6220,6230,10,0.16,18039,111714100
006090,사조오양,7990,7900,-90,-1.13,21867,172957250
005090,삼광글라스,36550,36300,-250,-0.68,4275,153931650
001470,삼부토건,903,896,-7,-0.78,184235,163774350
006400,삼성SDI,238000,234500,-3500,-1.47,157208,37108555000
006405,삼성SDI우,91100,90800,-300,-0.33,1779,162212900
006660,삼성공조,10350,10400,50,0.48,124,1284850
028260,삼성물산,96000,95200,-800,-0.83,135944,12966649100
02826K,삼성물산우B,71000,71000,0,0.0,795,56400400
207940,삼성바이오로직스,321000,324000,3000,0.93,46162,14936556000
032830,삼성생명,84100,84200,100,0.12,90946,7616698000
018260,삼성에스디에스,213500,210000,-3500,-1.64,57328,12096884000
028050,삼성엔지니어링,17300,17400,100,0.58,403868,7011474800
009150,삼성전기,99900,98100,-1800,-1.8,696060,68510804600
009155,삼성전기우,44100,43950,-150,-0.34,5748,252498250
005930,삼성전자,46600,46250,-350,-0.75,8463073,393048199550
005935,삼성전자우,38350,38150,-200,-0.52,746740,28384990800
001360,삼성제약,2565,2585,20,0.78,107225,275472500
010140,삼성중공업,8170,8220,50,0.61,1260676,10340224690
010145,삼성중공우,60100,61500,1400,2.33,2256,138769900
016360,삼성증권,38850,39100,250,0.64,232790,9074759800
068290,삼성출판사,17050,17050,0,0.0,53949,921610100
029780,삼성카드,37900,37850,-50,-0.13,67633,2559741650
000810,삼성화재,269000,264500,-4500,-1.67,115803,30648321000
000815,삼성화재우,191000,189500,-1500,-0.79,7410,1405291000
006110,삼아알미늄,4910,4915,5,0.1,26770,130674100
145990,삼양사,56400,55600,-800,-1.42,4973,278066000
145995,삼양사우,36850,36900,50,0.14,177,6509650
003230,삼양식품,70100,70400,300,0.43,11780,825775800
002170,삼양통상,66800,66800,0,0.0,7092,472341700
272550,삼양패키징,17550,17550,0,0.0,10368,181188650
000070,삼양홀딩스,74000,74300,300,0.41,5811,432914500
000075,삼양홀딩스우,50000,49850,-150,-0.3,74,3652450
002810,삼영무역,16100,16250,150,0.93,14143,226990650
005680,삼영전자,11550,11500,-50,-0.43,13065,149686350
003720,삼영화학,1170,1240,70,5.98,413988,506572305
023000,삼원강재,2995,3000,5,0.17,6274,18807130
004380,삼익THK,12150,12450,300,2.47,51291,631135250
002450,삼익악기,1910,1915,5,0.26,162350,309352600
000520,삼일제약,27900,28200,300,1.08,86535,2423450350
009770,삼정펄프,32950,32750,-200,-0.61,325,10671850
005500,삼진제약,30700,30350,-350,-1.14,33314,1015942450
004690,삼천리,94200,94400,200,0.21,1325,124478500
001880,삼호,24000,24300,300,1.25,8040,193559600
010960,삼호개발,5350,5310,-40,-0.75,72345,381564280
004450,삼화왕관,46000,45700,-300,-0.65,18,826100
009470,삼화전기,16500,16500,0,0.0,17494,288838850
011230,삼화전자,3070,3160,90,2.93,35043,109311040
001820,삼화콘덴서,52200,51500,-700,-1.34,74698,3857947500
000390,삼화페인트,5570,5550,-20,-0.36,8816,48564340
001290,상상인증권,2390,2340,-50,-2.09,31710,74905110
041650,상신브레이크,4000,4000,0,0.0,13026,51803190
075180,새론오토모티브,5400,5400,0,0.0,2578,13898850
007540,샘표,41450,42200,750,1.81,20934,878406800
248170,샘표식품,32100,32000,-100,-0.31,21430,683068650
007860,서연,4995,4685,-310,-6.21,1504183,7630003700
200880,서연이화,6250,6170,-80,-1.28,75523,462916800
017390,서울가스,77500,77500,0,0.0,52,4035300
004410,서울식품,206,206,0,0.0,2019210,413104184
004415,서울식품우,4095,4055,-40,-0.98,14251,57879670
021050,서원,1240,1265,25,2.02,483677,608905955
008490,서흥,34250,34250,0,0.0,11808,406857700
007610,선도전기,4055,4085,30,0.74,190827,775738885
136490,선진,11100,10950,-150,-1.35,17357,190902000
002820,선창산업,5110,5150,40,0.78,4632,23646170
014910,성문전자,2730,2700,-30,-1.1,79581,216032255
014915,성문전자우,13450,13150,-300,-2.23,22599,297737000
003080,성보화학,5160,5140,-20,-0.39,1196,6147430
004980,성신양회,10150,9990,-160,-1.58,209740,2111139060
004985,성신양회우,12000,11700,-300,-2.5,10933,129231050
011300,성안,575,567,-8,-1.39,62619,35352100
000180,성창기업지주,1985,1965,-20,-1.01,137043,267906465
002420,세기상사,64800,65700,900,1.39,968,63035400
004360,세방,14400,14400,0,0.0,1547,22268200
004365,세방우,7200,7120,-80,-1.11,127,898500
004490,세방전지,42000,42050,50,0.12,13840,580104850
001430,세아베스틸,18450,18550,100,0.54,34808,646768500
306200,세아제강,72800,71300,-1500,-2.06,7548,545911600
003030,세아제강지주,58500,57500,-1000,-1.71,2925,168581600
019440,세아특수강,14750,14650,-100,-0.68,24149,351461150
058650,세아홀딩스,93200,93200,0,0.0,153,14227400
013000,세우글로벌,1895,1910,15,0.79,441421,843488430
091090,세원셀론텍,3430,3365,-65,-1.9,226498,763384815
021820,세원정공,8500,8510,10,0.12,7193,61378260
067830,세이브존IC,3955,3940,-15,-0.38,5498,21504010
033530,세종공업,5710,5640,-70,-1.23,145169,821916410
075580,세진중공업,5130,5020,-110,-2.14,102673,519720220
027970,세하,1470,1470,0,0.0,34718,50352940
145210,세화아이엠씨,2990,2990,0,0.0,0,0
068270,셀트리온,208000,205000,-3000,-1.44,220246,45424884000
004430,송원산업,22550,22150,-400,-1.77,160552,3583345550
017550,수산중공업,1725,1735,10,0.58,355575,616094815
002200,수출포장,21500,21350,-150,-0.7,4980,105620800
053210,스카이라이프,10700,10650,-50,-0.47,41037,437425800
134790,시디즈,42500,43000,500,1.18,765,32899050
016590,신대양제지,81000,79800,-1200,-1.48,15107,1206577200
029530,신도리코,47500,47200,-300,-0.63,4691,221017800
004970,신라교역,13950,14000,50,0.36,2860,40074500
011930,신성이엔지,1300,1310,10,0.77,383541,499676705
005390,신성통상,1100,1130,30,2.73,1002361,1112927880
004170,신세계,306500,294500,-12000,-3.92,68548,20319647000
035510,신세계IC,120500,119000,-1500,-1.24,3840,458452500
034300,신세계건설,30800,31750,950,3.08,6975,217110700
031430,신세계인터내셔날,215000,202000,-13000,-6.05,79870,16411803000
031440,신세계푸드,85900,85500,-400,-0.47,2086,177937700
006880,신송홀딩스,5390,6120,730,13.54,8010843,49549781060
005800,신영와코루,120000,120000,0,0.0,31,3740000
001720,신영증권,60000,60400,400,0.67,702,42266500
001725,신영증권우,54300,54400,100,0.18,1072,58143800
009270,신원,2500,2515,15,0.6,12066577,30712032175
009275,신원우,61200,58000,-3200,-5.23,25268,1500501000
002700,신일산업,2145,2120,-25,-1.17,4999958,10775435110
019170,신풍제약,6870,6920,50,0.73,122214,841589470
019175,신풍제약우,6250,6410,160,2.56,11556,72985580
002870,신풍제지,1410,1425,15,1.06,216081,304824755
005450,신한,4945,4945,0,0.0,0,0
293940,신한알파리츠,6820,7000,180,2.64,228534,1594521450
055550,신한지주,45050,44800,-250,-0.55,1335748,59904302000
001770,신화실업,22750,22700,-50,-0.22,2711,61338500
004080,신흥,10000,10000,0,0.0,1075,10718410
102280,쌍방울,1130,1105,-25,-2.21,14114016,16444049175
003410,쌍용양회,6300,6290,-10,-0.16,597717,3748862910
003415,쌍용양회우,6570,6480,-90,-1.37,24942,161667760
003620,쌍용차,3960,3800,-160,-4.04,389046,1486018150
004770,써니전자,3400,3425,25,0.74,1508061,5130529940
004920,씨아이테크,523,513,-10,-1.91,553230,282590109
112610,씨에스윈드,42150,42850,700,1.66,30772,1317185400
008700,아남전자,2860,2915,55,1.92,933218,2704669060
002790,아모레G,62900,62300,-600,-0.95,76900,4775239900
002795,아모레G우,27100,27100,0,0.0,3960,106121000
090430,아모레퍼시픽,164000,160000,-4000,-2.44,212482,34230811500
090435,아모레퍼시픽우,87800,87200,-600,-0.68,3453,298690000
002030,아세아,114500,114000,-500,-0.44,401,45680500
183190,아세아시멘트,99300,100000,700,0.7,3376,337931800
002310,아세아제지,37500,37200,-300,-0.8,31838,1181858850
267850,아시아나IDT,22400,22250,-150,-0.67,438535,10099623600
020560,아시아나항공,5500,5580,80,1.45,2227716,12699849390
122900,아이마켓코리아,11500,11500,0,0.0,35159,404834750
010780,아이에스동서,37900,38200,300,0.79,38452,1459846300
033660,아주캐피탈,11200,10950,-250,-2.23,41202,455046950
001780,알루코,2890,2845,-45,-1.56,276266,791940735
018250,애경산업,38100,38250,150,0.39,102410,3911752500
161000,애경유화,7920,7980,60,0.76,132242,1060513140
011090,에넥스,1345,1350,5,0.37,124556,166868230
005850,에스엘,23750,23350,-400,-1.68,39031,914381700
012750,에스원,98400,97400,-1000,-1.02,38079,3724803100
023960,에쓰씨엔지니어링,1665,1695,30,1.8,24959,41919690
298690,에어부산,6190,6380,190,3.07,639968,4141664250
140910,에이리츠,6110,6240,130,2.13,14890,92730310
078520,에이블씨엔씨,11900,11850,-50,-0.42,95727,1137992100
015260,에이엔피,466,469,3,0.64,322701,150002653
007460,에이프로젠KIC,2850,2895,45,1.58,1976001,5708247755
003060,에이프로젠제약,1280,1270,-10,-0.78,646259,832663070
036570,엔씨소프트,468000,459000,-9000,-1.92,80270,36926886750
138250,엔에스쇼핑,12000,11850,-150,-1.25,27890,331606050
085310,엔케이,1325,1320,-5,-0.38,236480,311078150
009810,엔케이물산,1380,1340,-40,-2.9,956208,1269932125
900140,엘브이엠씨홀딩스,2975,3090,115,3.87,197022,594624980
014440,영보화학,3915,3920,5,0.13,4470,17456845
111770,영원무역,38100,37650,-450,-1.18,93607,3531884600
009970,영원무역홀딩스,60200,60900,700,1.16,547,33236500
003520,영진약품,5160,5190,30,0.58,322140,1668167570
000670,영풍,700000,717000,17000,2.43,949,676965000
006740,영풍제지,3430,3430,0,0.0,52692,179044155
012280,영화금속,1550,1580,30,1.94,780567,1225510260
012160,영흥철강,1385,1390,5,0.36,474637,660135370
015360,예스코홀딩스,41500,41450,-50,-0.12,515,21384850
007310,오뚜기,681000,686000,5000,0.73,3769,2593470000
079440,오렌지라이프,31400,31550,150,0.48,106127,3345394650
002630,오리엔트바이오,514,524,10,1.95,1014188,526471233
271560,오리온,94400,92600,-1800,-1.91,66290,6193768400
001800,오리온홀딩스,17250,17300,50,0.29,36149,623580400
070960,용평리조트,8190,8200,10,0.12,779322,6357833460
316140,우리금융지주,14000,14050,50,0.36,435041,6083381050
004720,우리들제약,7320,7210,-110,-1.5,21887,159418140
118000,우리들휴브레인,2340,2360,20,0.85,90032,212715100
010050,우리종금,757,760,3,0.4,1066859,811128539
006980,우성사료,3250,3300,50,1.54,520304,1717135145
017370,우신시스템,6030,6060,30,0.5,8932,53673120
105840,우진,6260,6260,0,0.0,70204,436880650
010400,우진아이엔에스,10200,10350,150,1.47,16675,170959800
049800,우진플라임,4665,4660,-5,-0.11,21166,98950970
016880,웅진,1590,1615,25,1.57,1706715,2738213605
095720,웅진씽크빅,2575,2590,15,0.58,812041,2103868755
103130,웅진에너지,914,914,0,0.0,0,0
021240,웅진코웨이,77000,77200,200,0.26,177491,13507263700
005820,원림,18300,18550,250,1.37,1480,27247950
010600,웰바이오텍,4640,4655,15,0.32,2665456,11823777300
008600,윌비스,1190,1185,-5,-0.42,383346,452559335
033270,유나이티드제약,22950,23250,300,1.31,35384,820848050
014830,유니드,48950,48800,-150,-0.31,13134,641100850
000910,유니온,4785,4885,100,2.09,336016,1632385890
047400,유니온머티리얼,2525,2620,95,3.76,1841183,4771212175
011330,유니켐,2210,2225,15,0.68,220192,491239195
077500,유니퀘스트,7280,7170,-110,-1.51,58889,425650760
002920,유성기업,3040,3095,55,1.81,10654,32926800
000700,유수홀딩스,7840,7750,-90,-1.15,29066,226286690
003470,유안타증권,3245,3245,0,0.0,84666,274832210
003475,유안타증권우,2220,2250,30,1.35,4101,9164890
011690,유양디앤유,7590,7550,-40,-0.53,267565,2009378070
072130,유엔젤,4410,4530,120,2.72,61186,274091985
000220,유유제약,11650,11550,-100,-0.86,24364,284010550
000225,유유제약1우,7440,7480,40,0.54,2517,18760200
000227,유유제약2우B,19200,19200,0,0.0,708,13476850
001200,유진투자증권,2715,2735,20,0.74,138402,377335750
000100,유한양행,251500,248000,-3500,-1.39,94686,23678063000
000105,유한양행우,215500,218000,2500,1.16,3688,810309500
003460,유화증권,12650,12750,100,0.79,3086,39078700
003465,유화증권우,12800,12900,100,0.78,7,90150
008730,율촌화학,13600,13500,-100,-0.74,8015,108695600
008250,이건산업,9520,9500,-20,-0.21,48090,456202250
025820,이구산업,2080,2140,60,2.88,282465,596754395
214320,이노션,71700,71900,200,0.28,38429,2785145700
088260,이리츠코크렙,6130,6290,160,2.61,154863,964138750
139480,이마트,144000,142000,-2000,-1.39,63585,9051794500
007660,이수페타시스,5370,5520,150,2.79,1025941,5566793090
005950,이수화학,9600,9530,-70,-0.73,4857,46382070
015020,이스타코,681,668,-13,-1.91,73425,49209731
093230,이아이디,589,596,7,1.19,26793563,15671622960
102460,이연제약,16500,16700,200,1.21,11179,185435300
084680,이월드,3150,3285,135,4.29,935267,3005635350
000760,이화산업,17150,17350,200,1.17,309,5268550
014990,인디에프,2995,3175,180,6.01,28754022,92313285610
006490,인스코비,3170,3065,-105,-3.31,1477928,4575072255
023800,인지컨트롤스,6820,6830,10,0.15,202840,1385446110
034590,인천도시가스,29500,29550,50,0.17,103,3038850
129260,인터지스,2570,2625,55,2.14,218765,566563115
023810,인팩,4115,4060,-55,-1.34,10623,43301740
249420,일동제약,20050,20250,200,1.0,41913,847103150
000230,일동홀딩스,13100,13200,100,0.76,9384,124240350
013360,일성건설,1555,1510,-45,-2.89,469220,709064285
003120,일성신약,89900,89900,0,0.0,63,5646400
003200,일신방직,95800,95400,-400,-0.42,703,66911100
007110,일신석재,3315,3190,-125,-3.77,5169785,16751984930
007570,일양약품,26350,26200,-150,-0.57,17425,458452900
007575,일양약품우,19850,19850,0,0.0,645,12739150
008500,일정실업,19850,19400,-450,-2.27,230,4529250
081000,일진다이아,30450,31000,550,1.81,154127,4761099100
020760,일진디스플,5000,5130,130,2.6,272567,1395988110
020150,일진머티리얼즈,39050,39150,100,0.26,357256,13924205800
103590,일진전기,3240,3195,-45,-1.39,22767,72960505
015860,일진홀딩스,3275,3270,-5,-0.15,30536,99724985
226320,잇츠한불,23600,23250,-350,-1.48,33484,777603500
033240,자화전자,12100,12050,-50,-0.41,54708,656663500
000950,전방,17350,17450,100,0.58,691,11922200
194370,제이에스코퍼레이션,17250,18050,800,4.64,57685,1030224250
025620,제이준코스메틱,6650,6590,-60,-0.9,147038,973477020
030000,제일기획,28850,29150,300,1.04,211669,6116175500
271980,제일약품,37850,38150,300,0.79,14831,560297500
001560,제일연마,6730,6680,-50,-0.74,6362,42527300
002620,제일파마홀딩스,22200,22100,-100,-0.45,5314,117398200
006220,제주은행,4705,4705,0,0.0,39763,187274105
089590,제주항공,32950,32100,-850,-2.58,86097,2771686950
004910,조광페인트,6540,6450,-90,-1.38,5466,35291970
004700,조광피혁,36900,36800,-100,-0.27,483,17856050
001550,조비,24100,24150,50,0.21,70870,1705295500
000480,조선내화,86500,88100,1600,1.85,7014,614542500
120030,조선선재,87000,87300,300,0.34,654,57043200
018470,조일알미늄,920,930,10,1.09,84082,77516095
002600,조흥,168000,170000,2000,1.19,87,14611000
185750,종근당,93300,92300,-1000,-1.07,11446,1059557100
063160,종근당바이오,28100,27750,-350,-1.25,33234,923528400
001630,종근당홀딩스,104500,107000,2500,2.39,59017,6355135000
044380,주연테크,468,462,-6,-1.28,1185321,546026810
013870,지엠비코리아,6900,7020,120,1.74,53881,375538770
071320,지역난방공사,53200,54000,800,1.5,2501,133860000
010580,지코,866,875,9,1.04,591116,511239150
035000,지투알,8270,8170,-100,-1.21,4442,36238070
088790,진도,3990,4030,40,1.0,10557,42340700
003780,진양산업,3590,3700,110,3.06,155124,568060345
010640,진양폴리,2295,2330,35,1.53,43903,102290415
100250,진양홀딩스,2580,2585,5,0.19,21964,56614700
051630,진양화학,5480,5900,420,7.66,1146433,6621877680
272450,진에어,21300,20700,-600,-2.82,98031,2045264000
011000,진원생명과학,4450,4455,5,0.11,59198,263276175
002780,진흥기업,2445,2405,-40,-1.64,193589,466629745
002787,진흥기업2우B,15200,15200,0,0.0,9297,140856450
002785,진흥기업우B,5930,5800,-130,-2.19,51538,298793290
009310,참엔지니어링,1390,1460,70,5.04,105187,149175215
000650,천일고속,73800,73900,100,0.14,390,28735200
012600,청호컴넷,3770,3740,-30,-0.8,30551,113445045
033250,체시스,2290,2275,-15,-0.66,396489,889076245
035720,카카오,129500,131500,2000,1.54,264488,34393070000
006380,카프로,4315,4310,-5,-0.12,73901,319350910
109070,컨버즈,3260,3260,0,0.0,0,0
001620,케이비아이동국실업,932,903,-29,-3.11,99348,90407548
029460,케이씨,14000,14200,200,1.43,38013,533314050
281820,케이씨텍,14850,15300,450,3.03,271591,4132939850
145270,케이탑리츠,920,919,-1,-0.11,49341,45162260
007815,코리아써우,2780,2745,-35,-1.26,153,420745
007810,코리아써키트,5480,5470,-10,-0.18,8430,45973970
00781K,코리아써키트2우B,4560,4530,-30,-0.66,1,4530
152330,코리아오토글라스,21000,20700,-300,-1.43,50582,1041507700
003690,코리안리,8700,8560,-140,-1.61,187607,1609618860
192820,코스맥스,110000,108000,-2000,-1.82,70447,7630156500
044820,코스맥스비티아이,19500,19550,50,0.26,18527,359428700
005070,코스모신소재,13650,13450,-200,-1.47,81664,1107182950
005420,코스모화학,11450,11500,50,0.44,70105,805319350
071950,코아스,1670,1660,-10,-0.6,1149277,1890777655
002020,코오롱,18450,18150,-300,-1.63,22428,410078400
003070,코오롱글로벌,10450,10750,300,2.87,59760,630796250
003075,코오롱글로벌우,16200,16500,300,1.85,869,14078300
144620,코오롱머티리얼,1925,1925,0,0.0,46534,89335695
002025,코오롱우,11650,11300,-350,-3.0,4573,51996400
120110,코오롱인더,43850,44250,400,0.91,194978,8768697300
120115,코오롱인더우,21500,21300,-200,-0.93,23659,511761100
138490,코오롱플라스틱,5190,5210,20,0.39,19916,103400560
031820,콤텍시스템,1865,1960,95,5.09,7362149,14113504570
192400,쿠쿠홀딩스,138000,135500,-2500,-1.81,2801,382159500
284740,쿠쿠홈시스,49000,49600,600,1.22,23621,1168994800
015590,큐로,906,901,-5,-0.55,860824,781273876
264900,크라운제과,9450,9440,-10,-0.11,13314,125568640
26490K,크라운제과우,8250,8250,0,0.0,3778,31165490
005740,크라운해태홀딩스,12200,12600,400,3.28,230134,2851569000
005745,크라운해태홀딩스우,14750,14550,-200,-1.36,57878,830046350
020120,키다리스튜디오,3205,3810,605,18.88,12234107,48168293705
039490,키움증권,82200,81400,-800,-0.97,65982,5381797600
012170,키위미디어그룹,197,174,-23,-11.68,13253098,2497916816
015890,태경산업,5920,6000,80,1.35,89726,533110750
006890,태경화학,5590,5850,260,4.65,434170,2502914220
003240,태광산업,1306000,1342000,36000,2.76,977,1295732000
011280,태림포장,6990,7100,110,1.57,834975,5952077280
004100,태양금속,1205,1185,-20,-1.66,58700,69591815
004105,태양금속우,3305,3245,-60,-1.82,17724,57708695
009410,태영건설,14900,14900,0,0.0,250088,3704937300
009415,태영건설우,8160,8100,-60,-0.74,34208,276269030
001420,태원물산,4665,4650,-15,-0.32,3714,17158385
007980,태평양물산,3045,3000,-45,-1.48,85866,257871075
055490,테이팩스,21800,21800,0,0.0,3890,84898900
078000,텔코웨어,18500,18550,50,0.27,27030,496598100
214420,토니모리,12650,12400,-250,-1.98,52689,658823750
019180,티에이치엔,3665,3780,115,3.14,334429,1272757025
091810,티웨이항공,6640,6660,20,0.3,105472,697113680
004870,티웨이홀딩스,2060,2065,5,0.24,207244,425450325
005690,파미셀,8280,8220,-60,-0.72,279185,2306517230
036580,팜스코,6130,6000,-130,-2.12,121797,736811530
028670,팬오션,4565,4560,-5,-0.11,1010838,4644556595
010820,퍼스텍,2630,2615,-15,-0.57,145587,381172650
016800,퍼시스,32250,31900,-350,-1.09,617,19807100
001020,페이퍼코리아,844,840,-4,-0.47,60528,50825648
090080,평화산업,1660,1735,75,4.52,364913,622334440
010770,평화홀딩스,4820,4900,80,1.66,47854,233105285
058430,포스코강판,18850,18850,0,0.0,526,9902100
047050,포스코인터내셔널,18750,19050,300,1.6,245203,4631625050
003670,포스코케미칼,53500,52100,-1400,-2.62,288565,15140974100
007630,폴루스바이오팜,1955,1910,-45,-2.3,518223,1000150605
017810,풀무원,12850,12800,-50,-0.39,57360,737395750
103140,풍산,26200,26200,0,0.0,48594,1274465550
005810,풍산홀딩스,40500,40350,-150,-0.37,2202,88874450
033180,필룩스,5780,5840,60,1.04,1246287,7222086000
086790,하나금융지주,37550,37500,-50,-0.13,787392,29508154900
099340,하나니켈1호,834,826,-8,-0.96,98141,80878742
099350,하나니켈2호,1530,1545,15,0.98,145705,222945575
293480,하나제약,26000,25750,-250,-0.96,90912,2353020750
039130,하나투어,51400,49600,-1800,-3.5,273111,13617712650
172580,하이골드12호,2780,2790,10,0.36,16150,44945780
153360,하이골드3호,1785,1790,5,0.28,19646,35173750
159650,하이골드8호,1825,1805,-20,-1.1,32753,58997680
071090,하이스틸,23500,23150,-350,-1.49,7340,168663550
019490,하이트론,4040,4145,105,2.6,8043,32222145
000080,하이트진로,20300,20750,450,2.22,294959,6106892050
000087,하이트진로2우B,15900,16100,200,1.26,5158,82127050
000140,하이트진로홀딩스,9000,9130,130,1.44,10819,97944820
000145,하이트진로홀딩스우,9820,9980,160,1.63,1124,11086500
152550,한국ANKOR유전,1760,1765,5,0.28,271,477215
036460,한국가스공사,42000,43200,1200,2.86,423016,18152543750
005430,한국공항,44600,44550,-50,-0.11,3001,133886300
071050,한국금융지주,80800,81200,400,0.5,175384,14133546700
071055,한국금융지주우,46750,47700,950,2.03,7346,348615450
010040,한국내화,5850,6070,220,3.76,2081168,12759650280
025540,한국단자,66600,68200,1600,2.4,14895,1013506700
004090,한국석유,115500,117500,2000,1.73,1152,133992000
002960,한국쉘석유,336000,337500,1500,0.45,759,255483500
123890,한국자산신탁,4140,4140,0,0.0,25221,104597365
015760,한국전력,25350,25250,-100,-0.39,1090035,27484360650
006200,한국전자홀딩스,793,804,11,1.39,73759,58974778
002300,한국제지,19100,19200,100,0.52,8040,152846000
009540,한국조선해양,119000,118000,-1000,-0.84,84106,9973797500
023350,한국종합기술,4765,4885,120,2.52,84187,403635220
025890,한국주강,1900,1930,30,1.58,12623,24130675
000970,한국주철관,15150,14200,-950,-6.27,797518,11649977500
104700,한국철강,6150,6100,-50,-0.81,16908,102845000
017960,한국카본,8800,8690,-110,-1.25,235930,2044974170
161890,한국콜마,61000,60400,-600,-0.98,68075,4146462200
024720,한국콜마홀딩스,28500,28200,-300,-1.05,26989,764847450
161390,한국타이어앤테크놀로지,35100,34750,-350,-1.0,294785,10257496500
000240,한국테크놀로지그룹,17000,16750,-250,-1.47,18961,319477250
034830,한국토지신탁,2335,2335,0,0.0,564927,1307375710
007280,한국특수형강,1720,1720,0,0.0,17088,29241665
168490,한국패러랠,2250,2250,0,0.0,16066,35851250
010100,한국프랜지,2095,2190,95,4.53,1750447,3846176445
047810,한국항공우주,35150,36050,900,2.56,382443,13694092450
123690,한국화장품,10150,10000,-150,-1.48,39194,393723950
003350,한국화장품제조,29050,29200,150,0.52,7583,219739700
011500,한농화성,4185,4265,80,1.91,7082,29970215
002390,한독,25400,26000,600,2.36,109227,2836205250
014790,한라,3830,3875,45,1.17,64682,249844100
060980,한라홀딩스,43900,44350,450,1.03,18072,802897450
053690,한미글로벌,11450,11050,-400,-3.49,108225,1210113550
042700,한미반도체,7450,7620,170,2.28,128924,975281730
008930,한미사이언스,69800,67800,-2000,-2.87,51305,3501956400
128940,한미약품,418000,415000,-3000,-0.72,13937,5784983000
009240,한샘,69800,72300,2500,3.58,111358,7990058800
020000,한섬,36350,36600,250,0.69,48931,1803323100
003680,한성기업,6530,6600,70,1.07,112970,744850370
105630,한세실업,21050,20700,-350,-1.66,115117,2390602400
069640,한세엠케이,5400,5400,0,0.0,14670,78938940
016450,한세예스24홀딩스,8420,8530,110,1.31,8359,70332310
010420,한솔PNS,1850,1815,-35,-1.89,3556333,6603798895
009180,한솔로지스틱스,1485,1520,35,2.36,288876,433056725
213500,한솔제지,14600,14700,100,0.68,54095,788290400
014680,한솔케미칼,79500,80700,1200,1.51,108873,8752645100
004710,한솔테크닉스,6540,6550,10,0.15,180939,1187962980
004150,한솔홀딩스,5080,5100,20,0.39,86045,437414940
025750,한솔홈데코,1425,1425,0,0.0,333536,474105520
004960,한신공영,18450,18500,50,0.27,6567,120788750
011700,한신기계,1890,1920,30,1.59,143869,274005935
001750,한양증권,7760,7790,30,0.39,15788,122965500
001755,한양증권우,8670,8460,-210,-2.42,628,5295380
018880,한온시스템,11550,11450,-100,-0.87,741618,8526696900
009420,한올바이오파마,26000,26650,650,2.5,206628,5476426750
014130,한익스프레스,6990,6980,-10,-0.14,174921,1256766360
300720,한일시멘트,128500,127000,-1500,-1.17,4751,611741500
002220,한일철강,2180,2180,0,0.0,10640,23143355
006390,한일현대시멘트,38900,37800,-1100,-2.83,26324,1004166100
003300,한일홀딩스,52900,53000,100,0.19,1978,104529200
051600,한전KPS,31250,31000,-250,-0.8,90153,2800754000
052690,한전기술,20500,20400,-100,-0.49,34824,709945650
130660,한전산업,3615,3635,20,0.55,27688,99627285
002320,한진,35900,36550,650,1.81,36606,1333388850
097230,한진중공업,6070,6000,-70,-1.15,109688,660787510
003480,한진중공업홀딩스,3285,3325,40,1.22,15960,53458690
180640,한진칼,29900,30450,550,1.84,721952,21918181200
18064K,한진칼우,37800,37500,-300,-0.79,29830,1131706400
005110,한창,3620,3700,80,2.21,5917369,21834975840
009460,한창제지,3160,3225,65,2.06,865878,2754141400
000880,한화,27000,27100,100,0.37,129534,3525400050
00088K,한화3우B,14100,14100,0,0.0,15173,213765400
027390,한화갤러리아타임월드,23150,23000,-150,-0.65,10850,251435200
088350,한화생명,3260,3190,-70,-2.15,1909903,6092101300
000370,한화손해보험,4100,4065,-35,-0.85,422383,1713096515
012450,한화에어로스페이스,32200,32650,450,1.4,119872,3916032400
000885,한화우,31000,31050,50,0.16,19962,648665950
009830,한화케미칼,23100,23250,150,0.65,830229,19192155900
009835,한화케미칼우,13750,13900,150,1.09,25820,361586750
003530,한화투자증권,2580,2575,-5,-0.19,321018,831124010
003535,한화투자증권우,2395,2465,70,2.92,34725,85151315
195870,해성디에스,13350,13550,200,1.5,34012,460884400
101530,해태제과식품,9150,9050,-100,-1.09,12511,113759070
143210,핸즈코퍼레이션,6850,6850,0,0.0,4734,32264160
000720,현대건설,55000,54900,-100,-0.18,332865,18300299700
267270,현대건설기계,41150,40800,-350,-0.85,36952,1517355100
000725,현대건설우,192000,186500,-5500,-2.86,2762,514741000
005440,현대그린푸드,13200,13150,-50,-0.38,94019,1236022300
086280,현대글로비스,160500,161500,1000,0.62,44926,7234887000
064350,현대로템,22300,21800,-500,-2.24,483302,10627658850
079430,현대리바트,17650,17500,-150,-0.85,36624,646040450
012330,현대모비스,235000,232000,-3000,-1.28,166913,38751011000
010620,현대미포조선,49700,49050,-650,-1.31,150205,7375771000
069960,현대백화점,83200,82100,-1100,-1.32,71955,5928535500
004560,현대비앤지스틸,9100,9010,-90,-0.99,6097,54910730
004565,현대비앤지스틸우,65700,65700,0,0.0,390,25643300
011760,현대상사,24600,24400,-200,-0.81,83816,2050701200
011200,현대상선,3845,3745,-100,-2.6,6352834,25270065180
004310,현대약품,4915,4885,-30,-0.61,141567,694308190
126560,현대에이치씨엔,4080,3990,-90,-2.21,35323,141921165
017800,현대엘리베이,98400,96200,-2200,-2.24,449996,43497487000
307950,현대오토에버,59200,57600,-1600,-2.7,60234,3501782100
011210,현대위아,47900,47300,-600,-1.25,128207,6061681950
267260,현대일렉트릭,18400,17850,-550,-2.99,90421,1627626150
004020,현대제철,42750,41900,-850,-1.99,218676,9192691850
267250,현대중공업지주,325000,325500,500,0.15,19847,6486379500
005380,현대차,141000,137000,-4000,-2.84,444895,61162973000
005387,현대차2우B,88000,86100,-1900,-2.16,91966,7888733500
005389,현대차3우B,75900,74200,-1700,-2.24,8783,654844000
005385,현대차우,80200,78600,-1600,-2.0,18463,1448748800
001500,현대차증권,10600,10650,50,0.47,22673,240087250
227840,현대코퍼레이션홀딩스,14000,13900,-100,-0.71,34306,477634650
001450,현대해상,28500,28000,-500,-1.75,262464,7376228150
057050,현대홈쇼핑,106000,103500,-2500,-2.36,26783,2792108500
093240,형지엘리트,1815,1815,0,0.0,120260,216676750
003010,혜인,5540,5630,90,1.62,736216,4180337170
111110,호전실업,13000,13100,100,0.77,242,3138300
008770,호텔신라,98700,92700,-6000,-6.08,1156447,108694889300
008775,호텔신라우,54800,53700,-1100,-2.01,8073,431156600
002460,화성산업,13800,13800,0,0.0,13231,181630300
013520,화승알앤에이,2095,2030,-65,-3.1,88620,181587890
241590,화승엔터프라이즈,13950,14450,500,3.58,172447,2511161900
006060,화승인더,9120,9630,510,5.59,1406871,13864986520
010690,화신,2750,2745,-5,-0.18,40182,109790870
133820,화인베스틸,3470,3545,75,2.16,210428,733990455
010660,화천기계,2980,3100,120,4.03,12565514,39894221595
000850,화천기공,43450,44400,950,2.19,14751,647386000
016580,환인제약,17500,17600,100,0.57,20589,361749900
032560,황금에스티,8300,8250,-50,-0.6,17574,145425280
004800,효성,72500,72500,0,0.0,35308,2551157900
094280,효성ITX,10100,10150,50,0.5,4356,44176450
298040,효성중공업,34500,34150,-350,-1.01,8806,302065600
298050,효성첨단소재,120000,125000,5000,4.17,23113,2842681000
298020,효성티앤씨,143500,145500,2000,1.39,18334,2643256000
298000,효성화학,150500,157500,7000,4.65,29097,4540822000
093370,후성,7460,7300,-160,-2.14,9899985,76790146510
081660,휠라코리아,76900,78300,1400,1.82,273123,21418872500
005870,휴니드,8140,8020,-120,-1.47,17590,141612500
079980,휴비스,7430,7350,-80,-1.08,32519,239862290
005010,휴스틸,12450,12400,-50,-0.4,9102,112635750
069260,휴켐스,21900,22200,300,1.37,105817,2352878250
000540,흥국화재,4440,4450,10,0.23,5452,24158940
000547,흥국화재2우B,23000,22850,-150,-0.65,138,3147950
000545,흥국화재우,5840,5860,20,0.34,357,2088180
003280,흥아해운,620,612,-8,-1.29,693009,424836359
