티커,종목명,시가,종가,변동폭,등락률,거래량,거래대금
095570,AJ네트웍스,4300,4365,65,1.51,22241,95764520
068400,AJ렌터카,12300,12500,200,1.63,427857,5375827150
006840,AK홀딩스,31200,31450,250,0.8,22550,707380050
027410,BGF,6000,6000,0,0.0,88087,524707680
282330,BGF리테일,192000,197000,5000,2.6,28870,5582227000
138930,BNK금융지주,7070,7190,120,1.7,483219,3461914470
001460,BYC,245000,240000,-5000,-2.04,659,159037500
001465,BYC우,132000,130500,-1500,-1.14,279,36287500
001040,CJ,82700,82000,-700,-0.85,37051,3050995100
079160,CJCGV,33700,33400,-300,-0.89,39774,1332703550
00104K,CJ4우전환,60000,60000,0,0.0,7029,419483600
000120,CJ대한통운,146500,144500,-2000,-1.37,35245,5136448500
011150,CJ씨푸드,3305,3100,-205,-6.2,1695096,5360220110
011155,CJ씨푸드1우,37000,35400,-1600,-4.32,15500,553546150
001045,CJ우,44200,43800,-400,-0.9,2656,115827000
097950,CJ제일제당,234000,234500,500,0.21,16739,3908686000
097955,CJ제일제당우,106500,105000,-1500,-1.41,3579,376875500
037560,CJ헬로,6140,6250,110,1.79,355178,2199414130
000590,CS홀딩스,58400,58100,-300,-0.51,431,24808900
012030,DB,770,762,-8,-1.04,242187,185019061
016610,DB금융투자,4500,4535,35,0.78,41268,185062120
005830,DB손해보험,52200,51600,-600,-1.15,131708,6819069500
000990,DB하이텍,16150,16000,-150,-0.93,206852,3309810450
000995,DB하이텍1우,39000,38350,-650,-1.67,1066,41779500
139130,DGB금융지주,7390,7450,60,0.81,543687,4041956070
001530,DI동일,81700,81700,0,0.0,3248,262754900
004840,DRB동일,5650,5640,-10,-0.18,1767,9868380
155660,DSR,4270,4145,-125,-2.93,35671,149749680
069730,DSR제강,4660,4530,-130,-2.79,107292,492019080
017940,E1,49500,49400,-100,-0.2,4792,236572750
007700,FF,95000,96900,1900,2.0,43770,4190541100
114090,GKL,20600,20650,50,0.24,115332,2381945000
078930,GS,49750,50300,550,1.11,112061,5617193100
006360,GS건설,32200,33000,800,2.48,214447,6986936200
001250,GS글로벌,2435,2395,-40,-1.64,128954,310159250
007070,GS리테일,41100,41250,150,0.36,120087,4949268350
078935,GS우,36650,36700,50,0.14,1507,55290300
012630,HDC,12950,12900,-50,-0.39,187689,2427086500
039570,HDC아이콘트롤스,9570,9560,-10,-0.1,16925,161142900
089470,HDC현대EP,4645,4680,35,0.75,35201,162993685
294870,HDC현대산업개발,32600,32850,250,0.77,113202,3699138050
082740,HSD엔진,3385,3430,45,1.33,48013,161197235
003560,IHQ,1905,1875,-30,-1.57,530354,996293835
175330,JB금융지주,5590,5620,30,0.54,138350,775380050
234080,JW생명과학,21250,21250,0,0.0,24571,517827750
001060,JW중외제약,28400,27500,-900,-3.17,87532,2440508400
001067,JW중외제약2우B,40100,40700,600,1.5,1873,75667450
001065,JW중외제약우,25550,25300,-250,-0.98,1014,26117800
096760,JW홀딩스,5900,5850,-50,-0.85,43569,256312560
105560,KB금융,42400,42700,300,0.71,815797,34789744800
002380,KCC,219500,218000,-1500,-0.68,14678,3200721500
009070,KCTC,3185,3170,-15,-0.47,32058,102349320
009440,KC그린홀딩스,4470,4400,-70,-1.57,32707,144201570
119650,KC코트렐,6630,6780,150,2.26,258727,1745035160
092220,KEC,1115,1065,-50,-4.48,1320785,1423034855
001390,KG케미칼,11600,11450,-150,-1.29,15059,172538850
001940,KISCO홀딩스,12200,12550,350,2.87,49210,601143100
025000,KPX케미칼,54000,54300,300,0.56,1758,95919100
092230,KPX홀딩스,54600,54600,0,0.0,68,3697100
000040,KR모터스,500,504,4,0.8,141311,70793144
044450,KSS해운,7030,7070,40,0.57,16701,117596410
030200,KT,27450,27450,0,0.0,276201,7591082900
033780,KTG,104500,105500,1000,0.96,172361,18134440000
030210,KTB투자증권,2480,2480,0,0.0,62930,155560445
058850,KTcs,2035,2015,-20,-0.98,37603,75946270
058860,KTis,2260,2255,-5,-0.22,19457,43455165
093050,LF,20200,20200,0,0.0,43087,871234700
003550,LG,68900,70000,1100,1.6,222478,15497709700
034220,LG디스플레이,13700,14150,450,3.28,1249666,17621435050
001120,LG상사,17200,17150,-50,-0.29,62394,1069741900
051900,LG생활건강,1306000,1307000,1000,0.08,20282,26510782840
051905,LG생활건강우,755000,771000,16000,2.12,2025,1545848000
003555,LG우,46200,46600,400,0.87,7417,345995650
032640,LG유플러스,13550,13650,100,0.74,974958,13234672700
011070,LG이노텍,114500,114000,-500,-0.44,132093,15014142477
066570,LG전자,66700,67400,700,1.05,364683,24538560300
066575,LG전자우,27300,27450,150,0.55,17732,487085200
108670,LG하우시스,60100,60300,200,0.33,12479,749227800
108675,LG하우시스우,29100,29150,50,0.17,457,13223450
051910,LG화학,301500,299500,-2000,-0.66,214811,64293379352
051915,LG화학우,168000,167500,-500,-0.3,20679,3438581500
079550,LIG넥스원,34800,35650,850,2.44,142401,5084441600
006260,LS,47100,47450,350,0.74,23371,1105849950
000680,LS네트웍스,2480,2465,-15,-0.6,10962,26780075
010120,LS산전,47650,48150,500,1.05,30319,1451374400
229640,LS전선아시아,7870,8020,150,1.91,67672,538225270
023150,MH에탄올,5970,5940,-30,-0.5,4208,25098990
035420,NAVER,156000,157000,1000,0.64,313910,49019728000
181710,NHN,62700,62300,-400,-0.64,32282,2011316400
005940,NH투자증권,12500,12700,200,1.6,481041,6042588750
005945,NH투자증권우,9020,9010,-10,-0.11,48298,434344550
034310,NICE,19150,19100,-50,-0.26,50622,964749700
008260,NI스틸,2380,2365,-15,-0.63,22240,52091000
004250,NPC,4000,4020,20,0.5,5733,22950195
004255,NPC우,2310,2310,0,0.0,1065,2459650
010060,OCI,66700,69500,2800,4.2,125369,8617471800
005490,POSCO,225000,227000,2000,0.89,156949,35491068500
100840,STC,17350,16950,-400,-2.31,14808,252165250
064960,ST모티브,52200,54300,2100,4.02,55684,2969223300
003570,ST중공업,6160,6130,-30,-0.49,5784,35296260
036530,ST홀딩스,14800,14950,150,1.01,2781,41142750
010950,S-Oil,100000,99400,-600,-0.6,207857,20612318200
010955,S-Oil우,59500,59400,-100,-0.17,2749,163106600
034120,SBS,17950,18250,300,1.67,38186,687952850
101060,SBS미디어홀딩스,2120,2155,35,1.65,23351,50084105
004060,SG세계물산,1085,1075,-10,-0.92,821428,879931060
001380,SG충방,2075,2020,-55,-2.65,252406,516281015
002360,SH에너지화학,1080,1060,-20,-1.85,802251,858340325
009160,SIMPAC,3755,3815,60,1.6,621478,2330524500
123700,SJM,3100,3095,-5,-0.16,1862,5751065
025530,SJM홀딩스,3095,3075,-20,-0.65,794,2460400
034730,SK,202500,204000,1500,0.74,85899,17432689500
011790,SKC,39350,39800,450,1.14,195520,7778978800
018670,SK가스,74600,74400,-200,-0.27,4174,311530700
001740,SK네트웍스,5470,5560,90,1.65,962608,5332288620
001745,SK네트웍스우,90400,89300,-1100,-1.22,2544,227494700
006120,SK디스커버리,22200,21950,-250,-1.13,35216,774489850
006125,SK디스커버리우,14700,14600,-100,-0.68,7674,111403200
210980,SK디앤디,27050,27650,600,2.22,2056,56472900
03473K,SK우,139000,140500,1500,1.08,712,100217500
096770,SK이노베이션,164000,166000,2000,1.22,191316,31728471000
096775,SK이노베이션우,116500,117000,500,0.43,3026,355423500
001510,SK증권,620,619,-1,-0.16,483598,298685642
001515,SK증권우,2820,2770,-50,-1.77,4306,12018880
285130,SK케미칼,46150,45300,-850,-1.84,15723,713169100
28513K,SK케미칼우,20600,20400,-200,-0.97,2608,53603900
017670,SK텔레콤,239500,241500,2000,0.84,125115,30067694500
000660,SK하이닉스,81400,82200,800,0.98,2442478,200012415300
005610,SPC삼립,98200,96900,-1300,-1.32,6809,657871800
011810,STX,8200,8200,0,0.0,18323,149178160
077970,STX엔진,8200,7990,-210,-2.56,15687,126067610
071970,STX중공업,2490,2460,-30,-1.2,133246,325210780
084870,TBH글로벌,3080,3100,20,0.65,87731,270615350
002710,TCC스틸,2840,2825,-15,-0.53,18659,52427390
024070,WISCOM,2690,2680,-10,-0.37,4913,13134495
037270,YGPLUS,1140,1150,10,0.88,97554,110076815
000500,가온전선,16800,16650,-150,-0.89,9588,160067100
000860,강남제비스코,22650,22550,-100,-0.44,2463,55241800
035250,강원랜드,29500,29550,50,0.17,274424,8114576400
011420,갤럭시아에스엠,2005,1935,-70,-3.49,337114,644385880
002100,경농,15750,15450,-300,-1.9,108327,1676658850
009450,경동나비엔,39650,39850,200,0.5,29003,1146292350
267290,경동도시가스,27100,27200,100,0.37,1577,42682150
012320,경동인베스트,34450,34000,-450,-1.31,2427,82016900
000050,경방,9780,9800,20,0.2,3175,31067470
214390,경보제약,8280,8330,50,0.6,12859,105885230
012610,경인양행,8620,8400,-220,-2.55,706239,5976763220
009140,경인전자,20550,20450,-100,-0.49,1518,31153950
013580,계룡건설,22500,22250,-250,-1.11,1693,37731250
012200,계양전기,2880,2835,-45,-1.56,77769,221156760
012205,계양전기우,7800,7610,-190,-2.44,8291,63444950
004200,고려개발,9690,9590,-100,-1.03,2914,27858880
002140,고려산업,4570,4600,30,0.66,1353182,5983783375
010130,고려아연,443000,448000,5000,1.13,22541,10051518000
002240,고려제강,23700,23800,100,0.42,3746,88612600
009290,광동제약,6870,6750,-120,-1.75,117895,797641630
017040,광명전기,2420,2425,5,0.21,267406,647589245
017900,광전자,2205,2190,-15,-0.68,96907,212296395
037710,광주신세계,171500,171500,0,0.0,307,52903500
030610,교보증권,9760,9770,10,0.1,21934,214006880
007690,국도화학,44400,44750,350,0.79,3604,161136450
005320,국동,1655,1540,-115,-6.95,1596697,2532101665
002720,국제약품,4305,4220,-85,-1.97,130003,551928970
083420,그린케미칼,3445,3415,-30,-0.87,1927,6578275
014530,극동유화,3405,3380,-25,-0.73,116699,395188835
014280,금강공업,4110,4110,0,0.0,63643,260116535
014285,금강공업우,9240,9200,-40,-0.43,2199,20109880
008870,금비,65000,64200,-800,-1.23,152,9750600
001570,금양,2190,2185,-5,-0.23,39726,85978720
002990,금호산업,12500,12400,-100,-0.8,32148,398342500
002995,금호산업우,48600,48900,300,0.62,6571,321018600
011780,금호석유,69600,71600,2000,2.87,82641,5884876100
011785,금호석유우,29250,29100,-150,-0.51,16139,470325500
214330,금호에이치티,3960,3815,-145,-3.66,71342,274036065
001210,금호전기,2190,2155,-35,-1.6,32809,70597065
073240,금호타이어,4370,4300,-70,-1.6,204937,880962030
092440,기신정기,3590,3585,-5,-0.14,14933,53244165
000270,기아차,45350,45600,250,0.55,778085,35523153400
024110,기업은행,12850,13200,350,2.72,856713,11231180200
013700,까뮤이앤씨,1260,1240,-20,-1.59,60218,74255475
004540,깨끗한나라,2360,2350,-10,-0.42,212720,486818420
004545,깨끗한나라우,18800,18200,-600,-3.19,7836,143143550
074610,나노메딕스,6850,6400,-450,-6.57,1286191,8200585100
001260,남광토건,13800,13500,-300,-2.17,28059,379242750
008350,남선알미늄,3365,3230,-135,-4.01,2676966,8762279195
008355,남선알미우,32300,31900,-400,-1.24,9366,299380650
004270,남성,3415,3210,-205,-6.0,1153207,3773750015
003920,남양유업,492000,491500,-500,-0.1,313,153109000
003925,남양유업우,177500,177500,0,0.0,1,177500
002070,남영비비안,17900,17450,-450,-2.51,67915,1197131750
025860,남해화학,9160,9060,-100,-1.09,58451,528872560
005720,넥센,5850,5870,20,0.34,10120,59053770
005725,넥센우,3615,3600,-15,-0.41,2785,10063935
002350,넥센타이어,8960,9040,80,0.89,78030,700912890
002355,넥센타이어1우B,3620,3535,-85,-2.35,13665,48698630
003580,넥스트사이언스,4010,4330,320,7.98,767945,3326271565
251270,넷마블,94100,94500,400,0.43,115862,10931971600
090350,노루페인트,7570,7500,-70,-0.92,28026,209358710
090355,노루페인트우,11850,11850,0,0.0,4334,52253700
000320,노루홀딩스,11550,11750,200,1.73,3280,38370850
000325,노루홀딩스우,17750,17950,200,1.13,583,10331200
006280,녹십자,114000,113500,-500,-0.44,12016,1358519500
005250,녹십자홀딩스,20400,20850,450,2.21,31798,657309300
005257,녹십자홀딩스2우,16050,16050,0,0.0,531,8521450
004370,농심,250000,249500,-500,-0.2,5819,1452872000
072710,농심홀딩스,88500,88600,100,0.11,802,70540400
058730,다스코,6020,5910,-110,-1.83,22149,131303930
023590,다우기술,19500,19900,400,2.05,41241,811529250
019680,대교,6040,6060,20,0.33,14526,87961760
019685,대교우B,4215,4215,0,0.0,1979,8340935
006370,대구백화점,5850,5940,90,1.54,21972,129761850
008060,대덕전자,10900,10850,-50,-0.46,690526,7515733300
00806K,대덕전자1우,6390,6420,30,0.47,4016,25667050
000490,대동공업,7110,7010,-100,-1.41,223047,1561818730
008110,대동전자,3840,3810,-30,-0.78,9724,36679100
005750,대림BCo,3990,3985,-5,-0.13,16154,64021900
000210,대림산업,102500,104000,1500,1.46,143264,14589859000
000215,대림산업우,43800,43550,-250,-0.57,19504,834007300
004440,대림씨엔에스,7400,7390,-10,-0.14,1002,7354140
006570,대림통상,4200,4185,-15,-0.36,2740,11347145
001680,대상,22150,22250,100,0.45,42060,935034600
001685,대상우,13100,13250,150,1.15,8983,118693200
084690,대상홀딩스,6800,7080,280,4.12,84103,586703920
084695,대상홀딩스우,6620,7000,380,5.74,188687,1298418730
128820,대성산업,4045,3995,-50,-1.24,34808,139159060
117580,대성에너지,5380,5370,-10,-0.19,4474,23947700
016710,대성홀딩스,7800,7790,-10,-0.13,7313,55976940
003540,대신증권,12950,13150,200,1.54,89425,1165323300
003547,대신증권2우B,8610,8670,60,0.7,13234,114491360
003545,대신증권우,9350,9370,20,0.21,49671,464800570
009190,대양금속,17600,16400,-1200,-6.82,175818,2979842400
014160,대영포장,1135,1115,-20,-1.76,604341,675737815
047040,대우건설,4730,4830,100,2.11,529840,2533515385
009320,대우부품,2550,2580,30,1.18,12349724,31847484155
042660,대우조선해양,29950,30600,650,2.17,107436,3236643300
003090,대웅,14600,14750,150,1.03,60899,899236400
069620,대웅제약,150000,149000,-1000,-0.67,26786,4006406500
000430,대원강업,3930,3945,15,0.38,18500,72594810
006340,대원전선,1355,1330,-25,-1.85,235710,310545780
006345,대원전선우,3305,3310,5,0.15,7500,24272510
003220,대원제약,15200,15250,50,0.33,13313,201656450
024890,대원화성,1435,1405,-30,-2.09,54409,76249690
002880,대유에이텍,961,942,-19,-1.98,120477,113953200
000300,대유플러스,849,825,-24,-2.83,105014,87596818
012800,대창,1220,1185,-35,-2.87,846283,1006247075
015230,대창단조,28700,28800,100,0.35,685,19610800
001070,대한방직,19300,19350,50,0.26,3767,71671600
006650,대한유화,124500,127500,3000,2.41,20397,2569178000
001440,대한전선,635,605,-30,-4.72,5146314,3140627399
084010,대한제강,6500,6430,-70,-1.08,35850,231018190
001790,대한제당,21450,20950,-500,-2.33,79531,1665588300
001799,대한제당3우B,55000,43250,-11750,-21.36,50648,2269611950
001795,대한제당우,14500,13900,-600,-4.14,27432,383454100
001130,대한제분,165000,164500,-500,-0.3,522,86140500
003490,대한항공,23050,22900,-150,-0.65,260724,5973902400
003495,대한항공우,17000,15250,-1750,-10.29,467774,8040368000
005880,대한해운,21950,22100,150,0.68,42810,944030700
003830,대한화섬,95500,95500,0,0.0,77,7300500
016090,대현,2450,2390,-60,-2.45,43133,103452300
069460,대호에이엘,5060,4660,-400,-7.91,1050871,4955801620
192080,더블유게임즈,54400,55200,800,1.47,32299,1763824300
012510,더존비즈온,64500,65400,900,1.4,67147,4356489392
004830,덕성,3225,3095,-130,-4.03,142800,444410795
004835,덕성우,3900,3875,-25,-0.64,30603,119196515
024900,덕양산업,1180,1160,-20,-1.69,84245,97500065
145720,덴티움,65500,65800,300,0.46,15289,1003268300
002150,도화엔지니어링,11300,11250,-50,-0.44,72443,812848150
001230,동국제강,6450,6500,50,0.78,115094,746049310
023450,동남합성,24100,24200,100,0.41,31,750850
004140,동방,1795,1760,-35,-1.95,232976,406446060
007590,동방아그로,6850,6890,40,0.58,8171,55498920
005960,동부건설,8890,8920,30,0.34,33555,298676820
005965,동부건설우,18800,19100,300,1.6,1714,32362100
016380,동부제철,11300,10450,-850,-7.52,55296,577629700
016385,동부제철우,86900,84500,-2400,-2.76,1547,129518400
083370,동북아12호,4990,5020,30,0.6,8,40160
083380,동북아13호,4990,5000,10,0.2,0,0
026960,동서,17850,18000,150,0.84,36484,654136650
002210,동성제약,16750,16550,-200,-1.19,690613,11537166550
102260,동성코퍼레이션,5400,5540,140,2.59,18053,98690530
005190,동성화학,16650,16650,0,0.0,4252,70456900
000640,동아쏘시오홀딩스,86800,87400,600,0.69,3053,265566200
170900,동아에스티,84300,84100,-200,-0.24,14537,1225633400
028100,동아지질,23750,23550,-200,-0.84,127648,2964049450
282690,동아타이어,12350,12300,-50,-0.4,1813,22370700
001520,동양,1525,1520,-5,-0.33,117665,179441520
001527,동양2우B,9270,9170,-100,-1.08,3958,36394400
001529,동양3우B,28050,27750,-300,-1.07,791,21937500
084670,동양고속,27700,27100,-600,-2.17,614,16658400
030790,동양네트웍스,1330,935,-395,-29.7,20672648,19917487454
002900,동양물산,1035,1035,0,0.0,298328,308977830
082640,동양생명,3825,3820,-5,-0.13,87322,333346390
001525,동양우,7230,7160,-70,-0.97,2055,14718140
008970,동양철관,1300,1275,-25,-1.92,522936,666356505
092780,동양피스톤,4800,4800,0,0.0,30557,144194295
049770,동원FB,227000,230500,3500,1.54,6660,1530571000
018500,동원금속,883,884,1,0.11,90487,78143688
006040,동원산업,213500,214500,1000,0.47,1179,253178500
030720,동원수산,10850,9860,-990,-9.12,642506,6486313550
014820,동원시스템즈,38400,39400,1000,2.6,19428,757575850
014825,동원시스템즈우,29000,29200,200,0.69,689,19325150
163560,동일고무벨트,5550,5520,-30,-0.54,3381,18636440
004890,동일산업,56500,56400,-100,-0.18,978,54887500
002690,동일제강,2775,2740,-35,-1.26,20944,57579145
000020,동화약품,7980,7910,-70,-0.88,26914,214589450
000150,두산,106000,106000,0,0.0,0,0
000157,두산2우B,89100,89100,0,0.0,0,0
011160,두산건설,1305,1290,-15,-1.15,113181,145993030
241560,두산밥캣,33900,35400,1500,4.42,150175,5240448100
000155,두산우,81000,81000,0,0.0,0,0
042670,두산인프라코어,6160,6300,140,2.27,756682,4740283610
034020,두산중공업,6760,6800,40,0.59,1144451,7695249770
016740,두올,3275,3450,175,5.34,295380,997569910
192650,드림텍,6620,6690,70,1.06,268325,1769666660
024090,디씨엠,12400,12350,-50,-0.4,331,4068000
003160,디아이,3265,3225,-40,-1.23,33007,106219705
092200,디아이씨,2580,2460,-120,-4.65,290313,722112595
013570,디와이,4915,4870,-45,-0.92,46109,224206245
210540,디와이파워,10000,9880,-120,-1.2,83019,817882720
007340,디티알오토모티브,30500,30500,0,0.0,603,18401600
026890,디피씨,5190,5150,-40,-0.77,829960,4192188795
115390,락앤락,12550,12450,-100,-0.8,50983,635473050
032350,롯데관광개발,11350,11200,-150,-1.32,223703,2491611250
000400,롯데손해보험,2125,2120,-5,-0.24,250080,521653335
023530,롯데쇼핑,129500,129000,-500,-0.39,58173,7514686500
004000,롯데정밀화학,44200,45600,1400,3.17,45762,2058871250
286940,롯데정보통신,44400,45400,1000,2.25,53796,2446114500
280360,롯데제과,146500,147000,500,0.34,892,131007000
004990,롯데지주,36450,36250,-200,-0.55,87679,3175482850
00499K,롯데지주우,50000,50000,0,0.0,918,45273000
005300,롯데칠성,135500,138500,3000,2.21,7067,970473000
005305,롯데칠성우,73700,73700,0,0.0,217,15991100
011170,롯데케미칼,235500,236000,500,0.21,73647,17316195500
002270,롯데푸드,438000,440000,2000,0.46,766,335456500
071840,롯데하이마트,30850,30000,-850,-2.76,148589,4474472550
027740,마니커,1390,1385,-5,-0.36,15362126,20597362585
204320,만도,35300,36200,900,2.55,323887,11685312750
001080,만호제강,17300,17250,-50,-0.29,1004,17169000
088980,맥쿼리인프라,11750,11750,0,0.0,273390,3205294332
094800,맵스리얼티1,4985,4995,10,0.2,189320,948044945
015540,메디파트너생명공학,6650,6680,30,0.45,34649,229603440
138040,메리츠금융지주,12450,12850,400,3.21,80222,1026204150
008560,메리츠종금증권,4930,5050,120,2.43,777184,3890955395
000060,메리츠화재,19100,19100,0,0.0,58793,1123605250
090370,메타랩스,1460,1400,-60,-4.11,353747,502352830
017180,명문제약,4200,4165,-35,-0.83,140859,580802665
012690,모나리자,3860,3865,5,0.13,522069,2006795615
005360,모나미,4590,4520,-70,-1.53,947700,4223522650
204210,모두투어리츠,2910,2910,0,0.0,7978,23124720
009680,모토닉,8850,8790,-60,-0.68,14738,129550760
009580,무림PP,4530,4485,-45,-0.99,129717,581714005
009200,무림페이퍼,2670,2660,-10,-0.37,36308,96340230
033920,무학,9250,9300,50,0.54,30700,283018070
008420,문배철강,2810,2755,-55,-1.96,133378,368441940
025560,미래산업,173,171,-2,-1.16,10972949,1847850678
007120,미래아이앤지,296,287,-9,-3.04,314308,90422464
006800,미래에셋대우,7460,7500,40,0.54,608649,4553517950
00680K,미래에셋대우2우B,4220,4230,10,0.24,112634,476968070
006805,미래에셋대우우,4630,4645,15,0.32,23638,109545950
085620,미래에셋생명,4200,4325,125,2.98,49121,210571410
002840,미원상사,55900,56300,400,0.72,1219,68837100
268280,미원에스씨,70400,69900,-500,-0.71,336,23577300
107590,미원홀딩스,41050,41000,-50,-0.12,309,12648500
134380,미원화학,41100,41200,100,0.24,329,13533750
003650,미창석유,78700,77300,-1400,-1.78,1651,128464900
155900,바다로19호,2930,2935,5,0.17,2765,8110970
003610,방림,2025,1995,-30,-1.48,7351,14651120
001340,백광산업,2685,2600,-85,-3.17,604498,1582580310
014580,백광소재,6070,5360,-710,-11.7,3630882,19785180670
035150,백산,6210,6150,-60,-0.97,94911,584754900
002410,범양건영,1720,1655,-65,-3.78,177800,298670600
096300,베트남개발1,438,438,0,0.0,65862,28779130
007210,벽산,2105,2060,-45,-2.14,658814,1325566760
002760,보락,2055,2070,15,0.73,2235382,4715592605
003850,보령제약,12250,12050,-200,-1.63,158663,1913003100
000890,보해양조,1240,1215,-25,-2.02,5289475,6544625000
003000,부광약품,13600,13850,250,1.84,139771,1915401700
001270,부국증권,20350,20100,-250,-1.23,1154,23299200
001275,부국증권우,18850,18900,50,0.27,461,8694750
026940,부국철강,3965,3875,-90,-2.27,111358,432888465
015350,부산가스,35500,35500,0,0.0,154,5438150
011390,부산산업,170500,172500,2000,1.17,152352,26587194500
005030,부산주공,516,510,-6,-1.16,67123,33950435
100220,비상교육,7830,7840,10,0.13,16414,127862580
101140,비티원,2900,2895,-5,-0.17,265734,757640450
005180,빙그레,58900,58300,-600,-1.02,13135,765951900
003960,사조대림,18600,17950,-650,-3.49,12150,220143250
008040,사조동아원,1170,1115,-55,-4.7,1493411,1682767015
007160,사조산업,43150,42550,-600,-1.39,8339,352915550
014710,사조씨푸드,5800,5640,-160,-2.76,119411,673557430
006090,사조오양,11000,9860,-1140,-10.36,1012111,10179270150
005090,삼광글라스,31750,32000,250,0.79,2587,82052750
001470,삼부토건,763,704,-59,-7.73,1815068,1304910723
006400,삼성SDI,222500,223000,500,0.22,253050,55957025000
006405,삼성SDI우,87200,87300,100,0.11,2074,179837900
006660,삼성공조,8800,8800,0,0.0,444,3884370
028260,삼성물산,88900,89700,800,0.9,187463,16737178300
02826K,삼성물산우B,67900,69100,1200,1.77,2001,138581600
207940,삼성바이오로직스,311500,307500,-4000,-1.28,86603,26513910500
032830,삼성생명,70600,71100,500,0.71,192481,13596327500
018260,삼성에스디에스,189500,190500,1000,0.53,63012,12033400000
028050,삼성엔지니어링,16650,16800,150,0.9,418898,6980825150
009150,삼성전기,100500,103000,2500,2.49,1015595,103585943900
009155,삼성전기우,41150,41900,750,1.82,20360,845581850
005930,삼성전자,48400,49050,650,1.34,9497119,462639969057
005935,삼성전자우,39300,39500,200,0.51,2243443,88375720012
001360,삼성제약,2720,2650,-70,-2.57,884659,2366084085
010140,삼성중공업,7790,7880,90,1.16,1758579,13784249080
010145,삼성중공우,60200,60000,-200,-0.33,1495,88951700
016360,삼성증권,35150,35350,200,0.57,107369,3781381900
068290,삼성출판사,12850,12750,-100,-0.78,51082,646406100
029780,삼성카드,33550,35150,1600,4.77,92591,3200021650
000810,삼성화재,227500,223000,-4500,-1.98,122461,27417789000
000815,삼성화재우,162500,162500,0,0.0,11451,1848700000
006110,삼아알미늄,4535,4625,90,1.98,14248,63642990
145990,삼양사,49550,49350,-200,-0.4,5410,267383250
145995,삼양사우,33900,34200,300,0.88,92,3126800
003230,삼양식품,78100,78100,0,0.0,17860,1390695200
002170,삼양통상,60800,61100,300,0.49,4567,275292800
272550,삼양패키징,16350,16350,0,0.0,8499,138061750
000070,삼양홀딩스,60500,60000,-500,-0.83,6057,363740500
000075,삼양홀딩스우,43500,44150,650,1.49,12,526100
002810,삼영무역,16350,16350,0,0.0,11800,191997200
005680,삼영전자,9200,9280,80,0.87,41544,382872290
003720,삼영화학,1100,1085,-15,-1.36,68888,74280200
023000,삼원강재,2850,2885,35,1.23,11368,32360100
004380,삼익THK,12300,12150,-150,-1.22,24580,295402650
002450,삼익악기,1845,1830,-15,-0.81,245779,449130795
000520,삼일제약,22350,22800,450,2.01,403020,9610765800
009770,삼정펄프,33950,34250,300,0.88,171,5872800
005500,삼진제약,24850,25200,350,1.41,25820,645297300
004690,삼천리,84300,84400,100,0.12,3179,266646200
001880,삼호,20000,20400,400,2.0,75138,1503381650
010960,삼호개발,4585,4505,-80,-1.74,48011,217247865
004450,삼화왕관,45650,45400,-250,-0.55,186,8504400
009470,삼화전기,15450,15700,250,1.62,43901,682468350
011230,삼화전자,2810,2810,0,0.0,33874,94431795
001820,삼화콘덴서,47150,49250,2100,4.45,398423,19481106900
000390,삼화페인트,5590,5480,-110,-1.97,15295,84287620
001290,상상인증권,1855,1845,-10,-0.54,80936,149178770
041650,상신브레이크,3820,3945,125,3.27,53469,207718875
075180,새론오토모티브,4745,4740,-5,-0.11,1245,5826925
007540,샘표,43900,42050,-1850,-4.21,60542,2550430700
248170,샘표식품,33200,31600,-1600,-4.82,44331,1420539250
007860,서연,3790,3730,-60,-1.58,22227,83286705
200880,서연이화,6500,6550,50,0.77,76583,494338770
017390,서울가스,68000,67200,-800,-1.18,112,7563900
004410,서울식품,191,188,-3,-1.57,2666863,499328467
004415,서울식품우,3830,3775,-55,-1.44,23435,87857715
021050,서원,1145,1135,-10,-0.87,109463,123074270
008490,서흥,32050,32100,50,0.16,14845,474232650
007610,선도전기,3765,3770,5,0.13,83169,309523990
136490,선진,10950,10850,-100,-0.91,325986,3506739300
002820,선창산업,4850,4890,40,0.82,2193,10617000
014910,성문전자,2435,2320,-115,-4.72,374268,873089400
014915,성문전자우,12100,12000,-100,-0.83,22960,279402650
003080,성보화학,4895,4855,-40,-0.82,4333,21096595
004980,성신양회,9190,9080,-110,-1.2,122075,1106455090
004985,성신양회우,12650,12500,-150,-1.19,10185,126728000
011300,성안,457,457,0,0.0,21697,9881900
000180,성창기업지주,1820,1800,-20,-1.1,29342,52759350
002420,세기상사,58000,57500,-500,-0.86,990,56483700
004360,세방,12000,11950,-50,-0.42,7263,86377950
004365,세방우,6640,6710,70,1.05,86,574140
004490,세방전지,39750,39200,-550,-1.38,7751,304386050
001430,세아베스틸,16000,16400,400,2.5,16990,275893800
306200,세아제강,62200,61500,-700,-1.13,2159,133045700
003030,세아제강지주,51300,51100,-200,-0.39,902,45645900
019440,세아특수강,13550,13500,-50,-0.37,7201,96894750
058650,세아홀딩스,81700,82100,400,0.49,29,2378300
013000,세우글로벌,1920,1900,-20,-1.04,389015,739808885
091090,세원셀론텍,2970,2930,-40,-1.35,106463,310086475
021820,세원정공,8090,8090,0,0.0,0,0
067830,세이브존IC,3400,3370,-30,-0.88,14060,47308750
033530,세종공업,4715,4530,-185,-3.92,81823,373215320
075580,세진중공업,5380,5480,100,1.86,145473,781792720
027970,세하,2550,2560,10,0.39,419691,1054823960
145210,세화아이엠씨,2990,2990,0,0.0,0,0
068270,셀트리온,166000,164000,-2000,-1.2,514888,84302668000
004430,송원산업,18550,18550,0,0.0,63661,1170829050
017550,수산중공업,1540,1545,5,0.32,314891,482032090
002200,수출포장,18800,18600,-200,-1.06,3302,61496900
053210,스카이라이프,9050,9050,0,0.0,20483,185179780
134790,시디즈,39000,39100,100,0.26,104,4050550
016590,신대양제지,65500,64800,-700,-1.07,11864,771578800
029530,신도리코,39600,39700,100,0.25,5907,235369750
004970,신라교역,13400,13300,-100,-0.75,25340,332755300
011930,신성이엔지,940,927,-13,-1.38,443579,411955114
005390,신성통상,1645,1590,-55,-3.34,2849723,4516870375
004170,신세계,262000,262500,500,0.19,29701,7711619000
035510,신세계IC,119000,118500,-500,-0.42,9066,1082919500
034300,신세계건설,25250,25150,-100,-0.4,2671,67430050
031430,신세계인터내셔날,201500,198000,-3500,-1.74,57732,11518140000
031440,신세계푸드,77500,76900,-600,-0.77,2169,165492000
006880,신송홀딩스,4535,4635,100,2.21,252179,1160760960
005800,신영와코루,107000,109000,2000,1.87,157,16884500
001720,신영증권,55500,55600,100,0.18,1574,87730500
001725,신영증권우,53100,52800,-300,-0.56,205,10831700
009270,신원,2515,2430,-85,-3.38,1594691,3887274620
009275,신원우,55300,55200,-100,-0.18,1064,57865900
002700,신일산업,1515,1565,50,3.3,1451389,2229957000
019170,신풍제약,6180,6230,50,0.81,300972,1870331720
019175,신풍제약우,5760,5640,-120,-2.08,29925,166019830
002870,신풍제지,1315,1320,5,0.38,33519,43941265
005450,신한,4945,4945,0,0.0,0,0
293940,신한알파리츠,7990,8000,10,0.13,116932,933887230
055550,신한지주,41850,41800,-50,-0.12,948341,39675011550
001770,신화실업,23200,23400,200,0.86,8857,203599850
004080,신흥,9490,9470,-20,-0.21,249,2360380
102280,쌍방울,1010,1000,-10,-0.99,1586482,1584853269
003410,쌍용양회,6040,6110,70,1.16,353223,2154083790
003415,쌍용양회우,9200,9460,260,2.83,71731,674728850
003620,쌍용차,2910,2870,-40,-1.37,188415,540123490
004770,써니전자,3900,4200,300,7.69,23690649,98796278400
004920,씨아이테크,455,457,2,0.44,200434,90634935
112610,씨에스윈드,31550,31800,250,0.79,26404,836604200
008700,아남전자,2355,2340,-15,-0.64,409098,946971820
002790,아모레G,66800,65400,-1400,-2.1,85650,5605659100
002795,아모레G우,25450,25250,-200,-0.79,1508,37846050
090430,아모레퍼시픽,145000,140500,-4500,-3.1,295326,42100262000
090435,아모레퍼시픽우,74200,73300,-900,-1.21,14189,1044158400
002030,아세아,116500,115000,-1500,-1.29,358,41329000
183190,아세아시멘트,92600,92800,200,0.22,2905,270518900
002310,아세아제지,30450,29700,-750,-2.46,29975,892792100
267850,아시아나IDT,17000,16800,-200,-1.18,33365,564055300
020560,아시아나항공,5180,5140,-40,-0.77,575711,2959426040
122900,아이마켓코리아,10550,10400,-150,-1.42,87832,920440450
010780,아이에스동서,30050,30050,0,0.0,39379,1182462700
033660,아주캐피탈,10950,11100,150,1.37,29613,328031350
001780,알루코,2400,2370,-30,-1.25,74111,174245895
018250,애경산업,30200,30000,-200,-0.66,53278,1601357100
161000,애경유화,7750,7750,0,0.0,60736,467021270
011090,에넥스,1070,1065,-5,-0.47,86431,91167200
005850,에스엘,23150,24000,850,3.67,88326,2101015500
012750,에스원,95900,98100,2200,2.29,57168,5570439300
023960,에쓰씨엔지니어링,1550,1525,-25,-1.61,62111,94188405
298690,에어부산,6300,6240,-60,-0.95,285418,1766288370
140910,에이리츠,6430,6430,0,0.0,1871,11999920
078520,에이블씨엔씨,11200,11150,-50,-0.45,75309,850538350
015260,에이엔피,364,357,-7,-1.92,169078,60499750
007460,에이프로젠KIC,1915,1820,-95,-4.96,1940854,3580242100
003060,에이프로젠제약,753,709,-44,-5.84,1661174,1188489479
036570,엔씨소프트,523000,521000,-2000,-0.38,54094,28158549000
138250,엔에스쇼핑,9860,9770,-90,-0.91,27029,262909840
085310,엔케이,1220,1200,-20,-1.64,314708,374517115
009810,엔케이물산,788,750,-38,-4.82,2396059,1782086643
900140,엘브이엠씨홀딩스,3300,3320,20,0.61,119000,391757665
014440,영보화학,3390,3365,-25,-0.74,5896,19806960
111770,영원무역,35100,35700,600,1.71,76057,2720429700
009970,영원무역홀딩스,48000,47400,-600,-1.25,5673,271937450
003520,영진약품,4835,4680,-155,-3.21,821638,3875353395
000670,영풍,597000,608000,11000,1.84,721,433715000
006740,영풍제지,2985,3015,30,1.01,25763,77304640
012280,영화금속,1460,1415,-45,-3.08,170142,241017375
012160,영흥철강,1155,1115,-40,-3.46,399681,447259620
015360,예스코홀딩스,37400,37800,400,1.07,878,33720050
007310,오뚜기,579000,583000,4000,0.69,1197,695300000
079440,오렌지라이프,26900,27050,150,0.56,76768,2059305350
002630,오리엔트바이오,442,425,-17,-3.85,1198236,514891267
271560,오리온,97500,98400,900,0.92,62234,6092042000
001800,오리온홀딩스,15800,15900,100,0.63,32831,518033100
070960,용평리조트,7610,7500,-110,-1.45,249519,1864577750
316140,우리금융지주,12100,12450,350,2.89,1380560,17070227800
004720,우리들제약,6090,6000,-90,-1.48,39688,240772850
118000,우리들휴브레인,2600,2530,-70,-2.69,167777,425184910
010050,우리종금,693,688,-5,-0.72,524262,361932862
006980,우성사료,3860,3530,-330,-8.55,3078989,11260966775
017370,우신시스템,4695,4685,-10,-0.21,11919,54943525
105840,우진,5280,5230,-50,-0.95,660332,3500388650
010400,우진아이엔에스,8730,8550,-180,-2.06,18556,159672510
049800,우진플라임,3955,3870,-85,-2.15,5815,22448725
016880,웅진,1295,1270,-25,-1.93,115888,147925730
095720,웅진씽크빅,2410,2400,-10,-0.41,387425,939349020
103130,웅진에너지,914,914,0,0.0,0,0
021240,웅진코웨이,83700,84600,900,1.08,125355,10584311840
005820,원림,17800,17800,0,0.0,189,3408500
010600,웰바이오텍,2625,2500,-125,-4.76,280488,711258755
008600,윌비스,1125,1110,-15,-1.33,228952,251822210
033270,유나이티드제약,19300,19350,50,0.26,12368,239352200
014830,유니드,45850,45850,0,0.0,4620,210876700
000910,유니온,4805,4645,-160,-3.33,269719,1264524290
047400,유니온머티리얼,2575,2500,-75,-2.91,472103,1197279775
011330,유니켐,1855,1830,-25,-1.35,352625,640951910
077500,유니퀘스트,6950,6740,-210,-3.02,167857,1140732290
002920,유성기업,2780,2775,-5,-0.18,5284,14570070
000700,유수홀딩스,7360,7320,-40,-0.54,15621,114764680
003470,유안타증권,2690,2680,-10,-0.37,50263,134277750
003475,유안타증권우,1990,1980,-10,-0.5,1116,2216655
011690,유양디앤유,6070,5970,-100,-1.65,199142,1187479070
072130,유엔젤,3555,3495,-60,-1.69,33214,116657580
000220,유유제약,10650,10650,0,0.0,30379,322536150
000225,유유제약1우,6730,6750,20,0.3,3045,20268870
000227,유유제약2우B,18800,18800,0,0.0,298,5572950
001200,유진투자증권,2135,2145,10,0.47,152013,322989490
000100,유한양행,225000,228500,3500,1.56,27117,6178944500
000105,유한양행우,205000,206500,1500,0.73,40,8207500
003460,유화증권,12200,12300,100,0.82,3259,39649350
003465,유화증권우,13100,13100,0,0.0,499,6517650
008730,율촌화학,14450,14200,-250,-1.73,91433,1292291200
008250,이건산업,8620,8520,-100,-1.16,47884,406575330
025820,이구산업,1690,1660,-30,-1.78,145031,240973845
214320,이노션,66200,66600,400,0.6,23640,1567675800
088260,이리츠코크렙,6620,6640,20,0.3,103625,688214590
139480,이마트,115500,113000,-2500,-2.16,144001,16399247000
007660,이수페타시스,4340,4295,-45,-1.04,688117,2933495145
005950,이수화학,10600,11150,550,5.19,289540,3178307500
015020,이스타코,617,612,-5,-0.81,55023,33522607
093230,이아이디,277,266,-11,-3.97,6935248,1836108159
102460,이연제약,13000,12850,-150,-1.15,26336,338277750
084680,이월드,3110,3090,-20,-0.64,449638,1392668080
000760,이화산업,15150,15150,0,0.0,343,5162200
014990,인디에프,3445,3345,-100,-2.9,1166284,3907906570
006490,인스코비,3035,2895,-140,-4.61,1204681,3495986860
023800,인지컨트롤스,5240,5170,-70,-1.34,89077,453307920
034590,인천도시가스,29100,29150,50,0.17,840,24363900
129260,인터지스,2105,2130,25,1.19,11600,24343220
023810,인팩,3955,3860,-95,-2.4,5514,21307905
249420,일동제약,15300,15300,0,0.0,39547,602085900
000230,일동홀딩스,10800,10850,50,0.46,3898,42099600
013360,일성건설,1525,1445,-80,-5.25,383268,563856725
003120,일성신약,83300,83900,600,0.72,86,7153500
003200,일신방직,79000,78900,-100,-0.13,671,52655600
007110,일신석재,3745,3610,-135,-3.6,2734679,9947120065
007570,일양약품,20450,20150,-300,-1.47,32434,655011050
007575,일양약품우,16600,16600,0,0.0,3864,64505950
008500,일정실업,19200,19200,0,0.0,1997,38163650
081000,일진다이아,31550,31650,100,0.32,167926,5252664800
020760,일진디스플,3780,3770,-10,-0.26,56434,210286545
020150,일진머티리얼즈,37650,37400,-250,-0.66,360277,13279168650
103590,일진전기,3180,3155,-25,-0.79,37642,117959435
015860,일진홀딩스,5110,4935,-175,-3.42,237729,1176285140
226320,잇츠한불,18950,18600,-350,-1.85,21336,393971000
033240,자화전자,10500,10250,-250,-2.38,135810,1408189400
000950,전방,16550,16500,-50,-0.3,103,1693500
194370,제이에스코퍼레이션,14550,14250,-300,-2.06,25085,358766000
025620,제이준코스메틱,4165,3995,-170,-4.08,251508,1012828965
030000,제일기획,24400,24800,400,1.64,155123,3847624000
271980,제일약품,31300,30550,-750,-2.4,13966,429885050
001560,제일연마,6210,6290,80,1.29,11598,72923370
002620,제일파마홀딩스,15900,15400,-500,-3.14,7708,119064200
006220,제주은행,4225,4205,-20,-0.47,14030,59060355
089590,제주항공,24350,24450,100,0.41,77028,1878153100
004910,조광페인트,6220,6190,-30,-0.48,11889,73297940
004700,조광피혁,36900,37050,150,0.41,703,25954400
001550,조비,20450,20050,-400,-1.96,25048,500273750
000480,조선내화,85000,85900,900,1.06,1587,134867000
120030,조선선재,84200,83900,-300,-0.36,652,54419400
018470,조일알미늄,759,760,1,0.13,34320,25568722
002600,조흥,152000,151500,-500,-0.33,12,1820000
185750,종근당,82300,83400,1100,1.34,12311,1017856800
063160,종근당바이오,30000,28950,-1050,-3.5,58280,1699867400
001630,종근당홀딩스,92900,90600,-2300,-2.48,37832,3417153500
044380,주연테크,387,388,1,0.26,351872,134852084
013870,지엠비코리아,5180,5160,-20,-0.39,63244,323155390
071320,지역난방공사,49850,49900,50,0.1,4945,247267850
010580,지코,868,863,-5,-0.58,271845,232996323
035000,지투알,7050,6870,-180,-2.55,22801,156287300
088790,진도,3795,3800,5,0.13,8287,30923160
003780,진양산업,3310,3320,10,0.3,48386,159824390
010640,진양폴리,2465,2525,60,2.43,28496,70781845
100250,진양홀딩스,2490,2490,0,0.0,11636,28934425
051630,진양화학,4625,4490,-135,-2.92,149828,674902620
272450,진에어,15200,15100,-100,-0.66,45873,689353600
011000,진원생명과학,4320,4170,-150,-3.47,102300,432542610
002780,진흥기업,1975,1970,-5,-0.25,34087,67549705
002787,진흥기업2우B,13550,13750,200,1.48,11646,157361400
002785,진흥기업우B,5360,5110,-250,-4.66,19894,102230500
009310,참엔지니어링,1125,1110,-15,-1.33,22656,25177050
000650,천일고속,71200,71500,300,0.42,188,13427100
012600,청호컴넷,2955,2960,5,0.17,16106,47439845
033250,체시스,4625,4285,-340,-7.35,3798111,16447768470
001140,카리스국보,5400,5380,-20,-0.37,618925,3365827960
035720,카카오,135500,135500,0,0.0,202006,27275180500
006380,카프로,3710,3690,-20,-0.54,55174,202719000
109070,컨버즈,3260,3260,0,0.0,0,0
001620,케이비아이동국실업,790,785,-5,-0.63,68630,53825052
029460,케이씨,13600,13250,-350,-2.57,31454,417468750
281820,케이씨텍,17850,17700,-150,-0.84,157538,2749541000
145270,케이탑리츠,914,914,0,0.0,97718,88793027
007815,코리아써우,2700,2855,155,5.74,8255,22966945
007810,코리아써키트,5860,6380,520,8.87,913170,5728938880
00781K,코리아써키트2우B,4180,4460,280,6.7,6336,27546785
152330,코리아오토글라스,16850,16900,50,0.3,46612,789626300
003690,코리안리,7950,8010,60,0.75,62972,502567470
192820,코스맥스,74800,73200,-1600,-2.14,99762,7314240600
044820,코스맥스비티아이,14350,13900,-450,-3.14,4145,57999300
005070,코스모신소재,8640,8210,-430,-4.98,168532,1398251070
005420,코스모화학,6620,6230,-390,-5.89,201558,1265529040
071950,코아스,1510,1575,65,4.3,1338480,2070573655
002020,코오롱,16300,16100,-200,-1.23,35305,565590650
003070,코오롱글로벌,9070,9090,20,0.22,15085,136427530
003075,코오롱글로벌우,17050,16900,-150,-0.88,418,7064600
144620,코오롱머티리얼,1445,1420,-25,-1.73,81132,114171990
002025,코오롱우,10700,10650,-50,-0.47,5435,57874250
120110,코오롱인더,41400,41800,400,0.97,33043,1377884250
120115,코오롱인더우,20350,20250,-100,-0.49,3360,68268450
138490,코오롱플라스틱,5060,4905,-155,-3.06,246321,1211767610
031820,콤텍시스템,1295,1315,20,1.54,415571,537241475
192400,쿠쿠홀딩스,117500,117000,-500,-0.43,1500,175287000
284740,쿠쿠홈시스,43100,42100,-1000,-2.32,15001,637396750
015590,큐로,885,919,34,3.84,1016297,924159849
264900,크라운제과,8800,8750,-50,-0.57,13503,117219100
26490K,크라운제과우,8450,8390,-60,-0.71,17535,147037540
005740,크라운해태홀딩스,11100,11150,50,0.45,30269,332383400
005745,크라운해태홀딩스우,14200,14450,250,1.76,19572,278504400
020120,키다리스튜디오,4595,4370,-225,-4.9,129513,575430175
039490,키움증권,67200,67900,700,1.04,23809,1606318900
012170,키위미디어그룹,150,150,0,0.0,0,0
015890,태경산업,5840,5700,-140,-2.4,114705,653121230
006890,태경화학,5290,5240,-50,-0.95,40476,211067890
003240,태광산업,1139000,1130000,-9000,-0.79,235,265936000
011280,태림포장,5400,5310,-90,-1.67,684387,3627338230
004100,태양금속,1080,1060,-20,-1.85,126724,134500710
004105,태양금속우,3020,3000,-20,-0.66,5222,15658625
009410,태영건설,13150,13300,150,1.14,131064,1745214250
009415,태영건설우,7360,7360,0,0.0,45421,327278330
001420,태원물산,4245,4505,260,6.12,104413,460973000
007980,태평양물산,2825,2805,-20,-0.71,38027,106801845
055490,테이팩스,24100,23800,-300,-1.24,3411,81227300
078000,텔코웨어,13550,13650,100,0.74,7322,98959750
214420,토니모리,10200,10200,0,0.0,166038,1710746350
019180,티에이치엔,4650,4575,-75,-1.61,279859,1268466720
091810,티웨이항공,4855,4820,-35,-0.72,87230,418631575
004870,티웨이홀딩스,1670,1655,-15,-0.9,630356,1021674980
005690,파미셀,7340,7110,-230,-3.13,531399,3801182780
036580,팜스코,6020,5670,-350,-5.81,736389,4211577810
028670,팬오션,4540,4570,30,0.66,525504,2391620740
010820,퍼스텍,2375,2275,-100,-4.21,311634,714564180
016800,퍼시스,31500,31900,400,1.27,1232,39070600
001020,페이퍼코리아,704,715,11,1.56,52247,37133888
090080,평화산업,1345,1315,-30,-2.23,204840,269033025
010770,평화홀딩스,4225,4100,-125,-2.96,14674,60446025
058430,포스코강판,17750,17750,0,0.0,1646,29323750
047050,포스코인터내셔널,19150,19100,-50,-0.26,128218,2447179400
003670,포스코케미칼,44700,44150,-550,-1.23,240787,10599421450
007630,폴루스바이오팜,1225,1225,0,0.0,0,0
017810,풀무원,9390,9490,100,1.06,62943,588400930
103140,풍산,22100,22300,200,0.9,28290,628498050
005810,풍산홀딩스,34250,34800,550,1.61,1728,59919550
033180,필룩스,3755,3455,-300,-7.99,3120809,10991240150
086790,하나금융지주,35000,35250,250,0.71,884596,31299052550
099340,하나니켈1호,447,445,-2,-0.45,41318,18389218
099350,하나니켈2호,1150,1035,-115,-10.0,242205,255162700
293480,하나제약,23250,23400,150,0.65,29359,683844650
039130,하나투어,44450,44200,-250,-0.56,37942,1674308350
172580,하이골드12호,2800,2820,20,0.71,14112,39571425
153360,하이골드3호,1785,1805,20,1.12,29961,54112700
159650,하이골드8호,1855,1875,20,1.08,19952,37120065
071090,하이스틸,23350,23000,-350,-1.5,15928,368764150
019490,하이트론,3800,3735,-65,-1.71,2040,7630835
000080,하이트진로,26550,27200,650,2.45,333814,8972220050
000087,하이트진로2우B,17650,17700,50,0.28,2488,43570500
000140,하이트진로홀딩스,11100,11200,100,0.9,84337,932797900
000145,하이트진로홀딩스우,20250,19750,-500,-2.47,19715,384826150
152550,한국ANKOR유전,1760,1760,0,0.0,2782,4891710
036460,한국가스공사,39500,39600,100,0.25,85707,3394725150
005430,한국공항,40600,40600,0,0.0,1761,71253300
071050,한국금융지주,73300,75300,2000,2.73,107501,8039601200
071055,한국금융지주우,43200,43700,500,1.16,5496,239066250
010040,한국내화,5480,5300,-180,-3.28,194622,1035472870
025540,한국단자,45950,46200,250,0.54,10237,469110250
004090,한국석유,113500,113000,-500,-0.44,3707,414978000
002960,한국쉘석유,330000,333000,3000,0.91,1029,341471000
123890,한국자산신탁,3360,3375,15,0.45,62404,210595355
015760,한국전력,25750,25900,150,0.58,814978,21112801150
006200,한국전자홀딩스,736,721,-15,-2.04,45316,32861794
002300,한국제지,17550,17950,400,2.28,3782,67454350
009540,한국조선해양,122500,124000,1500,1.22,148254,18365500000
023350,한국종합기술,4310,4295,-15,-0.35,23679,101022220
025890,한국주강,1650,1660,10,0.61,16325,26880890
000970,한국주철관,11150,11000,-150,-1.35,45336,498127300
104700,한국철강,4890,4880,-10,-0.2,90074,438264800
017960,한국카본,8260,8360,100,1.21,222475,1832067800
161890,한국콜마,43200,42200,-1000,-2.31,199505,8451130850
024720,한국콜마홀딩스,20950,20800,-150,-0.72,58509,1210240900
161390,한국타이어앤테크놀로지,31600,32250,650,2.06,289245,9345724850
000240,한국테크놀로지그룹,14050,14300,250,1.78,18609,263168950
034830,한국토지신탁,2095,2090,-5,-0.24,200844,417121520
007280,한국특수형강,1410,1380,-30,-2.13,14934,20677215
168490,한국패러랠,2235,2235,0,0.0,7164,16001545
010100,한국프랜지,2725,2575,-150,-5.5,1904654,4932005475
047810,한국항공우주,38400,39100,700,1.82,291287,11294644200
123690,한국화장품,8450,8280,-170,-2.01,102157,851206330
003350,한국화장품제조,29800,29850,50,0.17,147861,4329538650
011500,한농화성,4040,3985,-55,-1.36,23313,92103315
002390,한독,20900,20850,-50,-0.24,20329,423414750
014790,한라,3335,3335,0,0.0,75530,250809375
060980,한라홀딩스,42250,42900,650,1.54,12117,521365800
053690,한미글로벌,9000,8910,-90,-1.0,21399,190557220
042700,한미반도체,6710,6610,-100,-1.49,75868,501818400
008930,한미사이언스,39500,39600,100,0.25,72717,2846769500
128940,한미약품,279000,276000,-3000,-1.08,25041,6920958000
009240,한샘,59800,60000,200,0.33,81811,4910767300
020000,한섬,29250,29200,-50,-0.17,34667,1010186250
003680,한성기업,6980,6440,-540,-7.74,158847,1045372570
105630,한세실업,19050,19300,250,1.31,122250,2360518100
069640,한세엠케이,4345,4395,50,1.15,30698,133061645
016450,한세예스24홀딩스,7270,7340,70,0.96,12575,91252050
010420,한솔PNS,1685,1665,-20,-1.19,148725,246708290
009180,한솔로지스틱스,1290,1270,-20,-1.55,79517,100380465
213500,한솔제지,15450,15400,-50,-0.32,25468,394120400
014680,한솔케미칼,80500,79600,-900,-1.12,30054,2408776800
004710,한솔테크닉스,6940,6960,20,0.29,166300,1142611800
004150,한솔홀딩스,4150,4150,0,0.0,44449,183126840
025750,한솔홈데코,1290,1280,-10,-0.78,295701,375917240
004960,한신공영,15600,15650,50,0.32,48167,748866150
011700,한신기계,1730,1695,-35,-2.02,224614,379867360
001750,한양증권,7450,7420,-30,-0.4,2019,14967190
001755,한양증권우,8140,8170,30,0.37,631,5155720
018880,한온시스템,12000,12000,0,0.0,698165,8347377200
009420,한올바이오파마,26700,26100,-600,-2.25,195850,5162373050
014130,한익스프레스,5800,5680,-120,-2.07,90151,511950050
300720,한일시멘트,99700,99500,-200,-0.2,1224,121680600
002220,한일철강,2200,2190,-10,-0.45,7382,16153335
006390,한일현대시멘트,37200,37000,-200,-0.54,18454,683351900
003300,한일홀딩스,49700,49800,100,0.2,1778,88523550
051600,한전KPS,33900,34550,650,1.92,62484,2139632100
052690,한전기술,22250,22100,-150,-0.67,97788,2151238000
130660,한전산업,3435,3400,-35,-1.02,57774,196036975
002320,한진,31500,31150,-350,-1.11,42207,1332285900
097230,한진중공업,4535,4545,10,0.22,65613,295883335
003480,한진중공업홀딩스,2820,2825,5,0.18,5181,14589200
180640,한진칼,27350,27100,-250,-0.91,562602,15319215050
18064K,한진칼우,37800,36900,-900,-2.38,623758,26191288700
005110,한창,4020,3990,-30,-0.75,4459183,17691863980
009460,한창제지,2855,2800,-55,-1.93,1697753,4885466080
000880,한화,24650,25250,600,2.43,147177,3672943000
00088K,한화3우B,13600,13750,150,1.1,21647,295844300
027390,한화갤러리아타임월드,18400,18300,-100,-0.54,6523,118500900
088350,한화생명,2400,2380,-20,-0.83,1316525,3129428110
000370,한화손해보험,3075,3010,-65,-2.11,195853,591412100
012450,한화에어로스페이스,40950,42150,1200,2.93,303428,12728940650
000885,한화우,38550,32950,-5600,-14.53,235934,8028683950
009830,한화케미칼,17650,17950,300,1.7,303187,5395243650
009835,한화케미칼우,12200,12300,100,0.82,92090,1155910450
003530,한화투자증권,2100,2110,10,0.48,118744,248643325
003535,한화투자증권우,2130,2115,-15,-0.7,8413,17804925
195870,해성디에스,13750,13650,-100,-0.73,27247,372293100
101530,해태제과식품,7710,7680,-30,-0.39,13125,100522090
143210,핸즈코퍼레이션,7380,7420,40,0.54,30652,224057030
000720,현대건설,45800,46300,500,1.09,296051,13587990700
267270,현대건설기계,31850,31600,-250,-0.78,56340,1764492550
000725,현대건설우,171500,174000,2500,1.46,413,69614000
005440,현대그린푸드,11700,11700,0,0.0,54148,633286400
086280,현대글로비스,151500,156000,4500,2.97,61093,9492870500
064350,현대로템,19650,19500,-150,-0.76,323941,6290765800
079430,현대리바트,13500,13700,200,1.48,28635,388286550
012330,현대모비스,249000,252000,3000,1.2,191365,48004519500
010620,현대미포조선,44300,45100,800,1.81,92803,4143486200
069960,현대백화점,76500,78100,1600,2.09,49747,3854525800
004560,현대비앤지스틸,9050,9030,-20,-0.22,12257,110039340
004565,현대비앤지스틸우,60800,60700,-100,-0.16,511,30727900
011760,현대상사,20150,19900,-250,-1.24,45023,890716600
011200,현대상선,3670,3625,-45,-1.23,403450,1459152000
004310,현대약품,4890,4715,-175,-3.58,381013,1810868260
126560,현대에이치씨엔,3665,3670,5,0.14,12693,46588885
017800,현대엘리베이,90000,89300,-700,-0.78,161641,14457706400
307950,현대오토에버,55500,54100,-1400,-2.52,239174,12661606900
011210,현대위아,50000,51000,1000,2.0,121328,6146947750
267260,현대일렉트릭,11150,11200,50,0.45,168071,1896445750
004020,현대제철,38750,38900,150,0.39,250702,9700198550
267250,현대중공업지주,346000,349500,3500,1.01,13594,4717554500
005380,현대차,133500,134000,500,0.37,429631,57742930500
005387,현대차2우B,85000,84900,-100,-0.12,93049,7977219500
005389,현대차3우B,74200,75200,1000,1.35,4713,353782200
005385,현대차우,75800,76400,600,0.79,34676,2660179300
001500,현대차증권,10550,10600,50,0.47,21727,228868750
227840,현대코퍼레이션홀딩스,16500,15750,-750,-4.55,2163587,36700964700
001450,현대해상,26200,26400,200,0.76,277780,7325166374
057050,현대홈쇼핑,91900,91500,-400,-0.44,9210,845471000
093240,형지엘리트,1435,1405,-30,-2.09,123259,172345845
003010,혜인,5100,4970,-130,-2.55,114624,569249740
111110,호전실업,13100,13400,300,2.29,1556,20613200
008770,호텔신라,86800,86200,-600,-0.69,270347,23274820900
008775,호텔신라우,52000,51800,-200,-0.38,5466,281185400
002460,화성산업,12250,12200,-50,-0.41,23802,291480800
013520,화승알앤에이,1915,1930,15,0.78,266317,515055225
241590,화승엔터프라이즈,15400,16050,650,4.22,773925,12408565400
006060,화승인더,9890,10350,460,4.65,628503,6490794020
010690,화신,3215,3450,235,7.31,137921,462057400
133820,화인베스틸,3380,3235,-145,-4.29,433826,1421959350
010660,화천기계,3900,4870,970,24.87,38980227,180817511220
000850,화천기공,39200,39750,550,1.4,18096,718520650
016580,환인제약,15400,15800,400,2.6,107285,1651992500
032560,황금에스티,7890,7880,-10,-0.13,30957,240775590
004800,효성,83800,83800,0,0.0,44105,3696895600
094280,효성ITX,9710,9750,40,0.41,3510,34099350
298040,효성중공업,32100,31450,-650,-2.02,22204,704425700
298050,효성첨단소재,123000,123000,0,0.0,39530,4830331500
298020,효성티앤씨,159000,158000,-1000,-0.63,5377,846239500
298000,효성화학,163000,169000,6000,3.68,10519,1751066500
093370,후성,8430,8480,50,0.59,2246457,19302088060
081660,휠라코리아,56100,57900,1800,3.21,663824,38316289000
005870,휴니드,7230,7200,-30,-0.41,24703,176950270
079980,휴비스,6210,6170,-40,-0.64,28844,178294940
005010,휴스틸,10500,10450,-50,-0.48,9909,102815900
069260,휴켐스,21450,21400,-50,-0.23,23990,513672350
000540,흥국화재,3230,3200,-30,-0.93,16038,51486980
000547,흥국화재2우B,19500,19500,0,0.0,26,507450
000545,흥국화재우,4940,4800,-140,-2.83,13893,66644945
003280,흥아해운,448,437,-11,-2.46,233227,101223182
