티커,종목명,시가,종가,변동폭,등락률,거래량,거래대금
095570,AJ네트웍스,4460,4455,-5,-0.11,43445,192903360
068400,AJ렌터카,12400,12100,-300,-2.42,377061,4612706050
006840,AK홀딩스,33900,33550,-350,-1.03,25066,843631300
027410,BGF,6130,6130,0,0.0,50801,311005640
282330,BGF리테일,201500,201500,0,0.0,14458,2914720000
138930,BNK금융지주,7220,7180,-40,-0.55,494585,3567793510
001460,BYC,239500,240000,500,0.21,958,228287000
001465,BYC우,131000,130000,-1000,-0.76,823,106070500
001040,CJ,85600,84100,-1500,-1.75,72259,6121678200
079160,CJCGV,35400,34550,-850,-2.4,67487,2353052600
00104K,CJ4우전환,61400,60400,-1000,-1.63,27465,1657954100
000120,CJ대한통운,143500,141000,-2500,-1.74,28886,4092495500
011150,CJ씨푸드,3475,3370,-105,-3.02,1641372,5572182760
011155,CJ씨푸드1우,35850,35500,-350,-0.98,19623,704051550
001045,CJ우,44300,43850,-450,-1.02,6279,276780250
097950,CJ제일제당,246000,237500,-8500,-3.46,60535,14506070500
097955,CJ제일제당우,112500,110000,-2500,-2.22,3650,406865000
037560,CJ헬로,6320,6290,-30,-0.47,255125,1613797160
000590,CS홀딩스,61000,60900,-100,-0.16,135,8139400
012030,DB,802,811,9,1.12,318070,256145395
016610,DB금융투자,4615,4600,-15,-0.33,23598,108618240
005830,DB손해보험,53000,51100,-1900,-3.58,145559,7528862900
000990,DB하이텍,15650,15700,50,0.32,432007,6808680050
000995,DB하이텍1우,37450,38350,900,2.4,961,36141600
139130,DGB금융지주,7570,7510,-60,-0.79,715604,5416633560
001530,DI동일,79000,81900,2900,3.67,9174,751365400
004840,DRB동일,5490,5470,-20,-0.36,2977,16286640
155660,DSR,4245,4320,75,1.77,35223,151314430
069730,DSR제강,4580,4700,120,2.62,39792,185292370
017940,E1,50700,50700,0,0.0,4267,215974400
007700,FF,90500,87500,-3000,-3.31,75621,6631588000
114090,GKL,20750,20900,150,0.72,77602,1619299750
078930,GS,50700,50000,-700,-1.38,119660,5972583500
006360,GS건설,34250,33600,-650,-1.9,305756,10328972400
001250,GS글로벌,2510,2505,-5,-0.2,173801,438134150
007070,GS리테일,41600,41750,150,0.36,114415,4744369100
078935,GS우,36900,36900,0,0.0,2922,107811200
012630,HDC,13050,13050,0,0.0,174530,2282009950
039570,HDC아이콘트롤스,9520,9500,-20,-0.21,14068,133215590
089470,HDC현대EP,4570,4580,10,0.22,24892,113790095
294870,HDC현대산업개발,32950,33700,750,2.28,196609,6590088500
082740,HSD엔진,3550,3510,-40,-1.13,42914,150708880
003560,IHQ,1965,1930,-35,-1.78,998338,1943073895
175330,JB금융지주,5800,5780,-20,-0.34,174888,1015656490
234080,JW생명과학,22200,22000,-200,-0.9,71011,1561313050
001060,JW중외제약,28150,28000,-150,-0.53,28647,805139050
001067,JW중외제약2우B,38300,38950,650,1.7,628,24346800
001065,JW중외제약우,25300,25850,550,2.17,906,23376800
096760,JW홀딩스,6140,6080,-60,-0.98,62138,379767220
105560,KB금융,43250,42900,-350,-0.81,957419,41227060100
002380,KCC,228500,229500,1000,0.44,10552,2422267500
009070,KCTC,3320,3370,50,1.51,425400,1447322410
009440,KC그린홀딩스,4350,4310,-40,-0.92,112428,491545540
119650,KC코트렐,6740,6850,110,1.63,290710,1965325200
092220,KEC,1195,1230,35,2.93,1985900,2419885755
001390,KG케미칼,11850,12000,150,1.27,36329,434898950
001940,KISCO홀딩스,12550,12600,50,0.4,28419,356978600
025000,KPX케미칼,54400,54500,100,0.18,568,30864400
092230,KPX홀딩스,54800,54700,-100,-0.18,497,27078000
000040,KR모터스,504,507,3,0.6,326985,165915620
044450,KSS해운,7120,7120,0,0.0,22225,157222150
030200,KT,27550,27550,0,0.0,310253,8552250700
033780,KTG,103000,102500,-500,-0.49,192769,19780626000
030210,KTB투자증권,2630,2615,-15,-0.57,129043,337888330
058850,KTcs,2100,2100,0,0.0,44229,92784650
058860,KTis,2260,2255,-5,-0.22,43386,97711510
093050,LF,20500,20450,-50,-0.24,54773,1124969600
003550,LG,71700,71000,-700,-0.98,158420,11252521400
034220,LG디스플레이,14350,14700,350,2.44,2101971,30867908500
001120,LG상사,18150,18100,-50,-0.28,67033,1211385100
051900,LG생활건강,1262000,1257000,-5000,-0.4,22342,28113548000
051905,LG생활건강우,764000,769000,5000,0.65,354,271450000
003555,LG우,46450,46850,400,0.86,6207,291548600
032640,LG유플러스,13450,13450,0,0.0,1342810,18197320000
011070,LG이노텍,105000,105000,0,0.0,169637,17984078000
066570,LG전자,66100,65200,-900,-1.36,582024,38100550400
066575,LG전자우,26950,26750,-200,-0.74,20637,557515100
108670,LG하우시스,63100,62200,-900,-1.43,18996,1188258200
108675,LG하우시스우,29600,29450,-150,-0.51,564,16603400
051910,LG화학,325500,327500,2000,0.61,108529,35461618000
051915,LG화학우,179500,180500,1000,0.56,17375,3131207500
079550,LIG넥스원,34300,34600,300,0.87,174131,6055416750
006260,LS,48250,48350,100,0.21,36430,1759612850
000680,LS네트웍스,2520,2520,0,0.0,17128,43097955
010120,LS산전,47500,48100,600,1.26,32762,1568781600
229640,LS전선아시아,7300,7350,50,0.68,192128,1425543500
023150,MH에탄올,6020,6050,30,0.5,2857,17261930
035420,NAVER,159000,157500,-1500,-0.94,377446,59301314500
181710,NHN,63200,62100,-1100,-1.74,90816,5662570700
005940,NH투자증권,13050,12800,-250,-1.92,554289,7156351050
005945,NH투자증권우,9230,9090,-140,-1.52,133687,1229295110
034310,NICE,19100,19050,-50,-0.26,24015,458181000
008260,NI스틸,2395,2500,105,4.38,113332,277906220
004250,NPC,3970,4045,75,1.89,106399,438284515
004255,NPC우,2335,2335,0,0.0,3318,7702685
010060,OCI,71300,70700,-600,-0.84,67743,4787906900
005490,POSCO,238000,233500,-4500,-1.89,245084,57433162500
100840,STC,18400,18300,-100,-0.54,8135,149446650
064960,ST모티브,51300,51200,-100,-0.19,88160,4481072300
003570,ST중공업,6270,6260,-10,-0.16,3609,22566490
036530,ST홀딩스,15050,15150,100,0.66,4279,64560350
010950,S-Oil,100000,99700,-300,-0.3,206982,20491956850
010955,S-Oil우,59800,60200,400,0.67,4672,280294900
034120,SBS,18300,18400,100,0.55,112698,2080767300
101060,SBS미디어홀딩스,2230,2230,0,0.0,20519,45822175
004060,SG세계물산,1095,1090,-5,-0.46,1162150,1277754215
001380,SG충방,2025,2035,10,0.49,179125,364432960
002360,SH에너지화학,1110,1115,5,0.45,3343166,3729674725
009160,SIMPAC,3165,3320,155,4.9,883604,2917750880
123700,SJM,3100,3120,20,0.65,6518,20229665
025530,SJM홀딩스,3105,3110,5,0.16,1605,4966950
034730,SK,211500,210000,-1500,-0.71,86999,18346280500
011790,SKC,43650,43200,-450,-1.03,165641,7203573800
018670,SK가스,77800,77500,-300,-0.39,5323,415216300
001740,SK네트웍스,5420,5320,-100,-1.85,725035,3886130780
001745,SK네트웍스우,87500,86800,-700,-0.8,2481,216324200
006120,SK디스커버리,23350,23200,-150,-0.64,18612,433742350
006125,SK디스커버리우,14900,14800,-100,-0.67,18523,275205400
210980,SK디앤디,28650,28850,200,0.7,19501,565654100
03473K,SK우,141000,141000,0,0.0,936,132499000
096770,SK이노베이션,169500,169000,-500,-0.29,130936,22047755500
096775,SK이노베이션우,120000,119000,-1000,-0.83,3295,394575000
001510,SK증권,643,641,-2,-0.31,539377,347473410
001515,SK증권우,2865,2840,-25,-0.87,6835,19481475
285130,SK케미칼,48100,47750,-350,-0.73,19836,951895750
28513K,SK케미칼우,21300,21300,0,0.0,3337,70995850
017670,SK텔레콤,238500,238000,-500,-0.21,136505,32606131000
000660,SK하이닉스,80200,82700,2500,3.12,3612220,296218713239
005610,SPC삼립,97800,96000,-1800,-1.84,11623,1125032100
011810,STX,8590,8500,-90,-1.05,37547,322017410
077970,STX엔진,8100,8170,70,0.86,17923,146277960
071970,STX중공업,2585,2540,-45,-1.74,211812,541501490
084870,TBH글로벌,2970,3000,30,1.01,106047,317336395
002710,TCC스틸,2830,2830,0,0.0,23893,67055050
024070,WISCOM,2660,2650,-10,-0.38,1654,4391365
037270,YGPLUS,1145,1140,-5,-0.44,141814,161773485
000500,가온전선,16950,16850,-100,-0.59,14407,241023250
000860,강남제비스코,22900,22850,-50,-0.22,6549,149147050
035250,강원랜드,29450,29550,100,0.34,226976,6697181750
011420,갤럭시아에스엠,2200,2205,5,0.23,572553,1206692775
002100,경농,16350,16550,200,1.22,224973,3687375850
009450,경동나비엔,41450,41350,-100,-0.24,37434,1551949500
267290,경동도시가스,27550,27450,-100,-0.36,4332,118006400
012320,경동인베스트,36500,36000,-500,-1.37,5022,179427050
000050,경방,9860,9930,70,0.71,2300,22755820
214390,경보제약,8650,8590,-60,-0.69,15674,135536570
012610,경인양행,8540,8390,-150,-1.76,886000,7513463110
009140,경인전자,22550,22100,-450,-2.0,4633,102363800
013580,계룡건설,23400,23350,-50,-0.21,3007,70072600
012200,계양전기,2930,2935,5,0.17,75210,220345560
012205,계양전기우,8000,8000,0,0.0,10588,84468790
004200,고려개발,8960,9450,490,5.47,24946,235464900
002140,고려산업,4645,4645,0,0.0,7242697,34776504015
010130,고려아연,444000,435000,-9000,-2.03,29595,12937671500
002240,고려제강,22950,23200,250,1.09,9296,214827600
009290,광동제약,7270,7080,-190,-2.61,221749,1582479970
017040,광명전기,2490,2470,-20,-0.8,434241,1079764935
017900,광전자,2170,2190,20,0.92,59652,130185870
037710,광주신세계,171500,171000,-500,-0.29,106,18150500
030610,교보증권,9900,9860,-40,-0.4,28805,283433700
007690,국도화학,45550,45550,0,0.0,2522,114860150
005320,국동,1640,1635,-5,-0.3,359517,590464715
002720,국제약품,4475,4535,60,1.34,4099460,19348430625
083420,그린케미칼,3420,3410,-10,-0.29,12213,41827980
014530,극동유화,3520,3520,0,0.0,378047,1325869595
014280,금강공업,4235,4230,-5,-0.12,77439,327756160
014285,금강공업우,9190,9270,80,0.87,5118,47496480
008870,금비,66200,65900,-300,-0.45,82,5407000
001570,금양,2235,2230,-5,-0.22,16342,36218180
002990,금호산업,13000,12950,-50,-0.38,74239,960941500
002995,금호산업우,50000,50000,0,0.0,3765,188584400
011780,금호석유,74100,72900,-1200,-1.62,98108,7209919000
011785,금호석유우,30900,30750,-150,-0.49,6838,211571600
214330,금호에이치티,3985,4000,15,0.38,14421,57498410
001210,금호전기,2440,2400,-40,-1.64,38806,92864935
073240,금호타이어,4430,4450,20,0.45,172226,762267230
092440,기신정기,3690,3700,10,0.27,4475,16528290
000270,기아차,43850,43550,-300,-0.68,837270,36558215700
024110,기업은행,13350,13200,-150,-1.12,891920,11760013900
013700,까뮤이앤씨,1270,1260,-10,-0.79,90907,113983595
004540,깨끗한나라,2420,2440,20,0.83,196752,480253130
004545,깨끗한나라우,18600,18500,-100,-0.54,9675,180382750
074610,나노메딕스,7870,7850,-20,-0.25,1648076,13052993290
001260,남광토건,14000,13900,-100,-0.71,48872,679460400
008350,남선알미늄,3880,3840,-40,-1.03,2475091,9600459555
008355,남선알미우,38350,38100,-250,-0.65,9283,354134150
004270,남성,3905,3910,5,0.13,921461,3655100645
003920,남양유업,499000,495500,-3500,-0.7,419,207901000
003925,남양유업우,180000,179000,-1000,-0.56,12,2149000
002070,남영비비안,17400,17400,0,0.0,53467,917885650
025860,남해화학,9720,9620,-100,-1.03,93499,905024170
005720,넥센,5840,5950,110,1.88,176288,1054830520
005725,넥센우,3670,3630,-40,-1.09,630,2318270
002350,넥센타이어,9110,9090,-20,-0.22,42208,383642010
002355,넥센타이어1우B,3785,3795,10,0.26,3135,11903290
003580,넥스트사이언스,4795,4820,25,0.52,379624,1862494070
251270,넷마블,98200,95700,-2500,-2.55,161548,15632951100
090350,노루페인트,7600,7690,90,1.18,59246,454819300
090355,노루페인트우,11650,11950,300,2.58,4349,51393250
000320,노루홀딩스,11600,11650,50,0.43,1503,17450150
000325,노루홀딩스우,18000,17950,-50,-0.28,178,3198950
006280,녹십자,119000,117500,-1500,-1.26,30083,3540686000
005250,녹십자홀딩스,21550,21100,-450,-2.09,44959,956467550
005257,녹십자홀딩스2우,16500,16300,-200,-1.21,1176,19253700
004370,농심,246500,246500,0,0.0,11094,2752840000
072710,농심홀딩스,88400,88300,-100,-0.11,1295,113103500
058730,다스코,6490,6350,-140,-2.16,30049,192554010
023590,다우기술,20250,20550,300,1.48,92530,1905959150
019680,대교,6090,6070,-20,-0.33,20188,122719180
019685,대교우B,4220,4215,-5,-0.12,8308,34940060
006370,대구백화점,5430,5480,50,0.92,9860,53901510
008060,대덕전자,9800,9920,120,1.22,1116796,11152897550
00806K,대덕전자1우,6280,6250,-30,-0.48,6547,40976370
000490,대동공업,6450,6540,90,1.4,331224,2128405330
008110,대동전자,3880,3890,10,0.26,10298,39967745
005750,대림BCo,4110,4095,-15,-0.36,3334,13673130
000210,대림산업,101000,99700,-1300,-1.29,85480,8572896400
000215,대림산업우,42000,41950,-50,-0.12,2965,123606500
004440,대림씨엔에스,7730,7720,-10,-0.13,10509,80915610
006570,대림통상,4245,4240,-5,-0.12,2074,8765100
001680,대상,22200,22100,-100,-0.45,53165,1181623850
001685,대상우,12900,12950,50,0.39,7454,96105900
084690,대상홀딩스,6880,6880,0,0.0,17022,117429420
084695,대상홀딩스우,6320,6500,180,2.85,216665,1435262710
128820,대성산업,4165,4105,-60,-1.44,52642,218199385
117580,대성에너지,5430,5400,-30,-0.55,5645,30561480
016710,대성홀딩스,7840,7840,0,0.0,3977,30988960
003540,대신증권,13200,13250,50,0.38,106463,1422588500
003547,대신증권2우B,8720,8700,-20,-0.23,11503,100156840
003545,대신증권우,9450,9370,-80,-0.85,50658,476687650
009190,대양금속,13300,17250,3950,29.7,481336,7499416900
014160,대영포장,1220,1220,0,0.0,1099222,1335292560
047040,대우건설,4875,4765,-110,-2.26,1220382,5849355775
009320,대우부품,2115,2135,20,0.95,212676,453541925
042660,대우조선해양,30350,30000,-350,-1.15,114928,3462342950
003090,대웅,16800,16850,50,0.3,14570,244740600
069620,대웅제약,169000,169000,0,0.0,16743,2827035000
000430,대원강업,3815,3840,25,0.66,17572,67413810
006340,대원전선,1425,1415,-10,-0.7,847405,1192097820
006345,대원전선우,3420,3355,-65,-1.9,17659,59136280
003220,대원제약,15400,15450,50,0.32,6022,92782200
024890,대원화성,1515,1520,5,0.33,38061,57282650
002880,대유에이텍,953,1005,52,5.46,1014514,1009871913
000300,대유플러스,859,860,1,0.12,31557,27158101
012800,대창,1300,1310,10,0.77,2563699,3362638320
015230,대창단조,29800,29700,-100,-0.34,4094,120738700
001070,대한방직,19550,19700,150,0.77,2057,40392000
006650,대한유화,131500,129000,-2500,-1.9,24858,3238342000
001440,대한전선,590,594,4,0.68,589808,351486871
084010,대한제강,6800,6750,-50,-0.74,45818,308293830
001790,대한제당,20100,22350,2250,11.19,1654360,41316678700
001799,대한제당3우B,24450,28100,3650,14.93,100225,3037276400
001795,대한제당우,13750,14200,450,3.27,430637,7084406200
001130,대한제분,172000,171000,-1000,-0.58,2274,388329000
003490,대한항공,24300,23900,-400,-1.65,476193,11493837700
003495,대한항공우,14600,14500,-100,-0.68,6221,90451200
005880,대한해운,23400,23400,0,0.0,39798,941164350
003830,대한화섬,96600,96700,100,0.1,173,16623100
016090,대현,2450,2440,-10,-0.41,49205,119962295
069460,대호에이엘,6000,5900,-100,-1.67,294804,1755509180
192080,더블유게임즈,57200,56700,-500,-0.87,48771,2774807300
012510,더존비즈온,64600,64200,-400,-0.62,118244,7616801650
004830,덕성,3330,3360,30,0.9,189814,637434225
004835,덕성우,3935,3995,60,1.52,17735,70489330
024900,덕양산업,1235,1230,-5,-0.4,82642,102475785
145720,덴티움,67500,67100,-400,-0.59,15567,1046667500
002150,도화엔지니어링,11300,11200,-100,-0.88,141768,1591114750
001230,동국제강,6800,6780,-20,-0.29,154776,1058049880
023450,동남합성,23800,23800,0,0.0,375,8951600
004140,동방,1865,1855,-10,-0.54,138142,255798910
007590,동방아그로,6720,6740,20,0.3,4200,28202870
005960,동부건설,9480,9550,70,0.74,39126,369354250
005965,동부건설우,19350,19750,400,2.07,1488,28865200
016380,동부제철,20000,16600,-3400,-17.0,68869,1229797550
016385,동부제철우,92500,90200,-2300,-2.49,6405,563703100
083370,동북아12호,5030,5020,-10,-0.2,0,0
083380,동북아13호,4995,5000,5,0.1,241,1205000
026960,동서,18100,18100,0,0.0,42699,773749150
002210,동성제약,17200,17000,-200,-1.16,320836,5490128700
102260,동성코퍼레이션,5660,5680,20,0.35,75448,424551930
005190,동성화학,16950,16800,-150,-0.88,6704,112485650
000640,동아쏘시오홀딩스,88600,87900,-700,-0.79,7985,701681300
170900,동아에스티,84600,84300,-300,-0.35,10102,851674000
028100,동아지질,25400,24000,-1400,-5.51,471580,11502726550
282690,동아타이어,12400,12350,-50,-0.4,3103,38513050
001520,동양,1610,1600,-10,-0.62,123942,198295695
001527,동양2우B,9330,9360,30,0.32,475,4462330
001529,동양3우B,28150,28250,100,0.36,3500,101669150
084670,동양고속,26800,27500,700,2.61,1312,35583350
030790,동양네트웍스,1455,1595,140,9.62,3352614,5202710780
002900,동양물산,1055,1030,-25,-2.37,580264,598230355
082640,동양생명,3910,3930,20,0.51,67914,267089850
001525,동양우,7260,7270,10,0.14,795,5779650
008970,동양철관,1325,1320,-5,-0.38,752275,987452695
092780,동양피스톤,4845,4960,115,2.37,106446,526777620
049770,동원FB,223000,221500,-1500,-0.67,5697,1264694500
018500,동원금속,894,896,2,0.22,60177,53921990
006040,동원산업,224500,220500,-4000,-1.78,3782,839929500
030720,동원수산,9860,9650,-210,-2.13,317862,3066721740
014820,동원시스템즈,39400,39300,-100,-0.25,19131,751547150
014825,동원시스템즈우,28450,28550,100,0.35,521,14808800
163560,동일고무벨트,5700,5680,-20,-0.35,12149,68561000
004890,동일산업,58300,58200,-100,-0.17,277,16141500
002690,동일제강,2810,2825,15,0.53,28610,80656000
000020,동화약품,8300,8180,-120,-1.45,113570,928357120
000150,두산,108500,109000,500,0.46,105447,11553820000
000157,두산2우B,80500,80700,200,0.25,317,25677700
011160,두산건설,1355,1350,-5,-0.37,54448,73921385
241560,두산밥캣,35850,35350,-500,-1.39,78294,2779598200
000155,두산우,80400,80600,200,0.25,6264,505023600
042670,두산인프라코어,6400,6430,30,0.47,807897,5205162490
034020,두산중공업,6770,7050,280,4.14,2802848,19513532960
016740,두올,3365,3375,10,0.3,185962,635343165
192650,드림텍,6750,6980,230,3.41,1285501,9016260020
024090,디씨엠,12550,12650,100,0.8,6754,84550650
003160,디아이,3400,3400,0,0.0,123325,420092835
092200,디아이씨,2615,2560,-55,-2.1,244935,632055475
013570,디와이,5050,5060,10,0.2,38656,195139350
210540,디와이파워,10950,10900,-50,-0.46,82610,910846300
007340,디티알오토모티브,30950,30500,-450,-1.45,23686,718466300
026890,디피씨,5670,5350,-320,-5.64,2214917,12079179610
115390,락앤락,13050,12800,-250,-1.92,93384,1203599550
032350,롯데관광개발,12050,12300,250,2.07,418556,5139510100
000400,롯데손해보험,2180,2175,-5,-0.23,281220,613254855
023530,롯데쇼핑,137500,136000,-1500,-1.09,53755,7321513500
004000,롯데정밀화학,47350,46950,-400,-0.84,25577,1201478850
286940,롯데정보통신,42700,42400,-300,-0.7,26785,1145093250
280360,롯데제과,149500,148000,-1500,-1.0,2602,385523500
004990,롯데지주,37550,37000,-550,-1.46,162622,6032594500
00499K,롯데지주우,49450,49000,-450,-0.91,1267,62335550
005300,롯데칠성,141500,143000,1500,1.06,12747,1809244000
005305,롯데칠성우,74500,74300,-200,-0.27,17,1263700
011170,롯데케미칼,250500,249000,-1500,-0.6,71919,17900213000
002270,롯데푸드,453000,451000,-2000,-0.44,1510,680500500
071840,롯데하이마트,32350,32250,-100,-0.31,93485,3022674700
027740,마니커,1410,1220,-190,-13.48,55915029,69010313030
204320,만도,35800,35300,-500,-1.4,209738,7480615150
001080,만호제강,17550,17200,-350,-1.99,1847,31853650
088980,맥쿼리인프라,11500,11600,100,0.87,410747,4741340900
094800,맵스리얼티1,4860,5000,140,2.88,214574,1064099940
015540,메디파트너생명공학,7720,7250,-470,-6.09,75232,551425730
138040,메리츠금융지주,13200,13300,100,0.76,22400,295844950
008560,메리츠종금증권,5130,5070,-60,-1.17,615021,3136485150
000060,메리츠화재,19050,18800,-250,-1.31,91755,1733565850
090370,메타랩스,1600,1590,-10,-0.63,287896,458601960
017180,명문제약,4430,4450,20,0.45,116720,517398065
012690,모나리자,3705,3820,115,3.1,613824,2312946385
005360,모나미,4970,4965,-5,-0.1,1195957,5973401265
204210,모두투어리츠,2850,2835,-15,-0.53,52573,147430055
009680,모토닉,9130,9100,-30,-0.33,20477,186287200
009580,무림PP,4705,4680,-25,-0.53,145321,683176430
009200,무림페이퍼,2740,2740,0,0.0,53685,147531730
033920,무학,9300,9520,220,2.37,97194,922473080
008420,문배철강,2930,2925,-5,-0.17,64456,187980010
025560,미래산업,176,179,3,1.7,12194826,2177141429
007120,미래아이앤지,307,310,3,0.98,142845,43621949
006800,미래에셋대우,7820,7660,-160,-2.05,1009983,7782331470
00680K,미래에셋대우2우B,4340,4255,-85,-1.96,169085,727586135
006805,미래에셋대우우,4755,4720,-35,-0.74,27036,128010170
085620,미래에셋생명,4350,4335,-15,-0.34,35688,154536340
002840,미원상사,54800,57900,3100,5.66,21599,1249789000
268280,미원에스씨,71800,71600,-200,-0.28,1081,76982500
107590,미원홀딩스,40100,40050,-50,-0.12,2476,99310550
134380,미원화학,40300,40300,0,0.0,227,9236200
003650,미창석유,78000,77400,-600,-0.77,668,51995400
155900,바다로19호,2920,2920,0,0.0,12540,36652240
003610,방림,2055,2050,-5,-0.24,43613,89867805
001340,백광산업,2955,2820,-135,-4.57,1926498,5406134605
014580,백광소재,6520,5730,-790,-12.12,11506930,66193224290
035150,백산,6300,6210,-90,-1.43,156733,978204910
002410,범양건영,1675,1635,-40,-2.39,71737,117850780
096300,베트남개발1,438,438,0,0.0,271999,117630195
007210,벽산,2180,2140,-40,-1.83,4814413,10696617975
002760,보락,2065,2075,10,0.48,1543137,3273401995
003850,보령제약,12400,12450,50,0.4,120240,1499148100
000890,보해양조,1245,1240,-5,-0.4,20456508,26277114555
003000,부광약품,14800,14550,-250,-1.69,122032,1788575700
001270,부국증권,20450,20300,-150,-0.73,3149,64285750
001275,부국증권우,19100,18950,-150,-0.79,5375,102169350
026940,부국철강,4015,4070,55,1.37,93634,382765110
015350,부산가스,35900,35850,-50,-0.14,340,12163600
011390,부산산업,164500,164500,0,0.0,38854,6393343500
005030,부산주공,532,536,4,0.75,74304,39675531
100220,비상교육,7980,8040,60,0.75,39717,321593970
101140,비티원,3170,3170,0,0.0,146464,460681850
005180,빙그레,57100,57700,600,1.05,6377,367083800
003960,사조대림,18150,17750,-400,-2.2,19158,342764850
008040,사조동아원,1155,1145,-10,-0.87,1028092,1185291580
007160,사조산업,43600,42900,-700,-1.61,9116,392920750
014710,사조씨푸드,5620,5570,-50,-0.89,108169,598155640
006090,사조오양,8550,8180,-370,-4.33,219776,1825407110
005090,삼광글라스,33650,33700,50,0.15,1122,37760350
001470,삼부토건,803,809,6,0.75,1014268,816186068
006400,삼성SDI,234500,236500,2000,0.85,176258,41621642000
006405,삼성SDI우,90100,90700,600,0.67,2189,198331700
006660,삼성공조,8780,8810,30,0.34,1466,12907070
028260,삼성물산,90500,91200,700,0.77,331003,30406464700
02826K,삼성물산우B,67600,68100,500,0.74,4831,329141100
207940,삼성바이오로직스,316000,329000,13000,4.11,273672,89866766500
032830,삼성생명,72700,71900,-800,-1.1,183913,13290475200
018260,삼성에스디에스,197500,199000,1500,0.76,61227,12196307500
028050,삼성엔지니어링,17050,16650,-400,-2.35,898271,15109424600
009150,삼성전기,97100,101000,3900,4.02,1592520,159424260823
009155,삼성전기우,39150,40400,1250,3.19,32930,1340342250
005930,삼성전자,47700,49150,1450,3.04,16461413,803291510354
005935,삼성전자우,39850,40550,700,1.76,1545963,62489808917
001360,삼성제약,2955,2935,-20,-0.68,1455246,4313861025
010140,삼성중공업,8240,8230,-10,-0.12,1614500,13297364230
010145,삼성중공우,62700,62000,-700,-1.12,1613,100589500
016360,삼성증권,36500,35950,-550,-1.51,154426,5587535650
068290,삼성출판사,13650,13700,50,0.37,45769,624866950
029780,삼성카드,34000,33800,-200,-0.59,52678,1785148350
000810,삼성화재,235000,230000,-5000,-2.13,114548,26599635800
000815,삼성화재우,165000,162500,-2500,-1.52,12903,2107446000
006110,삼아알미늄,4700,4750,50,1.06,9892,46583420
145990,삼양사,51500,51000,-500,-0.97,3058,156450700
145995,삼양사우,34150,34100,-50,-0.15,116,3924850
003230,삼양식품,77700,78000,300,0.39,40096,3148155300
002170,삼양통상,63300,62000,-1300,-2.05,3554,221550600
272550,삼양패키징,16550,16750,200,1.21,11249,187695000
000070,삼양홀딩스,63400,62400,-1000,-1.58,7003,439578600
000075,삼양홀딩스우,43950,44300,350,0.8,478,21059300
002810,삼영무역,16550,16600,50,0.3,3605,59765600
005680,삼영전자,9620,9550,-70,-0.73,17533,168246900
003720,삼영화학,1050,1080,30,2.86,80991,85801200
023000,삼원강재,2795,2810,15,0.54,13790,38779265
004380,삼익THK,12650,13250,600,4.74,100591,1322874600
002450,삼익악기,1840,1840,0,0.0,302103,558151795
000520,삼일제약,22950,23200,250,1.09,39799,911791150
009770,삼정펄프,34100,33750,-350,-1.03,129,4346750
005500,삼진제약,27050,27000,-50,-0.18,22445,609925650
004690,삼천리,86900,87000,100,0.12,3749,325968700
001880,삼호,20900,20950,50,0.24,5931,123916950
010960,삼호개발,4645,4630,-15,-0.32,94293,431396435
004450,삼화왕관,46100,46100,0,0.0,75,3460100
009470,삼화전기,15800,16550,750,4.75,128658,2112674050
011230,삼화전자,2810,2865,55,1.96,40392,115502215
001820,삼화콘덴서,46600,47650,1050,2.25,224329,10746295500
000390,삼화페인트,5730,5770,40,0.7,22756,131815070
001290,상상인증권,1900,1950,50,2.63,789402,1583415620
041650,상신브레이크,3820,3800,-20,-0.52,14499,55143890
075180,새론오토모티브,4785,4870,85,1.78,8743,41755430
007540,샘표,45050,45100,50,0.11,20965,945644750
248170,샘표식품,31950,32000,50,0.16,9772,313141000
007860,서연,3690,3715,25,0.68,25838,95563450
200880,서연이화,5850,5790,-60,-1.03,33033,190874310
017390,서울가스,69100,68700,-400,-0.58,121,8408800
004410,서울식품,194,197,3,1.55,2316391,451205693
004415,서울식품우,3790,3835,45,1.19,31455,120115805
021050,서원,1170,1165,-5,-0.43,129858,152312180
008490,서흥,32100,32400,300,0.93,21070,668943400
007610,선도전기,3905,3945,40,1.02,345700,1367750245
136490,선진,10850,10600,-250,-2.3,209112,2224777850
002820,선창산업,4850,4940,90,1.86,16977,83758045
014910,성문전자,2195,2200,5,0.23,58111,127633275
014915,성문전자우,12850,13000,150,1.17,12466,162442700
003080,성보화학,4920,4915,-5,-0.1,11155,54627640
004980,성신양회,9770,9700,-70,-0.72,193748,1881694830
004985,성신양회우,12000,12600,600,5.0,53234,661017500
011300,성안,482,483,1,0.21,25250,12149717
000180,성창기업지주,1830,1830,0,0.0,25048,45968375
002420,세기상사,58000,58300,300,0.52,337,19560400
004360,세방,12350,12300,-50,-0.4,14104,174352150
004365,세방우,6780,6790,10,0.15,933,6335070
004490,세방전지,40750,40600,-150,-0.37,12097,489294950
001430,세아베스틸,17050,16950,-100,-0.59,16414,279827150
306200,세아제강,64400,63800,-600,-0.93,4089,260472300
003030,세아제강지주,52500,52300,-200,-0.38,2760,143938700
019440,세아특수강,13850,13750,-100,-0.72,15902,219447800
058650,세아홀딩스,84100,84300,200,0.24,56,4702700
013000,세우글로벌,1915,1920,5,0.26,574875,1112097370
091090,세원셀론텍,3040,3035,-5,-0.16,104221,317338585
021820,세원정공,8090,8090,0,0.0,0,0
067830,세이브존IC,3435,3475,40,1.16,30581,106232375
033530,세종공업,4785,4800,15,0.31,50415,241231560
075580,세진중공업,5340,5380,40,0.75,117906,633041010
027970,세하,1695,1820,125,7.37,1737119,3178844900
145210,세화아이엠씨,2990,2990,0,0.0,0,0
068270,셀트리온,173500,168500,-5000,-2.88,766855,130698869000
004430,송원산업,18900,19150,250,1.32,95468,1831557750
017550,수산중공업,1585,1610,25,1.58,1981677,3212341780
002200,수출포장,19600,19800,200,1.02,1730,34105200
053210,스카이라이프,9330,9400,70,0.75,28859,270937040
134790,시디즈,38700,38850,150,0.39,941,36530000
016590,신대양제지,71300,70000,-1300,-1.82,8336,586485900
029530,신도리코,40400,40800,400,0.99,4148,169758950
004970,신라교역,13150,13000,-150,-1.14,12740,164682050
011930,신성이엔지,1020,1025,5,0.49,467461,478515590
005390,신성통상,1740,1720,-20,-1.15,2789032,4838956035
004170,신세계,257000,253500,-3500,-1.36,27956,7114309500
035510,신세계IC,120000,122000,2000,1.67,15834,1948347000
034300,신세계건설,26050,25900,-150,-0.58,1742,44941450
031430,신세계인터내셔날,179500,177500,-2000,-1.11,44529,7944316500
031440,신세계푸드,78400,78000,-400,-0.51,4412,342880900
006880,신송홀딩스,4415,4430,15,0.34,70431,310947930
005800,신영와코루,109500,110000,500,0.46,64,6974500
001720,신영증권,57200,57100,-100,-0.17,6354,361503300
001725,신영증권우,53500,53500,0,0.0,1160,62046600
009270,신원,2560,2580,20,0.78,3145197,8103624225
009275,신원우,56700,56600,-100,-0.18,1812,101782600
002700,신일산업,1525,1530,5,0.33,1029443,1579776230
019170,신풍제약,6140,6100,-40,-0.65,185814,1142774670
019175,신풍제약우,5570,5570,0,0.0,2871,15907920
002870,신풍제지,1315,1320,5,0.38,23871,31444495
005450,신한,4945,4945,0,0.0,0,0
293940,신한알파리츠,7920,8000,80,1.01,128752,1027647190
055550,신한지주,42200,42250,50,0.12,799147,33673165250
001770,신화실업,24650,24750,100,0.41,15945,396615600
004080,신흥,9510,9500,-10,-0.11,1215,11475700
102280,쌍방울,1075,1070,-5,-0.47,1151224,1228839290
003410,쌍용양회,6230,6180,-50,-0.8,467461,2896780190
003415,쌍용양회우,7780,8000,220,2.83,62387,492067640
003620,쌍용차,3145,3105,-40,-1.27,150258,468169745
004770,써니전자,3865,4070,205,5.3,24018032,98374058285
004920,씨아이테크,460,470,10,2.17,156724,72269062
112610,씨에스윈드,31150,30800,-350,-1.12,36527,1135466900
008700,아남전자,2465,2525,60,2.43,1387225,3486180710
002790,아모레G,63600,64400,800,1.26,95288,6101781600
002795,아모레G우,24850,25100,250,1.01,4108,103431150
090430,아모레퍼시픽,138500,138500,0,0.0,181118,25085567000
090435,아모레퍼시픽우,75000,74500,-500,-0.67,1906,141863900
002030,아세아,120000,121000,1000,0.83,702,83919000
183190,아세아시멘트,95900,95300,-600,-0.63,2156,206861300
002310,아세아제지,30950,31000,50,0.16,26245,816765600
267850,아시아나IDT,17800,17750,-50,-0.28,70537,1260644650
020560,아시아나항공,5370,5340,-30,-0.56,864247,4629689820
122900,아이마켓코리아,11500,11250,-250,-2.17,88310,995066800
010780,아이에스동서,31100,30750,-350,-1.13,37115,1151443300
033660,아주캐피탈,10950,11250,300,2.74,49122,543482650
001780,알루코,2515,2510,-5,-0.2,145460,364555320
018250,애경산업,31900,31600,-300,-0.94,67526,2146994450
161000,애경유화,7880,7790,-90,-1.14,133671,1043024840
011090,에넥스,1150,1140,-10,-0.87,139904,159441520
005850,에스엘,21900,22550,650,2.97,49911,1111415950
012750,에스원,96800,96700,-100,-0.1,47136,4564310000
023960,에쓰씨엔지니어링,1540,1590,50,3.25,128812,202496490
298690,에어부산,6200,6170,-30,-0.48,315061,1953553740
140910,에이리츠,6530,6480,-50,-0.77,4633,30005720
078520,에이블씨엔씨,11650,11500,-150,-1.29,59284,682597150
015260,에이엔피,384,383,-1,-0.26,238741,92293678
007460,에이프로젠KIC,2170,2165,-5,-0.23,1170180,2548462445
003060,에이프로젠제약,811,795,-16,-1.97,1071031,857144847
036570,엔씨소프트,524000,525000,1000,0.19,43304,22816351044
138250,엔에스쇼핑,10550,10250,-300,-2.84,25470,262963800
085310,엔케이,1300,1300,0,0.0,211864,274235675
009810,엔케이물산,915,880,-35,-3.83,7282848,6493990023
900140,엘브이엠씨홀딩스,3280,3270,-10,-0.3,89026,292919155
014440,영보화학,3405,3420,15,0.44,29701,101303025
111770,영원무역,35250,34900,-350,-0.99,84488,2957951300
009970,영원무역홀딩스,48000,48000,0,0.0,2832,135868200
003520,영진약품,4860,4850,-10,-0.21,414047,2014209870
000670,영풍,603000,600000,-3000,-0.5,702,422169000
006740,영풍제지,3015,3015,0,0.0,23761,71581275
012280,영화금속,1450,1455,5,0.34,160472,231867355
012160,영흥철강,1205,1200,-5,-0.41,147297,176760220
015360,예스코홀딩스,37300,37500,200,0.54,488,18295350
007310,오뚜기,593000,584000,-9000,-1.52,3554,2083666000
079440,오렌지라이프,27300,26950,-350,-1.28,111555,3015968100
002630,오리엔트바이오,460,453,-7,-1.52,3872293,1785709455
271560,오리온,99900,99100,-800,-0.8,44508,4419712800
001800,오리온홀딩스,16200,16050,-150,-0.93,29238,472346400
070960,용평리조트,7900,7850,-50,-0.63,513355,4044237620
316140,우리금융지주,12550,12400,-150,-1.2,929961,11553261150
004720,우리들제약,6270,6240,-30,-0.48,16908,105357940
118000,우리들휴브레인,2420,2370,-50,-2.07,83130,198342665
010050,우리종금,701,704,3,0.43,1012932,715841731
006980,우성사료,4465,3990,-475,-10.64,7112545,29451810895
017370,우신시스템,4880,4915,35,0.72,20199,98442450
105840,우진,5900,5840,-60,-1.02,410449,2412636560
010400,우진아이엔에스,8490,8450,-40,-0.47,13001,110326410
049800,우진플라임,4030,4055,25,0.62,20275,82413950
016880,웅진,1335,1300,-35,-2.62,470633,613441010
095720,웅진씽크빅,2435,2380,-55,-2.26,216602,520893535
103130,웅진에너지,914,914,0,0.0,0,0
021240,웅진코웨이,80500,79500,-1000,-1.24,134893,10770239400
005820,원림,17950,17900,-50,-0.28,108,1937750
010600,웰바이오텍,3105,2925,-180,-5.8,984341,2912716510
008600,윌비스,1145,1170,25,2.18,550039,639973810
033270,유나이티드제약,20200,20000,-200,-0.99,38351,774056000
014830,유니드,46150,46150,0,0.0,5710,263718050
000910,유니온,4950,4860,-90,-1.82,723333,3508572040
047400,유니온머티리얼,2690,2670,-20,-0.74,424440,1136555660
011330,유니켐,1840,1915,75,4.08,1263626,2400983710
077500,유니퀘스트,6510,6580,70,1.08,113869,751264770
002920,유성기업,2800,2790,-10,-0.36,20455,57200815
000700,유수홀딩스,7230,7290,60,0.83,13153,95375300
003470,유안타증권,2800,2785,-15,-0.54,174133,486395155
003475,유안타증권우,2060,2045,-15,-0.73,3322,6844545
011690,유양디앤유,5980,6000,20,0.33,189859,1139414150
072130,유엔젤,3670,3775,105,2.86,56998,214100570
000220,유유제약,10450,10700,250,2.39,563444,6371975250
000225,유유제약1우,6590,6660,70,1.06,49679,341680470
000227,유유제약2우B,18250,18700,450,2.47,13922,263268550
001200,유진투자증권,2290,2275,-15,-0.66,290249,663639280
000100,유한양행,230500,230000,-500,-0.22,36345,8413551000
000105,유한양행우,205500,206000,500,0.24,234,48191000
003460,유화증권,12300,12150,-150,-1.22,13049,159337250
003465,유화증권우,12850,13000,150,1.17,4073,51730550
008730,율촌화학,15250,15200,-50,-0.33,155811,2381357800
008250,이건산업,8490,9000,510,6.01,289952,2593280680
025820,이구산업,1795,1785,-10,-0.56,56196,100561275
214320,이노션,63300,63700,400,0.63,41780,2644963500
088260,이리츠코크렙,6210,6280,70,1.13,120378,753501380
139480,이마트,115500,113500,-2000,-1.73,160288,18375645000
007660,이수페타시스,4650,4570,-80,-1.72,535873,2479089665
005950,이수화학,9930,9950,20,0.2,14495,144331020
015020,이스타코,589,592,3,0.51,24282,14314632
093230,이아이디,304,306,2,0.66,8725794,2675710542
102460,이연제약,14450,14400,-50,-0.35,7567,108750000
084680,이월드,3410,3385,-25,-0.73,786898,2676372225
000760,이화산업,15700,15700,0,0.0,761,11770150
014990,인디에프,3735,3700,-35,-0.94,2068320,7695504745
006490,인스코비,2925,2930,5,0.17,685585,2012478165
023800,인지컨트롤스,5390,5350,-40,-0.74,66162,357042620
034590,인천도시가스,29250,29250,0,0.0,721,21010500
129260,인터지스,2210,2205,-5,-0.23,54784,120444870
023810,인팩,4060,4045,-15,-0.37,6742,27059680
249420,일동제약,16750,16550,-200,-1.19,19504,324178200
000230,일동홀딩스,11250,11300,50,0.44,3498,39371850
013360,일성건설,1610,1655,45,2.8,1001492,1616278915
003120,일성신약,83600,83700,100,0.12,475,39730300
003200,일신방직,81400,81500,100,0.12,1549,125182300
007110,일신석재,3730,3805,75,2.01,10076082,38013310870
007570,일양약품,21700,21550,-150,-0.69,29159,636740300
007575,일양약품우,16750,17050,300,1.79,723,12299500
008500,일정실업,18500,18500,0,0.0,1665,30786050
081000,일진다이아,33350,33150,-200,-0.6,186335,6242566800
020760,일진디스플,3940,4010,70,1.78,112292,449930635
020150,일진머티리얼즈,41150,40750,-400,-0.97,290518,11991322700
103590,일진전기,3310,3420,110,3.32,129849,440849490
015860,일진홀딩스,5100,5210,110,2.16,900110,4670442680
226320,잇츠한불,19800,19650,-150,-0.76,12686,250806400
033240,자화전자,10200,10100,-100,-0.98,151695,1529780570
000950,전방,16700,16600,-100,-0.6,312,5142600
194370,제이에스코퍼레이션,14700,14700,0,0.0,13227,195902300
025620,제이준코스메틱,4480,4450,-30,-0.67,165429,737477885
030000,제일기획,24750,24750,0,0.0,156536,3863505750
271980,제일약품,32250,32100,-150,-0.47,10632,344052650
001560,제일연마,6460,6400,-60,-0.93,4325,27605850
002620,제일파마홀딩스,15950,15900,-50,-0.31,4066,65059850
006220,제주은행,4360,4360,0,0.0,4797,20940605
089590,제주항공,24900,24600,-300,-1.2,92471,2281770050
004910,조광페인트,6290,6300,10,0.16,8590,54022210
004700,조광피혁,38050,38100,50,0.13,799,30360700
001550,조비,21650,21750,100,0.46,68645,1479450850
000480,조선내화,87900,87900,0,0.0,2179,190715400
120030,조선선재,90600,90000,-600,-0.66,1424,127672400
018470,조일알미늄,758,786,28,3.69,77796,59961196
002600,조흥,156000,154500,-1500,-0.96,35,5441000
185750,종근당,86100,85200,-900,-1.05,10148,867448100
063160,종근당바이오,30200,29550,-650,-2.15,65754,1947931050
001630,종근당홀딩스,98900,97700,-1200,-1.21,49534,4945056900
044380,주연테크,406,408,2,0.49,475693,195033774
013870,지엠비코리아,5450,5450,0,0.0,59857,326656470
071320,지역난방공사,50500,50500,0,0.0,12487,629448300
010580,지코,878,870,-8,-0.91,263694,227191435
035000,지투알,7170,7200,30,0.42,3904,27951050
088790,진도,3760,3770,10,0.27,14565,55113280
003780,진양산업,3375,3395,20,0.59,49221,166089745
010640,진양폴리,2650,2640,-10,-0.38,16107,42735260
100250,진양홀딩스,2520,2520,0,0.0,16188,40703535
051630,진양화학,4860,4865,5,0.1,94538,461457330
272450,진에어,15800,15700,-100,-0.63,170656,2712462550
011000,진원생명과학,4515,4355,-160,-3.54,266712,1170262370
002780,진흥기업,2030,2015,-15,-0.74,77689,155558145
002787,진흥기업2우B,12600,12650,50,0.4,620,7896850
002785,진흥기업우B,5080,5080,0,0.0,6022,30523940
009310,참엔지니어링,1230,1220,-10,-0.81,231086,281426230
000650,천일고속,70700,70900,200,0.28,255,18061300
012600,청호컴넷,2910,2920,10,0.34,37705,109762045
033250,체시스,2800,3210,410,14.64,16507362,55267612510
001140,카리스국보,5490,5500,10,0.18,1002484,5572229410
035720,카카오,137000,135500,-1500,-1.09,242822,33038722000
006380,카프로,3735,3700,-35,-0.94,48821,182050165
109070,컨버즈,3260,3260,0,0.0,0,0
001620,케이비아이동국실업,803,804,1,0.12,40223,32204647
029460,케이씨,13250,13450,200,1.51,25733,347379800
281820,케이씨텍,18200,18600,400,2.2,278647,5136968350
145270,케이탑리츠,923,919,-4,-0.43,154129,141260773
007815,코리아써우,2425,2425,0,0.0,330,799490
007810,코리아써키트,5170,5200,30,0.58,51824,269759080
00781K,코리아써키트2우B,3960,3955,-5,-0.13,10,39570
152330,코리아오토글라스,17300,17350,50,0.29,25304,441716350
003690,코리안리,8200,8120,-80,-0.98,140719,1146046380
192820,코스맥스,74400,74700,300,0.4,79555,5940066800
044820,코스맥스비티아이,14900,14850,-50,-0.34,6885,101808650
005070,코스모신소재,9410,9450,40,0.43,301623,2913413030
005420,코스모화학,7350,7420,70,0.95,165432,1237047940
071950,코아스,1515,1505,-10,-0.66,613844,943889160
002020,코오롱,16900,16700,-200,-1.18,36662,615803100
003070,코오롱글로벌,9240,9240,0,0.0,18594,172125920
003075,코오롱글로벌우,17500,17750,250,1.43,1499,26295950
144620,코오롱머티리얼,1570,1575,5,0.32,81647,128585370
002025,코오롱우,10850,10650,-200,-1.84,7079,75944900
120110,코오롱인더,42500,42200,-300,-0.71,55142,2339380050
120115,코오롱인더우,20600,20500,-100,-0.49,6180,127190050
138490,코오롱플라스틱,5300,5330,30,0.57,80806,431119630
031820,콤텍시스템,1470,1480,10,0.68,540814,804444115
192400,쿠쿠홀딩스,108500,108000,-500,-0.46,3124,338296000
284740,쿠쿠홈시스,41100,41100,0,0.0,18919,777549250
015590,큐로,784,784,0,0.0,263463,206552294
264900,크라운제과,8900,8790,-110,-1.24,11520,101585950
26490K,크라운제과우,8490,8470,-20,-0.24,15403,131054050
005740,크라운해태홀딩스,11700,11600,-100,-0.85,32900,379965800
005745,크라운해태홀딩스우,14400,14550,150,1.04,11105,161332650
020120,키다리스튜디오,4595,4510,-85,-1.85,420997,1921351555
039490,키움증권,70000,68700,-1300,-1.86,55561,3833438800
012170,키위미디어그룹,150,150,0,0.0,0,0
015890,태경산업,6100,5940,-160,-2.62,325295,1935883840
006890,태경화학,5420,5340,-80,-1.48,168859,900741710
003240,태광산업,1135000,1136000,1000,0.09,322,366737000
011280,태림포장,6030,5920,-110,-1.82,682098,4090555300
004100,태양금속,1095,1105,10,0.91,133129,146335875
004105,태양금속우,3110,3095,-15,-0.48,9413,29090350
009410,태영건설,12900,13250,350,2.71,293476,3894288350
009415,태영건설우,7440,7580,140,1.88,64849,492660610
001420,태원물산,4445,4400,-45,-1.01,22580,98698065
007980,태평양물산,2815,2855,40,1.42,86825,249024505
055490,테이팩스,23600,22900,-700,-2.97,55674,1286762850
078000,텔코웨어,14150,14000,-150,-1.06,16923,236609100
214420,토니모리,9860,9710,-150,-1.52,51724,506335120
019180,티에이치엔,4445,4455,10,0.22,117543,522115690
091810,티웨이항공,5150,5150,0,0.0,163790,848424190
004870,티웨이홀딩스,1850,1855,5,0.27,974958,1798798895
005690,파미셀,8110,8120,10,0.12,400147,3260187660
036580,팜스코,5370,5170,-200,-3.72,435181,2290445820
028670,팬오션,4805,4705,-100,-2.08,1140888,5404377035
010820,퍼스텍,2270,2235,-35,-1.54,580440,1339759260
016800,퍼시스,31300,31250,-50,-0.16,853,26513200
001020,페이퍼코리아,722,726,4,0.55,85987,61917508
090080,평화산업,1465,1455,-10,-0.68,319883,466872560
010770,평화홀딩스,4355,4350,-5,-0.11,26964,116760435
058430,포스코강판,17900,17650,-250,-1.4,4661,82843400
047050,포스코인터내셔널,19850,19550,-300,-1.51,189881,3713304200
003670,포스코케미칼,50800,49800,-1000,-1.97,321270,16153126750
007630,폴루스바이오팜,1225,1225,0,0.0,0,0
017810,풀무원,9300,9390,90,0.97,92428,868139990
103140,풍산,23200,23100,-100,-0.43,39922,918612000
005810,풍산홀딩스,36000,36050,50,0.14,1205,43154550
033180,필룩스,4390,4300,-90,-2.05,2600914,11488330805
086790,하나금융지주,35500,35450,-50,-0.14,801169,28437030650
099340,하나니켈1호,447,446,-1,-0.22,104118,46736409
099350,하나니켈2호,1270,1265,-5,-0.39,46794,58812435
293480,하나제약,23850,23750,-100,-0.42,30254,721291950
039130,하나투어,45150,44800,-350,-0.78,38895,1750506750
172580,하이골드12호,2755,2750,-5,-0.18,13063,35886335
153360,하이골드3호,1765,1755,-10,-0.57,28502,50187305
159650,하이골드8호,1785,1780,-5,-0.28,31625,55761640
071090,하이스틸,22450,22550,100,0.45,3226,72409850
019490,하이트론,3730,3770,40,1.07,13275,49817450
000080,하이트진로,26750,26800,50,0.19,295110,7905781050
000087,하이트진로2우B,17900,17900,0,0.0,934,16680250
000140,하이트진로홀딩스,11450,11550,100,0.87,73806,845042950
000145,하이트진로홀딩스우,22050,22000,-50,-0.23,35632,790779100
152550,한국ANKOR유전,1750,1750,0,0.0,153,268325
036460,한국가스공사,41450,41300,-150,-0.36,148791,6122715600
005430,한국공항,40450,40550,100,0.25,1917,77793600
071050,한국금융지주,79500,77100,-2400,-3.02,158107,12278202300
071055,한국금융지주우,45900,44950,-950,-2.07,8704,392666450
010040,한국내화,5770,5720,-50,-0.87,451414,2570639250
025540,한국단자,47350,46850,-500,-1.06,10571,497619400
004090,한국석유,118500,116500,-2000,-1.69,20550,2395859500
002960,한국쉘석유,338000,337500,-500,-0.15,805,272081500
123890,한국자산신탁,3425,3425,0,0.0,99605,340881855
015760,한국전력,25300,25400,100,0.4,1000818,25391796350
006200,한국전자홀딩스,756,758,2,0.26,29569,22398344
002300,한국제지,17450,17600,150,0.86,5247,91936050
009540,한국조선해양,124000,121500,-2500,-2.02,150889,18503895500
023350,한국종합기술,4375,4475,100,2.29,175784,794755885
025890,한국주강,1710,1685,-25,-1.46,39608,66424635
000970,한국주철관,11400,11350,-50,-0.44,70533,800207500
104700,한국철강,5200,5150,-50,-0.96,27743,142453740
017960,한국카본,8410,8560,150,1.78,645710,5573763300
161890,한국콜마,44900,44550,-350,-0.78,139369,6246281100
024720,한국콜마홀딩스,21700,21700,0,0.0,40933,890365950
161390,한국타이어앤테크놀로지,31400,30700,-700,-2.23,247765,7670214350
000240,한국테크놀로지그룹,14350,14300,-50,-0.35,45538,654220000
034830,한국토지신탁,2135,2130,-5,-0.23,413419,881716125
007280,한국특수형강,1465,1485,20,1.37,8763,12914735
168490,한국패러랠,2240,2245,5,0.22,14147,31682620
010100,한국프랜지,2470,2985,515,20.85,56020655,162421970605
047810,한국항공우주,41250,41150,-100,-0.24,276721,11357063750
123690,한국화장품,8410,8500,90,1.07,108348,922481990
003350,한국화장품제조,27650,27700,50,0.18,19050,527171550
011500,한농화성,4000,3995,-5,-0.13,7397,29554550
002390,한독,21950,21500,-450,-2.05,38441,836934050
014790,한라,3550,3495,-55,-1.55,170587,601594920
060980,한라홀딩스,43250,42500,-750,-1.73,8852,378168150
053690,한미글로벌,9360,9420,60,0.64,34027,318432060
042700,한미반도체,6260,6280,20,0.32,99010,632035460
008930,한미사이언스,44650,43350,-1300,-2.91,139387,6087712050
128940,한미약품,300000,295500,-4500,-1.5,42553,12669775000
009240,한샘,64000,63300,-700,-1.09,86316,5493088000
020000,한섬,30350,30450,100,0.33,31753,967840500
003680,한성기업,6470,6460,-10,-0.15,190554,1233424530
105630,한세실업,18900,18850,-50,-0.26,96305,1819928150
069640,한세엠케이,4560,4575,15,0.33,22638,103225855
016450,한세예스24홀딩스,7380,7330,-50,-0.68,55556,405846240
010420,한솔PNS,1785,1805,20,1.12,3494373,6630763975
009180,한솔로지스틱스,1315,1325,10,0.76,171600,226581250
213500,한솔제지,15900,16050,150,0.94,75246,1208207900
014680,한솔케미칼,79000,80000,1000,1.27,39332,3157940800
004710,한솔테크닉스,6460,6620,160,2.48,203139,1344668160
004150,한솔홀딩스,4435,4425,-10,-0.23,13353,59092725
025750,한솔홈데코,1270,1340,70,5.51,1629324,2159525860
004960,한신공영,15750,16000,250,1.59,4554,72353700
011700,한신기계,1815,1810,-5,-0.28,1465181,2696939790
001750,한양증권,7420,7470,50,0.67,9017,67293310
001755,한양증권우,8110,8240,130,1.6,86,700820
018880,한온시스템,12000,12200,200,1.67,621101,7548541400
009420,한올바이오파마,28550,28350,-200,-0.7,137817,3933548550
014130,한익스프레스,5800,5810,10,0.17,313154,1798138850
300720,한일시멘트,106000,104500,-1500,-1.42,2971,312453000
002220,한일철강,2185,2185,0,0.0,6264,13618745
006390,한일현대시멘트,39450,38950,-500,-1.27,27762,1082308900
003300,한일홀딩스,48300,48550,250,0.52,2861,139506550
051600,한전KPS,34000,34000,0,0.0,126518,4306462400
052690,한전기술,22750,22400,-350,-1.54,330394,7511061700
130660,한전산업,3450,3420,-30,-0.87,43086,147600610
002320,한진,31300,31300,0,0.0,65050,2070125100
097230,한진중공업,4845,4845,0,0.0,70419,342346625
003480,한진중공업홀딩스,2975,2915,-60,-2.02,7948,23332030
180640,한진칼,30100,29850,-250,-0.83,274052,8259127200
18064K,한진칼우,33000,32950,-50,-0.15,5284,173890350
005110,한창,4240,4240,0,0.0,30845293,134853080550
009460,한창제지,3060,3130,70,2.29,2444399,7633625905
000880,한화,26000,25700,-300,-1.15,147543,3823133900
00088K,한화3우B,14250,14100,-150,-1.05,42979,610221950
027390,한화갤러리아타임월드,18800,18650,-150,-0.8,9434,176249700
088350,한화생명,2595,2520,-75,-2.89,2065941,5264200725
000370,한화손해보험,3335,3305,-30,-0.9,99540,329941535
012450,한화에어로스페이스,41600,42250,650,1.56,275117,11580370950
000885,한화우,25150,25200,50,0.2,15300,389207700
009830,한화케미칼,18500,18300,-200,-1.08,280774,5157983850
009835,한화케미칼우,11800,11950,150,1.27,16763,200164000
003530,한화투자증권,2245,2200,-45,-2.0,501350,1106978210
003535,한화투자증권우,2190,2170,-20,-0.91,4760,10360820
195870,해성디에스,13200,13200,0,0.0,44481,584497850
101530,해태제과식품,7960,8000,40,0.5,15093,120703090
143210,핸즈코퍼레이션,7010,7150,140,2.0,25979,184390160
000720,현대건설,47800,46850,-950,-1.99,768002,36163065050
267270,현대건설기계,31450,31350,-100,-0.32,77211,2443603800
000725,현대건설우,173500,176500,3000,1.73,900,156238000
005440,현대그린푸드,12000,11900,-100,-0.83,52930,631422600
086280,현대글로비스,152000,149500,-2500,-1.64,45210,6795113000
064350,현대로템,20250,20050,-200,-0.99,470868,9504566450
079430,현대리바트,14300,13950,-350,-2.45,48187,678086100
012330,현대모비스,249500,245500,-4000,-1.6,169654,41683905250
010620,현대미포조선,45400,45300,-100,-0.22,93003,4234966100
069960,현대백화점,78900,78700,-200,-0.25,40947,3211220700
004560,현대비앤지스틸,9310,9280,-30,-0.32,6959,64516550
004565,현대비앤지스틸우,61600,61200,-400,-0.65,724,44791900
011760,현대상사,20950,20500,-450,-2.15,119525,2468810200
011200,현대상선,3740,3740,0,0.0,319649,1192716695
004310,현대약품,4940,5000,60,1.21,2286332,11540330750
126560,현대에이치씨엔,3750,3840,90,2.4,365710,1438128030
017800,현대엘리베이,91200,91500,300,0.33,269321,24599174000
307950,현대오토에버,52300,54000,1700,3.25,55572,2972045500
011210,현대위아,48850,48650,-200,-0.41,83428,4065677800
267260,현대일렉트릭,11500,11250,-250,-2.17,190167,2168691550
004020,현대제철,40500,40100,-400,-0.99,176220,7062052700
267250,현대중공업지주,354500,356000,1500,0.42,22613,7993011000
005380,현대차,127500,129000,1500,1.18,618746,79245661750
005387,현대차2우B,86000,85200,-800,-0.93,21243,1809451700
005389,현대차3우B,73500,73700,200,0.27,2022,148984200
005385,현대차우,75100,75300,200,0.27,12074,907742400
001500,현대차증권,10850,10750,-100,-0.92,32770,354445050
227840,현대코퍼레이션홀딩스,12850,13400,550,4.28,233249,3142979550
001450,현대해상,26000,25550,-450,-1.73,365560,9308002250
057050,현대홈쇼핑,94600,94900,300,0.32,12322,1163282900
093240,형지엘리트,1505,1485,-20,-1.33,255695,383755720
003010,혜인,5410,5410,0,0.0,97972,529135790
111110,호전실업,13200,13000,-200,-1.52,7865,102754750
008770,호텔신라,85900,85900,0,0.0,184088,15808554500
008775,호텔신라우,50400,50400,0,0.0,8148,410495600
002460,화성산업,12500,12450,-50,-0.4,33160,412612350
013520,화승알앤에이,2065,2095,30,1.45,138282,287739765
241590,화승엔터프라이즈,14150,14150,0,0.0,73329,1033964200
006060,화승인더,9790,9650,-140,-1.43,159465,1539997450
010690,화신,3180,3000,-180,-5.66,139653,424006225
133820,화인베스틸,3515,3515,0,0.0,427527,1507937005
010660,화천기계,3730,3810,80,2.14,2817316,10739426140
000850,화천기공,40000,40000,0,0.0,4774,190725950
016580,환인제약,16200,15900,-300,-1.85,30719,491979150
032560,황금에스티,8230,8220,-10,-0.12,51954,430120260
004800,효성,87300,86800,-500,-0.57,49558,4309959300
094280,효성ITX,9750,9800,50,0.51,10194,99268540
298040,효성중공업,33950,34200,250,0.74,33926,1151134650
298050,효성첨단소재,127500,129500,2000,1.57,36472,4726458500
298020,효성티앤씨,153500,151500,-2000,-1.3,15758,2399858500
298000,효성화학,161000,160000,-1000,-0.62,4594,734939500
093370,후성,9160,9290,130,1.42,1945553,18080981790
081660,휠라코리아,60700,60000,-700,-1.15,616885,37335589600
005870,휴니드,7600,7540,-60,-0.79,30998,235488050
079980,휴비스,6290,6380,90,1.43,67054,425369840
005010,휴스틸,10750,10800,50,0.47,8815,95144250
069260,휴켐스,21450,21700,250,1.17,49863,1078966850
000540,흥국화재,3400,3405,5,0.15,21991,75476520
000547,흥국화재2우B,20450,20350,-100,-0.49,740,14837050
000545,흥국화재우,5100,5100,0,0.0,961,4948150
003280,흥아해운,481,480,-1,-0.21,200295,95832808
