티커,종목명,시가,종가,변동폭,등락률,거래량,거래대금
095570,AJ네트웍스,3060,3150,90,2.94,91306,288113930
006840,AK홀딩스,17300,17000,-300,-1.73,16250,277588450
027410,BGF,4150,4090,-60,-1.45,192281,787899750
282330,BGF리테일,126000,124500,-1500,-1.19,23206,2894757000
138930,BNK금융지주,5290,5300,10,0.19,1121356,5848559710
001460,BYC,238500,242500,4000,1.68,500,120133000
001465,BYC우,131000,130000,-1000,-0.76,642,83865000
001040,CJ,84600,83400,-1200,-1.42,69713,5781287400
079160,CJCGV,21650,21900,250,1.15,799464,17151121700
00104K,CJ4우전환,58800,58000,-800,-1.36,7730,445829000
000120,CJ대한통운,149000,150000,1000,0.67,43631,6484290500
011150,CJ씨푸드,4365,4175,-190,-4.35,11022789,48259104725
011155,CJ씨푸드1우,49100,48100,-1000,-2.04,35719,1757164650
001045,CJ우,47750,47100,-650,-1.36,4033,189760050
097950,CJ제일제당,416500,416500,0,0.0,70882,29337564000
097955,CJ제일제당우,171000,170000,-1000,-0.58,11726,1986657000
000590,CS홀딩스,53000,54100,1100,2.08,4702,251602500
012030,DB,692,693,1,0.14,450536,310891666
016610,DB금융투자,3760,3740,-20,-0.53,86718,322680975
005830,DB손해보험,45700,44950,-750,-1.64,155012,6950117000
000990,DB하이텍,36100,35550,-550,-1.52,936188,33148715600
000995,DB하이텍1우,68200,66900,-1300,-1.91,3101,205227000
139130,DGB금융지주,5350,5340,-10,-0.19,470569,2491651040
001530,DI동일,93300,91900,-1400,-1.5,17964,1649433800
004840,DRB동일,7860,8330,470,5.98,657746,5446512910
155660,DSR,4000,4040,40,1.0,64825,258593550
069730,DSR제강,4200,4275,75,1.79,190757,811468700
017940,E1,41300,43600,2300,5.57,54941,2335946850
007700,FF,98000,97800,-200,-0.2,59038,5697488800
114090,GKL,12400,12150,-250,-2.02,221070,2683283850
078930,GS,33200,33200,0,0.0,255479,8393920450
006360,GS건설,25600,25150,-450,-1.76,506378,12740281200
001250,GS글로벌,1655,1635,-20,-1.21,293373,480384515
007070,GS리테일,33000,32250,-750,-2.27,297515,9588963200
078935,GS우,29150,29100,-50,-0.17,5269,152383350
012630,HDC,9900,10800,900,9.09,1621135,17458855100
039570,HDC아이콘트롤스,8260,8470,210,2.54,70494,594056580
089470,HDC현대EP,4860,4840,-20,-0.41,132744,639888540
294870,HDC현대산업개발,20700,21900,1200,5.8,1539552,33415789700
011200,HMM,5700,5580,-120,-2.11,3893766,21705949840
082740,HSD엔진,4820,4900,80,1.66,662565,3189101520
003560,IHQ,1420,1430,10,0.7,671440,955648075
175330,JB금융지주,4365,4345,-20,-0.46,383190,1657535730
234080,JW생명과학,19500,19600,100,0.51,115659,2252567800
001060,JW중외제약,39050,40000,950,2.43,570569,22508265150
001067,JW중외제약2우B,115000,129000,14000,12.17,14466,1778107000
001065,JW중외제약우,85300,86400,1100,1.29,30377,2615919500
096760,JW홀딩스,5180,5450,270,5.21,358003,1906289890
105560,KB금융,37950,37100,-850,-2.24,2118673,78534297000
002380,KCC,145000,142000,-3000,-2.07,50361,7171107000
009070,KCTC,2160,2175,15,0.69,76892,165110205
009440,KC그린홀딩스,3605,3595,-10,-0.28,97438,349048840
119650,KC코트렐,5380,5350,-30,-0.56,193557,1024217150
092220,KEC,770,765,-5,-0.65,264333,201940379
016380,KG동부제철,12350,12100,-250,-2.02,67527,813314450
016385,KG동부제철우,118000,116500,-1500,-1.27,3083,357572500
001390,KG케미칼,23350,23750,400,1.71,847977,20233068650
001940,KISCO홀딩스,11350,11400,50,0.44,8596,97314700
025000,KPX케미칼,46600,46950,350,0.75,5482,256443100
092230,KPX홀딩스,41650,41650,0,0.0,7295,303407900
000040,KR모터스,705,703,-2,-0.28,654958,455367881
044450,KSS해운,8370,8280,-90,-1.08,26457,218648040
030200,KT,24300,24000,-300,-1.23,1039045,24989325550
033780,KTG,85400,85400,0,0.0,370504,31509462900
030210,KTB투자증권,2710,2675,-35,-1.29,296524,787007620
058850,KTcs,2055,2050,-5,-0.24,2640301,5479282460
058860,KTis,2580,2620,40,1.55,2067005,5360469325
093050,LF,13200,13150,-50,-0.38,121736,1580498400
003550,LG,87800,88100,300,0.34,303647,26605664900
034220,LG디스플레이,15150,15350,200,1.32,8143707,125018499450
001120,LG상사,14850,14750,-100,-0.67,176914,2610131500
051900,LG생활건강,1539000,1517000,-22000,-1.43,42308,63881058000
051905,LG생활건강우,734000,733000,-1000,-0.14,4235,3075163000
003555,LG우,56100,56500,400,0.71,22779,1283203700
032640,LG유플러스,12400,12350,-50,-0.4,2426787,29940037450
011070,LG이노텍,152000,149500,-2500,-1.64,177660,26449677500
066570,LG전자,90300,87900,-2400,-2.66,1571474,138189965600
066575,LG전자우,34900,33900,-1000,-2.87,140629,4803123300
108670,LG하우시스,58500,58300,-200,-0.34,35853,2088888500
108675,LG하우시스우,26750,27300,550,2.06,2855,77133600
037560,LG헬로비전,3960,4000,40,1.01,198566,790864870
051910,LG화학,713000,757000,44000,6.17,1094918,810225261000
051915,LG화학우,373000,390500,17500,4.69,183692,70222020000
079550,LIG넥스원,33700,32900,-800,-2.37,94766,3130698750
006260,LS,41200,41300,100,0.24,119216,4896357900
010120,LSELECTRIC,53500,54500,1000,1.87,113616,6099299300
000680,LS네트웍스,2070,2060,-10,-0.48,61163,125813255
229640,LS전선아시아,6830,6710,-120,-1.76,61668,414438280
023150,MH에탄올,9470,9320,-150,-1.58,890551,8459062600
035420,NAVER,325000,334000,9000,2.77,1155853,385114088000
181710,NHN,74800,73900,-900,-1.2,141234,10402073700
005940,NH투자증권,9390,9240,-150,-1.6,1077977,9950665310
005945,NH투자증권우,7710,7620,-90,-1.17,98594,751340680
338100,NH프라임리츠,4360,4380,20,0.46,23258,101664065
034310,NICE,19300,18800,-500,-2.59,44467,839315350
008260,NI스틸,2130,2130,0,0.0,108534,229664620
004250,NPC,3060,3070,10,0.33,61484,185777995
004255,NPC우,2235,2230,-5,-0.22,14731,32524280
010060,OCI,68200,68700,500,0.73,763158,51839590700
005490,POSCO,200500,193000,-7500,-3.74,512515,99191464500
100840,STC,15300,15100,-200,-1.31,48095,726170450
064960,ST모티브,57000,56200,-800,-1.4,74404,4161233500
003570,ST중공업,4975,4985,10,0.2,45210,225932755
036530,ST홀딩스,15350,15050,-300,-1.95,10559,161218050
010950,S-Oil,59700,58600,-1100,-1.84,399421,23463663300
010955,S-Oil우,34000,33550,-450,-1.32,14157,476153950
034120,SBS,15600,15600,0,0.0,40672,629332500
101060,SBS미디어홀딩스,1865,1900,35,1.88,400754,772151090
004060,SG세계물산,592,597,5,0.84,1117142,656128102
001380,SG충방,1925,1915,-10,-0.52,1915715,3698318295
002360,SH에너지화학,762,761,-1,-0.13,334872,252644653
009160,SIMPAC,2340,2320,-20,-0.85,34232,78754275
123700,SJM,2455,2465,10,0.41,8530,21046730
025530,SJM홀딩스,2465,2475,10,0.41,4229,10447940
034730,SK,222000,218500,-3500,-1.58,192270,42014089500
011790,SKC,94800,97000,2200,2.32,610472,58032241500
018670,SK가스,90400,89600,-800,-0.88,13798,1233991600
001740,SK네트웍스,5170,5140,-30,-0.58,480529,2460606630
001745,SK네트웍스우,165000,166000,1000,0.61,2221,365993000
006120,SK디스커버리,72900,70800,-2100,-2.88,249063,17662811800
006125,SK디스커버리우,70200,68000,-2200,-3.13,92568,6319394300
210980,SK디앤디,36400,40250,3850,10.58,787504,30808655550
068400,SK렌터카,8660,8650,-10,-0.12,33821,291719780
326030,SK바이오팜,172000,172000,0,0.0,198839,34336709000
03473K,SK우,216500,214500,-2000,-0.92,12386,2645711000
096770,SK이노베이션,163500,164000,500,0.31,1480461,237698534000
096775,SK이노베이션우,139000,139000,0,0.0,65978,9120448000
001510,SK증권,780,762,-18,-2.31,5177481,3956315732
001515,SK증권우,5500,5450,-50,-0.91,97891,535080990
285130,SK케미칼,416500,414000,-2500,-0.6,382648,157314165500
28513K,SK케미칼우,198500,194000,-4500,-2.27,62062,12007754000
017670,SK텔레콤,247500,248500,1000,0.4,494139,122600002500
000660,SK하이닉스,77000,78800,1800,2.34,4741965,371645530948
005610,SPC삼립,61500,61000,-500,-0.81,5476,333927500
011810,STX,5080,5100,20,0.39,34930,177548560
077970,STX엔진,5490,5380,-110,-2.0,8074,43583560
071970,STX중공업,2225,2230,5,0.22,98597,218431970
084870,TBH글로벌,1500,1530,30,2.0,105826,158095660
002710,TCC스틸,3535,3420,-115,-3.25,2384451,8141408820
024070,WISCOM,2240,2260,20,0.89,74103,167762955
037270,YGPLUS,4210,4950,740,17.58,10723915,48491347215
000500,가온전선,18400,18400,0,0.0,24849,454105950
000860,강남제비스코,14850,14850,0,0.0,6637,97784700
035250,강원랜드,21350,21000,-350,-1.64,483647,10159095600
011420,갤럭시아에스엠,1395,1400,5,0.36,64421,89204235
002100,경농,16450,16150,-300,-1.82,1744780,29288157950
009450,경동나비엔,52500,54000,1500,2.86,89710,4751775700
267290,경동도시가스,16600,16650,50,0.3,5680,94397350
012320,경동인베스트,26350,26650,300,1.14,4069,106955200
000050,경방,10900,10950,50,0.46,5459,59429700
214390,경보제약,11400,11900,500,4.39,703806,8308481400
012610,경인양행,8150,8040,-110,-1.35,711181,5712893300
009140,경인전자,19350,19200,-150,-0.78,1362,25925250
013580,계룡건설,23550,23550,0,0.0,134739,3131586350
012200,계양전기,3130,3100,-30,-0.96,276974,857853120
012205,계양전기우,8000,7910,-90,-1.13,31460,246838980
002140,고려산업,4430,5030,600,13.54,26883978,140726704810
010130,고려아연,410000,404000,-6000,-1.46,30694,12411092000
002240,고려제강,14850,14550,-300,-2.02,28913,420552350
009290,광동제약,10350,10700,350,3.38,9585707,103145743200
017040,광명전기,1725,1730,5,0.29,136777,234708430
017900,광전자,2060,2045,-15,-0.73,178837,364845200
037710,광주신세계,145000,145500,500,0.34,434,62615000
030610,교보증권,6970,6930,-40,-0.57,81805,564437520
007690,국도화학,38550,38450,-100,-0.26,11760,448018700
005320,국동,3060,3355,295,9.64,2523695,8077559115
001140,국보,2470,2490,20,0.81,1651518,4035011880
002720,국제약품,12750,13600,850,6.67,6968467,96143836150
083420,그린케미칼,3635,3665,30,0.83,138782,506481840
014530,극동유화,3070,3050,-20,-0.65,68515,209034365
014280,금강공업,3590,3670,80,2.23,207402,762099370
014285,금강공업우,11600,11800,200,1.72,303467,3747015350
008870,금비,54000,55200,1200,2.22,1661,91634400
001570,금양,4180,4260,80,1.91,214433,894811500
002990,금호산업,7030,7380,350,4.98,686708,5057531400
002995,금호산업우,39150,41200,2050,5.24,67873,2864495900
011780,금호석유,105500,103000,-2500,-2.37,168135,17227504000
011785,금호석유우,40500,39500,-1000,-2.47,13819,546122300
214330,금호에이치티,2710,3055,345,12.73,11285373,33255121940
001210,금호전기,3205,3200,-5,-0.16,57366,180798125
073240,금호타이어,3200,3165,-35,-1.09,509526,1597566890
092440,기신정기,3100,3100,0,0.0,10109,31278320
000270,기아차,43000,43200,200,0.47,1613088,69114081300
024110,기업은행,8420,8350,-70,-0.83,1463232,12146147430
013700,까뮤이앤씨,1165,1160,-5,-0.43,203424,235521120
004540,깨끗한나라,4360,5200,840,19.27,10064139,49835804505
004545,깨끗한나라우,30900,34200,3300,10.68,297290,10246330500
001260,남광토건,10350,10200,-150,-1.45,41794,424629850
008350,남선알미늄,5250,5240,-10,-0.19,3415941,17783212140
008355,남선알미우,80600,79400,-1200,-1.49,25262,1991506400
004270,남성,2460,2450,-10,-0.41,261498,636466465
003920,남양유업,271500,273000,1500,0.55,3274,883873000
003925,남양유업우,174500,173500,-1000,-0.57,1438,251268000
025860,남해화학,8410,8460,50,0.59,615136,5195308160
005720,넥센,3715,3760,45,1.21,51058,190695785
005725,넥센우,2900,3095,195,6.72,430831,1422289990
002350,넥센타이어,5270,5180,-90,-1.71,347639,1798322520
002355,넥센타이어1우B,2280,2290,10,0.44,18090,41351430
003580,넥스트사이언스,5170,5070,-100,-1.93,158351,805208850
251270,넷마블,151000,150000,-1000,-0.66,323248,48427868000
090350,노루페인트,7140,7110,-30,-0.42,76467,541730180
090355,노루페인트우,13500,13600,100,0.74,22939,314348100
000320,노루홀딩스,9110,9160,50,0.55,5707,51888400
000325,노루홀딩스우,18200,17750,-450,-2.47,3180,55502400
006280,녹십자,276500,274500,-2000,-0.72,208524,57216054000
005250,녹십자홀딩스,27600,27150,-450,-1.63,219569,5964137500
005257,녹십자홀딩스2우,193000,177000,-16000,-8.29,40905,7223692500
004370,농심,361500,359000,-2500,-0.69,24037,8641638000
072710,농심홀딩스,79600,79200,-400,-0.5,3143,249260200
058730,다스코,4700,4795,95,2.02,140758,668182180
023590,다우기술,20000,19900,-100,-0.5,129048,2538176750
019680,대교,3980,3980,0,0.0,196960,794121890
019685,대교우B,2535,2540,5,0.2,50576,128276910
006370,대구백화점,5840,5840,0,0.0,2057,11986340
008060,대덕,6200,6150,-50,-0.81,168467,1037564270
00806K,대덕1우,6050,6080,30,0.5,6841,41327030
353200,대덕전자,11700,11600,-100,-0.85,943854,10890603050
35320K,대덕전자1우,7130,6980,-150,-2.1,23524,165438300
000490,대동공업,6570,6590,20,0.3,243192,1591339850
008110,대동전자,4360,4340,-20,-0.46,7384,31858455
005750,대림BCo,4830,4835,5,0.1,12225,59219085
001880,대림건설,25700,24950,-750,-2.92,66687,1674082250
000210,대림산업,81400,80800,-600,-0.74,160617,12932390600
000215,대림산업우,38400,38100,-300,-0.78,7845,297804250
004440,대림씨엔에스,7960,7960,0,0.0,61168,483578200
006570,대림통상,4330,4350,20,0.46,478,2087150
001680,대상,28300,28150,-150,-0.53,255789,7165357450
001685,대상우,18150,18150,0,0.0,18554,333947850
084690,대상홀딩스,11800,12750,950,8.05,1057545,13117102550
084695,대상홀딩스우,7750,8220,470,6.06,34322,275070530
128820,대성산업,3475,3535,60,1.73,464936,1639056780
117580,대성에너지,5010,4990,-20,-0.4,13527,67271080
016710,대성홀딩스,15400,15500,100,0.65,282614,4267165050
003540,대신증권,10500,10450,-50,-0.48,98427,1019282050
003547,대신증권2우B,9230,9180,-50,-0.54,17160,157490600
003545,대신증권우,9480,9400,-80,-0.84,65065,610004480
009190,대양금속,3995,3990,-5,-0.13,657395,2610073630
014160,대영포장,1005,991,-14,-1.39,884446,881997709
047040,대우건설,3210,3130,-80,-2.49,3703580,11650088720
009320,대우부품,2420,2435,15,0.62,744218,1795223920
042660,대우조선해양,23000,22950,-50,-0.22,239765,5551210750
003090,대웅,38250,37250,-1000,-2.61,1414391,53456207900
069620,대웅제약,119000,116500,-2500,-2.1,181818,21319553000
000430,대원강업,3120,3100,-20,-0.64,32922,101445145
006340,대원전선,962,962,0,0.0,237027,226755600
006345,대원전선우,3120,3130,10,0.32,29310,91022475
003220,대원제약,21500,22250,750,3.49,4508752,105368212450
024890,대원화성,1860,1835,-25,-1.34,104497,189955005
002880,대유에이텍,654,653,-1,-0.15,84819,55299154
000300,대유플러스,588,583,-5,-0.85,279537,163264837
012800,대창,1105,1095,-10,-0.9,864575,945043400
015230,대창단조,25800,25650,-150,-0.58,5433,139045400
001070,대한방직,33900,33800,-100,-0.29,4610,155631600
006650,대한유화,118000,114500,-3500,-2.97,51938,5943453500
001440,대한전선,706,692,-14,-1.98,2434825,1688441725
084010,대한제강,6400,6370,-30,-0.47,57978,366505800
001790,대한제당,19000,18950,-50,-0.26,9985,187910050
001795,대한제당우,13600,13650,50,0.37,4532,61552450
001130,대한제분,169000,171000,2000,1.18,8364,1432468000
003490,대한항공,18200,18000,-200,-1.1,1362809,24507113900
003495,대한항공우,23000,23000,0,0.0,57545,1316326700
005880,대한해운,15700,15600,-100,-0.64,56082,874956750
003830,대한화섬,84800,83000,-1800,-2.12,762,63373800
016090,대현,1725,1720,-5,-0.29,148200,252010785
069460,대호에이엘,1930,1895,-35,-1.81,189662,357630130
192080,더블유게임즈,72600,72000,-600,-0.83,119148,8604849400
012510,더존비즈온,101000,101000,0,0.0,76652,7697047000
004830,덕성,4920,5080,160,3.25,1321099,6709694665
004835,덕성우,9440,9640,200,2.12,75779,729397920
024900,덕양산업,1900,1870,-30,-1.58,1096645,2057961690
145720,덴티움,38900,38800,-100,-0.26,20115,781076350
002150,도화엔지니어링,7520,7420,-100,-1.33,65665,488059160
001230,동국제강,6670,6430,-240,-3.6,990628,6386191690
023450,동남합성,34550,34700,150,0.43,2201,75976750
004140,동방,1960,2005,45,2.3,10832950,22024692860
007590,동방아그로,6380,6360,-20,-0.31,45654,290203250
005960,동부건설,10500,10550,50,0.48,31687,331869100
005965,동부건설우,32400,32500,100,0.31,3544,115620900
026960,동서,24300,24050,-250,-1.03,151692,3630126900
002210,동성제약,12800,12900,100,0.78,427372,5538114850
102260,동성코퍼레이션,3850,3960,110,2.86,210288,819436140
005190,동성화학,15900,15900,0,0.0,43274,689424750
000640,동아쏘시오홀딩스,99800,99100,-700,-0.7,16706,1651977900
170900,동아에스티,95400,94100,-1300,-1.36,22507,2114172700
028100,동아지질,14900,14750,-150,-1.01,106433,1574541600
282690,동아타이어,10100,9970,-130,-1.29,7638,76372450
001520,동양,1150,1165,15,1.3,1265532,1465568715
001527,동양2우B,13700,14000,300,2.19,1414,19775100
001529,동양3우B,28150,28750,600,2.13,1204,34350800
084670,동양고속,26200,26100,-100,-0.38,4488,117320050
002900,동양물산,1290,1295,5,0.39,12274866,15758026645
082640,동양생명,3010,3000,-10,-0.33,52504,157247345
001525,동양우,6800,6920,120,1.76,684,4717470
008970,동양철관,1005,999,-6,-0.6,937412,931633214
092780,동양피스톤,4715,4740,25,0.53,62508,293440340
049770,동원FB,179500,178500,-1000,-0.56,4459,791556500
018500,동원금속,689,708,19,2.76,160247,111077536
006040,동원산업,222500,220500,-2000,-0.9,4253,938176500
030720,동원수산,8720,8680,-40,-0.46,32360,279615490
014820,동원시스템즈,21750,21650,-100,-0.46,27797,598361100
014825,동원시스템즈우,31900,32300,400,1.25,541,16844900
163560,동일고무벨트,11200,11350,150,1.34,1681739,19811334800
004890,동일산업,69500,69500,0,0.0,1308,90602500
002690,동일제강,1960,2055,95,4.85,588664,1232459355
000020,동화약품,23250,23750,500,2.15,1572466,37175678300
000150,두산,43100,42200,-900,-2.09,75188,3166434300
000157,두산2우B,78000,76700,-1300,-1.67,3346,257720500
241560,두산밥캣,27800,27200,-600,-2.16,322084,8786427500
336370,두산솔루스,40300,38850,-1450,-3.6,938569,36373374750
33637K,두산솔루스1우,16400,15750,-650,-3.96,183975,2849765700
33637L,두산솔루스2우B,33500,32450,-1050,-3.13,26187,837549500
000155,두산우,36350,36000,-350,-0.96,17504,624782200
042670,두산인프라코어,7900,7770,-130,-1.65,4189748,32483451590
034020,두산중공업,10150,10000,-150,-1.48,5588703,55690186880
336260,두산퓨얼셀,40200,42650,2450,6.09,1421474,58927397750
33626K,두산퓨얼셀1우,11100,11600,500,4.5,223110,2583436700
33626L,두산퓨얼셀2우B,18750,20050,1300,6.93,138545,2869174950
016740,두올,3535,3615,80,2.26,478177,1712187340
192650,드림텍,14250,14400,150,1.05,3009789,42960280800
024090,디씨엠,10650,10800,150,1.41,2717,29164250
003160,디아이,3950,3985,35,0.89,133799,525853110
092200,디아이씨,1630,1600,-30,-1.84,232085,375880190
013570,디와이,4030,3985,-45,-1.12,53546,214016320
210540,디와이파워,10200,10000,-200,-1.96,125645,1248958960
007340,디티알오토모티브,22450,22000,-450,-2.0,28390,625580100
026890,디피씨,17800,17400,-400,-2.25,1882831,32899794550
115390,락앤락,11050,10800,-250,-2.26,120619,1308456850
032350,롯데관광개발,18900,18900,0,0.0,0,0
330590,롯데리츠,5090,5080,-10,-0.2,261207,1323714890
000400,롯데손해보험,1620,1605,-15,-0.93,270763,434018625
023530,롯데쇼핑,77800,77200,-600,-0.77,92574,7100174800
004000,롯데정밀화학,46250,46950,700,1.51,169318,7831858250
286940,롯데정보통신,33500,33400,-100,-0.3,25778,848519650
280360,롯데제과,103000,101500,-1500,-1.46,5742,583434000
004990,롯데지주,30700,30250,-450,-1.47,153616,4652353650
00499K,롯데지주우,66500,65800,-700,-1.05,4410,292043000
005300,롯데칠성,95300,93900,-1400,-1.47,32982,3107206600
005305,롯데칠성우,59800,60000,200,0.33,1780,105511300
011170,롯데케미칼,175500,173500,-2000,-1.14,143346,24739925000
002270,롯데푸드,316000,310500,-5500,-1.74,2723,845319000
071840,롯데하이마트,30850,30850,0,0.0,66137,2020629250
027740,마니커,716,704,-12,-1.68,2072943,1467676916
204320,만도,29700,29850,150,0.51,918659,27558728900
001080,만호제강,15700,15100,-600,-3.82,19260,291711650
088980,맥쿼리인프라,11100,11050,-50,-0.45,560345,6176087250
094800,맵스리얼티1,3905,3910,5,0.13,33760,131991765
138040,메리츠금융지주,9220,9200,-20,-0.22,38985,358463350
008560,메리츠증권,3390,3320,-70,-2.06,2517393,8359867910
000060,메리츠화재,12900,12700,-200,-1.55,132689,1685373400
090370,메타랩스,1235,1225,-10,-0.81,390861,476495335
017180,명문제약,6140,6440,300,4.89,10156773,65579792190
012690,모나리자,6740,6810,70,1.04,3984283,27275688710
005360,모나미,6840,6730,-110,-1.61,1953838,13391760980
204210,모두투어리츠,2770,2730,-40,-1.44,7006,19245235
009680,모토닉,9780,9560,-220,-2.25,349601,3310934680
009580,무림PP,3005,3005,0,0.0,90327,271235670
009200,무림페이퍼,2100,2115,15,0.71,78351,164887645
033920,무학,5560,5530,-30,-0.54,26310,144303850
008420,문배철강,2625,2615,-10,-0.38,154313,402303430
025560,미래산업,3140,3095,-45,-1.43,283295,875646250
007120,미래아이앤지,351,352,1,0.28,242066,84809998
006800,미래에셋대우,9690,9560,-130,-1.34,3003282,28687117450
00680K,미래에셋대우2우B,4610,4510,-100,-2.17,695343,3143919345
006805,미래에셋대우우,5220,5180,-40,-0.77,56819,292408260
357250,미래에셋맵스리츠,4760,4765,5,0.11,34217,163193600
085620,미래에셋생명,3905,3950,45,1.15,121408,478981860
002840,미원상사,94800,92700,-2100,-2.22,3339,313808800
268280,미원에스씨,83600,84400,800,0.96,1577,133386400
107590,미원홀딩스,52400,52700,300,0.57,1394,72432700
134380,미원화학,52500,52700,200,0.38,392,20652300
003650,미창석유,59200,59100,-100,-0.17,535,31657000
155900,바다로19호,2600,2590,-10,-0.38,9011,23331670
003610,방림,1920,2110,190,9.9,5017666,10534350625
001340,백광산업,3600,3495,-105,-2.92,2071624,7400207225
035150,백산,4300,4410,110,2.56,205584,898452885
002410,범양건영,7350,7350,0,0.0,1877447,13756569160
096300,베트남개발1,285,286,1,0.35,84202,23959385
007210,벽산,1850,2065,215,11.62,18432444,38145706415
002760,보락,2020,2150,130,6.44,19362352,41153161890
003850,보령제약,16150,16200,50,0.31,365717,5894504750
000890,보해양조,833,830,-3,-0.36,928537,767762560
003000,부광약품,38100,37900,-200,-0.52,3582799,136518539650
001270,부국증권,20050,19850,-200,-1.0,2734,54727800
001275,부국증권우,18900,18750,-150,-0.79,1403,26347050
026940,부국철강,5540,5470,-70,-1.26,584326,3155192870
015350,부산가스,49300,49250,-50,-0.1,11639,571027300
011390,부산산업,119500,118000,-1500,-1.26,8609,1019677500
005030,부산주공,329,322,-7,-2.13,314142,101860607
002070,비비안,3890,3930,40,1.03,298775,1181550520
100220,비상교육,7710,7640,-70,-0.91,565657,4408867240
030790,비케이탑스,5550,5150,-400,-7.21,325069,1691302510
101140,비티원,3530,3455,-75,-2.12,294763,1022526655
005180,빙그레,58000,58000,0,0.0,28334,1635187300
003960,사조대림,14250,14100,-150,-1.05,21987,309594900
008040,사조동아원,821,823,2,0.24,461400,376073711
007160,사조산업,30400,30400,0,0.0,22402,676873400
014710,사조씨푸드,3575,3605,30,0.84,48273,172426175
006090,사조오양,8260,8180,-80,-0.97,45135,368909670
005090,삼광글라스,34900,34500,-400,-1.15,13437,463392650
001470,삼부토건,900,905,5,0.56,985670,888737831
006400,삼성SDI,444000,456500,12500,2.82,650896,293490004500
006405,삼성SDI우,265000,269500,4500,1.7,35546,9508259000
006660,삼성공조,6350,6330,-20,-0.31,1775,11254190
028260,삼성물산,118000,115000,-3000,-2.54,583585,67529342000
02826K,삼성물산우B,103000,101000,-2000,-1.94,16334,1647242900
207940,삼성바이오로직스,815000,812000,-3000,-0.37,101158,82114770000
032830,삼성생명,61300,60200,-1100,-1.79,724543,43755853200
018260,삼성에스디에스,161500,159500,-2000,-1.24,132530,21210095000
028050,삼성엔지니어링,12000,11800,-200,-1.67,810497,9619538800
009150,삼성전기,130500,128000,-2500,-1.92,395356,50804603000
009155,삼성전기우,61200,60300,-900,-1.47,23887,1436787400
005930,삼성전자,56400,56400,0,0.0,17651593,989962031580
005935,삼성전자우,48750,49000,250,0.51,1345692,65648744150
001360,삼성제약,3830,4005,175,4.57,2698445,10620164100
010140,삼성중공업,5390,5410,20,0.37,4907932,26665940860
010145,삼성중공우,486500,495000,8500,1.75,167214,95108061000
016360,삼성증권,31450,31300,-150,-0.48,525112,16311059400
068290,삼성출판사,19700,19450,-250,-1.27,56701,1102192150
029780,삼성카드,29750,29450,-300,-1.01,104172,3065969450
000810,삼성화재,184500,182000,-2500,-1.36,86680,15693023000
000815,삼성화재우,132500,129500,-3000,-2.26,16982,2206697000
006110,삼아알미늄,5870,5840,-30,-0.51,159169,908689520
145990,삼양사,70000,70000,0,0.0,25498,1770701300
145995,삼양사우,47900,47300,-600,-1.25,5490,259136000
003230,삼양식품,112500,110000,-2500,-2.22,64866,7153576000
002170,삼양통상,62000,61200,-800,-1.29,6455,394525100
272550,삼양패키징,17950,18850,900,5.01,156667,2948851500
000070,삼양홀딩스,66700,65000,-1700,-2.55,17624,1155003700
000075,삼양홀딩스우,50000,49700,-300,-0.6,1056,52055800
002810,삼영무역,13850,13650,-200,-1.44,31324,427612100
005680,삼영전자,8460,8460,0,0.0,72188,605870120
003720,삼영화학,1730,1815,85,4.91,349473,605181530
023000,삼원강재,2110,2120,10,0.47,20087,42213145
004380,삼익THK,10050,10050,0,0.0,30850,308685240
002450,삼익악기,1360,1355,-5,-0.37,278919,375450910
000520,삼일제약,21000,21300,300,1.43,208046,4412746650
009770,삼정펄프,28600,28050,-550,-1.92,1342,37450400
005500,삼진제약,29150,29500,350,1.2,74017,2165299750
004690,삼천리,75500,75300,-200,-0.26,2545,191679100
010960,삼호개발,4080,4090,10,0.25,76102,309848380
004450,삼화왕관,39900,39600,-300,-0.75,203,8105050
009470,삼화전기,18500,18300,-200,-1.08,65145,1186407800
011230,삼화전자,2800,2790,-10,-0.36,57838,159100705
001820,삼화콘덴서,56300,55600,-700,-1.24,101270,5616299500
000390,삼화페인트,4945,4940,-5,-0.1,13421,66057120
001290,상상인증권,1030,1010,-20,-1.94,139173,140698420
041650,상신브레이크,2405,2415,10,0.42,27895,66901375
075180,새론오토모티브,4140,4115,-25,-0.6,10002,41224380
007540,샘표,52900,52000,-900,-1.7,27021,1401156500
248170,샘표식품,48300,47450,-850,-1.76,34106,1623052700
007860,서연,9040,10000,960,10.62,5603340,54740358880
200880,서연이화,3895,3930,35,0.9,183553,711247265
017390,서울가스,67900,66400,-1500,-2.21,3158,209765300
004410,서울식품,153,153,0,0.0,4860205,744333944
004415,서울식품우,5300,5290,-10,-0.19,159894,860055650
021050,서원,3655,3690,35,0.96,4318366,15602142450
008490,서흥,58400,57500,-900,-1.54,28448,1636188800
007610,선도전기,2590,2530,-60,-2.32,59942,152421010
136490,선진,9920,9890,-30,-0.3,88369,869117140
002820,선창산업,3615,3650,35,0.97,21954,79072420
014910,성문전자,1545,1535,-10,-0.65,48831,75017780
014915,성문전자우,10500,10550,50,0.48,11326,117470850
003080,성보화학,4310,4280,-30,-0.7,26932,115388560
004980,성신양회,7110,6980,-130,-1.83,161995,1134164410
004985,성신양회우,15050,14350,-700,-4.65,63987,927737900
011300,성안,398,397,-1,-0.25,59651,23558513
000180,성창기업지주,1615,1615,0,0.0,87514,140058910
002420,세기상사,61600,61600,0,0.0,0,0
004360,세방,9830,9890,60,0.61,11287,111167150
004365,세방우,6070,6000,-70,-1.15,1640,9837880
004490,세방전지,28450,28100,-350,-1.23,53059,1483183200
001430,세아베스틸,10000,9840,-160,-1.6,104777,1032414710
306200,세아제강,78100,75500,-2600,-3.33,23289,1771225500
003030,세아제강지주,45750,45500,-250,-0.55,16007,715164050
019440,세아특수강,10750,10750,0,0.0,5670,60258000
058650,세아홀딩스,72800,71700,-1100,-1.51,826,59301200
013000,세우글로벌,1915,1940,25,1.31,821448,1590862335
091090,세원셀론텍,2915,2820,-95,-3.26,772496,2176434785
021820,세원정공,8090,8090,0,0.0,0,0
067830,세이브존IC,2585,2475,-110,-4.26,250526,621022320
033530,세종공업,7470,7340,-130,-1.74,747295,5445554700
075580,세진중공업,5410,5600,190,3.51,324306,1762900710
027970,세하,1380,1380,0,0.0,573260,785232830
145210,세화아이엠씨,1225,1225,0,0.0,772083,941089890
308170,센트랄모텍,25500,25000,-500,-1.96,76159,1913507050
068270,셀트리온,306500,310500,4000,1.31,1262116,395829208000
004430,송원산업,12200,12300,100,0.82,108877,1320719400
017550,수산중공업,1645,1620,-25,-1.52,605124,979821280
053210,스카이라이프,9210,9080,-130,-1.41,193625,1748385970
134790,시디즈,65600,63900,-1700,-2.59,10367,666362800
016590,신대양제지,54100,53600,-500,-0.92,16520,885998300
029530,신도리코,22400,22000,-400,-1.79,15927,351160500
004970,신라교역,9680,9600,-80,-0.83,21895,208710730
011930,신성이엔지,1445,1615,170,11.76,99164546,159815071755
005390,신성통상,1745,1700,-45,-2.58,3026137,5167448260
004170,신세계,207000,204500,-2500,-1.21,71859,14666229000
035510,신세계IC,120000,119000,-1000,-0.83,2833,337013500
034300,신세계건설,22950,22750,-200,-0.87,8171,183620100
031430,신세계인터내셔날,145500,143000,-2500,-1.72,51650,7367789500
031440,신세계푸드,52700,52300,-400,-0.76,6081,317353200
006880,신송홀딩스,3745,3675,-70,-1.87,49193,180843375
005800,신영와코루,95800,96900,1100,1.15,440,42940800
001720,신영증권,45950,45800,-150,-0.33,20091,923463350
001725,신영증권우,45800,46100,300,0.66,24472,1174716300
009270,신원,1490,1470,-20,-1.34,359681,530705125
009275,신원우,45300,44400,-900,-1.99,1429,64240500
002700,신일전자,1645,1590,-55,-3.34,3086099,4942563050
019170,신풍제약,114000,113000,-1000,-0.88,6839845,812300835500
019175,신풍제약우,173000,167000,-6000,-3.47,231036,39861958500
002870,신풍제지,1395,1365,-30,-2.15,172975,236671625
293940,신한알파리츠,6660,6660,0,0.0,51048,340267230
055550,신한지주,31400,30700,-700,-2.23,1469718,45171546800
001770,신화실업,19450,19500,50,0.26,3968,76820950
004080,신흥,9110,9130,20,0.22,570,5197990
102280,쌍방울,778,703,-75,-9.64,32325208,22617330474
003410,쌍용양회,5780,5720,-60,-1.04,1261036,7204815040
003415,쌍용양회우,14350,14050,-300,-2.09,2565,36061500
003620,쌍용차,3740,3685,-55,-1.47,1670871,6178154035
004770,써니전자,3815,3830,15,0.39,1866410,7134438130
015540,쎌마테라퓨틱스,9300,9160,-140,-1.51,591155,5470783870
004920,씨아이테크,1010,1015,5,0.5,108032,109036622
112610,씨에스윈드,85000,84700,-300,-0.35,308568,26001062300
008700,아남전자,1530,1525,-5,-0.33,275836,415498790
002790,아모레G,55000,53700,-1300,-2.36,109331,5869448100
00279K,아모레G3우전환,34700,34400,-300,-0.86,4985,170606000
002795,아모레G우,22400,22000,-400,-1.79,33099,731887400
090430,아모레퍼시픽,178000,173000,-5000,-2.81,310399,53669986500
090435,아모레퍼시픽우,60700,61000,300,0.49,47231,2849070300
002030,아세아,76400,76800,400,0.52,2373,181811300
183190,아세아시멘트,55600,55000,-600,-1.08,4818,265141500
002310,아세아제지,25500,25150,-350,-1.37,40399,1020164600
267850,아시아나IDT,21150,23000,1850,8.75,3246197,76232604750
020560,아시아나항공,4115,4405,290,7.05,18570721,82406199025
122900,아이마켓코리아,7840,7920,80,1.02,63380,500864640
010780,아이에스동서,43200,44000,800,1.85,136047,5983355800
033660,아주캐피탈,12050,12250,200,1.66,55613,675054200
001780,알루코,3655,3970,315,8.62,24676804,97898172725
018250,애경산업,22350,22150,-200,-0.89,81844,1811800300
161000,애경유화,6980,6950,-30,-0.43,78420,540770720
011090,에넥스,1005,1010,5,0.5,314895,315630863
005850,에스엘,12450,12250,-200,-1.61,164549,2006092750
012750,에스원,94900,92300,-2600,-2.74,47046,4370150800
023960,에쓰씨엔지니어링,1205,1220,15,1.24,160852,197813975
298690,에어부산,3510,3795,285,8.12,900111,3376183920
140910,에이리츠,6700,6630,-70,-1.04,9570,63925410
078520,에이블씨엔씨,7980,7850,-130,-1.63,56978,446862130
015260,에이엔피,182,182,0,0.0,2207044,396121789
007460,에이프로젠KIC,2970,3150,180,6.06,16397547,50424234595
003060,에이프로젠제약,1495,1560,65,4.35,13862497,21296701175
036570,엔씨소프트,826000,818000,-8000,-0.97,93233,76597364000
138250,엔에스쇼핑,11650,12250,600,5.15,140206,1686977550
085310,엔케이,918,911,-7,-0.76,292880,266336243
009810,엔케이물산,356,356,0,0.0,1511748,536107348
900140,엘브이엠씨홀딩스,3555,3595,40,1.13,109364,388400585
014440,영보화학,4070,4040,-30,-0.74,129692,516332050
111770,영원무역,29850,28650,-1200,-4.02,293326,8429924300
009970,영원무역홀딩스,35100,34350,-750,-2.14,6394,220645000
003520,영진약품,6520,6630,110,1.69,4555557,30286590860
000670,영풍,485500,480000,-5500,-1.13,2468,1188612500
006740,영풍제지,3265,3220,-45,-1.38,39827,127091070
012280,영화금속,1760,1760,0,0.0,1143867,2007492260
012160,영흥,1160,1150,-10,-0.86,220276,251249480
015360,예스코홀딩스,34450,34800,350,1.02,197,6870450
007310,오뚜기,598000,591000,-7000,-1.17,4795,2833689000
002630,오리엔트바이오,1870,2015,145,7.75,12880246,25997131765
271560,오리온,147500,144000,-3500,-2.37,70330,10146364000
001800,오리온홀딩스,13700,13650,-50,-0.36,111817,1523377950
070960,용평리조트,3990,3970,-20,-0.5,59715,236492785
316140,우리금융지주,8810,8800,-10,-0.11,1590558,13846221800
004720,우리들제약,21700,20300,-1400,-6.45,3381533,70575925050
118000,우리들휴브레인,5130,5200,70,1.36,62361787,332932993800
010050,우리종금,560,563,3,0.54,1379842,775126561
006980,우성사료,3120,3145,25,0.8,303133,947670030
017370,우신시스템,2800,2920,120,4.29,349277,1000086530
105840,우진,3575,3545,-30,-0.84,81156,286654230
010400,우진아이엔에스,7720,7960,240,3.11,155123,1234368210
049800,우진플라임,3355,3380,25,0.75,26004,87585055
016880,웅진,1040,1050,10,0.96,139599,144939410
095720,웅진씽크빅,2575,2730,155,6.02,2652303,7093604150
005820,원림,17650,17450,-200,-1.13,941,16573300
010600,웰바이오텍,2825,2730,-95,-3.36,11969215,36692485740
008600,윌비스,1180,1175,-5,-0.42,452888,528642745
033270,유나이티드제약,47450,45850,-1600,-3.37,2220163,107183485200
014830,유니드,48100,47500,-600,-1.25,34331,1617985000
000910,유니온,9110,8770,-340,-3.73,1653430,14527771430
047400,유니온머티리얼,4180,4220,40,0.96,4054550,17123425305
011330,유니켐,1365,1360,-5,-0.37,326765,439753485
077500,유니퀘스트,9360,9060,-300,-3.21,283954,2567753810
002920,유성기업,2415,2435,20,0.83,6757,16355060
000700,유수홀딩스,5290,5350,60,1.13,18220,96712550
003470,유안타증권,3075,3020,-55,-1.79,425540,1278261225
003475,유안타증권우,2175,2145,-30,-1.38,58283,124551980
011690,유양디앤유,1220,1220,0,0.0,0,0
072130,유엔젤,3110,4040,930,29.9,2671640,10063100595
000220,유유제약,17950,17600,-350,-1.95,359782,6373256050
000225,유유제약1우,17700,17150,-550,-3.11,91434,1592786450
000227,유유제약2우B,52900,50100,-2800,-5.29,11478,582689900
001200,유진투자증권,3720,3615,-105,-2.82,875341,3156753260
000100,유한양행,67600,66700,-900,-1.33,633076,42330996100
000105,유한양행우,69000,67900,-1100,-1.59,19774,1346469600
003460,유화증권,2200,2200,0,0.0,6499,14348005
003465,유화증권우,2595,2600,5,0.19,2380,6288570
008730,율촌화학,15700,15400,-300,-1.91,118777,1827952650
008250,이건산업,7750,7700,-50,-0.65,111120,851082350
025820,이구산업,1460,1450,-10,-0.68,71246,102640110
214320,이노션,54300,54400,100,0.18,58249,3154660100
088260,이리츠코크렙,5280,5300,20,0.38,30917,163111230
139480,이마트,119500,118500,-1000,-0.84,224054,26304470000
007660,이수페타시스,5070,5030,-40,-0.79,2327637,11792732195
005950,이수화학,8560,8540,-20,-0.23,311161,2645796910
015020,이스타코,680,671,-9,-1.32,132764,88628820
093230,이아이디,218,213,-5,-2.29,6682687,1417559414
074610,이엔플러스,4890,4930,40,0.82,1252320,6279876345
102460,이연제약,19900,20900,1000,5.03,547454,11207355850
084680,이월드,3480,3475,-5,-0.14,597302,2045151380
350520,이지스레지던스리츠,4660,4650,-10,-0.21,96493,447188650
334890,이지스밸류리츠,4580,4605,25,0.55,103183,473515120
000760,이화산업,14150,14050,-100,-0.71,1665,23465900
014990,인디에프,1760,1715,-45,-2.56,236763,407318250
006490,인스코비,2130,2250,120,5.63,2935427,6536628875
023800,인지컨트롤스,8330,8040,-290,-3.48,753731,6111592190
034590,인천도시가스,24650,24550,-100,-0.41,1071,26288600
129260,인터지스,3270,3025,-245,-7.49,805673,2522736760
023810,인팩,4520,4360,-160,-3.54,70047,305976340
249420,일동제약,16750,16900,150,0.9,151076,2514329800
000230,일동홀딩스,9600,9600,0,0.0,22542,213772850
013360,일성건설,880,900,20,2.27,169153,148843663
003120,일성신약,81800,83800,2000,2.44,8220,687762300
003200,일신방직,66800,70200,3400,5.09,32551,2290106200
007110,일신석재,2100,2075,-25,-1.19,550866,1144556670
007570,일양약품,78900,79100,200,0.25,570416,45216297100
007575,일양약품우,95100,93400,-1700,-1.79,16097,1509012500
008500,일정실업,11150,11200,50,0.45,1646,18164400
081000,일진다이아,56800,59100,2300,4.05,504039,29240482900
020760,일진디스플,2900,2975,75,2.59,183380,534376900
020150,일진머티리얼즈,52100,51600,-500,-0.96,377664,19402612200
103590,일진전기,2650,2595,-55,-2.08,95143,245049020
015860,일진홀딩스,5640,5570,-70,-1.24,473330,2623792350
226320,잇츠한불,30000,29650,-350,-1.17,427165,12628970700
317400,자이에스앤디,7410,7700,290,3.91,408758,3107140010
033240,자화전자,12650,12400,-250,-1.98,321788,3997531850
000950,전방,27650,28700,1050,3.8,16515,465804750
348950,제이알글로벌리츠,4945,4930,-15,-0.3,291166,1433856745
194370,제이에스코퍼레이션,8020,7730,-290,-3.62,190258,1488105360
025620,제이준코스메틱,2815,2850,35,1.24,321979,910484385
036420,제이콘텐트리,28350,27500,-850,-3.0,166367,4570442000
030000,제일기획,17700,17400,-300,-1.69,460926,7990768650
271980,제일약품,54000,53900,-100,-0.19,173352,9410172900
001560,제일연마,6240,6330,90,1.44,204247,1337427350
002620,제일파마홀딩스,24100,24500,400,1.66,51336,1237103350
006220,제주은행,3015,3015,0,0.0,15452,46326135
089590,제주항공,14150,14150,0,0.0,78655,1109044500
004910,조광페인트,5290,5380,90,1.7,399686,2281665390
004700,조광피혁,49950,53100,3150,6.31,74223,4350567450
001550,조비,24000,24600,600,2.5,1180399,29900191350
000480,조선내화,71200,71200,0,0.0,724,51599600
120030,조선선재,102000,100500,-1500,-1.47,5915,593618300
018470,조일알미늄,615,608,-7,-1.14,82430,50430804
002600,조흥,151500,150000,-1500,-0.99,437,65659500
185750,종근당,194500,186000,-8500,-4.37,198868,37563559000
063160,종근당바이오,55000,57000,2000,3.64,741334,41338981800
001630,종근당홀딩스,122500,121000,-1500,-1.22,26614,3207054500
044380,주연테크,1095,1075,-20,-1.83,569571,610648630
013890,지누스,85900,85800,-100,-0.12,66292,5643641700
013870,지엠비코리아,5090,5010,-80,-1.57,234612,1183838080
071320,지역난방공사,34000,33900,-100,-0.29,5782,196452550
010580,지코,306,306,0,0.0,0,0
035000,지투알,4840,4885,45,0.93,7431,35947820
088790,진도,2855,2780,-75,-2.63,93945,261656350
003780,진양산업,3585,3650,65,1.81,166696,602225180
010640,진양폴리,2760,2750,-10,-0.36,63275,173500290
100250,진양홀딩스,2450,2440,-10,-0.41,138635,337797065
051630,진양화학,3400,3500,100,2.94,83411,288974330
272450,진에어,9080,9110,30,0.33,57695,521072900
011000,진원생명과학,23750,30850,7100,29.89,22348248,646299251250
002780,진흥기업,2125,2080,-45,-2.12,86256,178962045
002787,진흥기업2우B,14400,14100,-300,-2.08,2668,37766350
002785,진흥기업우B,5510,5530,20,0.36,6285,34806000
009310,참엔지니어링,1285,1295,10,0.78,149986,192187150
000650,천일고속,61200,60800,-400,-0.65,2148,130701500
012600,청호컴넷,8420,8170,-250,-2.97,286200,2376361990
033250,체시스,2795,2880,85,3.04,3137840,9254798545
035720,카카오,381000,392000,11000,2.89,1351029,526186360000
006380,카프로,2500,2495,-5,-0.2,83967,208833905
109070,컨버즈,4100,4100,0,0.0,0,0
001620,케이비아이동국실업,594,595,1,0.17,86002,50702554
029460,케이씨,20900,20350,-550,-2.63,73168,1500170700
344820,케이씨씨글라스,28350,28600,250,0.88,64509,1815453750
281820,케이씨텍,20150,20200,50,0.25,62542,1254926400
145270,케이탑리츠,749,749,0,0.0,64393,47918633
007815,코리아써우,5310,5100,-210,-3.95,3255,16763020
007810,코리아써키트,13450,12900,-550,-4.09,418506,5449077550
00781K,코리아써키트2우B,6320,6120,-200,-3.16,2146,13189720
152330,코리아오토글라스,14750,15400,650,4.41,83111,1241506050
003690,코리안리,7310,7250,-60,-0.82,377346,2740518830
192820,코스맥스,108000,105500,-2500,-2.31,161411,16996729000
044820,코스맥스비티아이,21600,21200,-400,-1.85,30617,648739850
005070,코스모신소재,15900,16050,150,0.94,1656272,26245943150
005420,코스모화학,11150,11000,-150,-1.35,814184,8918843850
071950,코아스,1050,1045,-5,-0.48,187263,194989610
002020,코오롱,20900,20350,-550,-2.63,60922,1245758850
003070,코오롱글로벌,13200,13900,700,5.3,699770,9789801950
003075,코오롱글로벌우,28550,30000,1450,5.08,349908,10906417800
144620,코오롱머티리얼,3115,3060,-55,-1.77,810875,2471378260
002025,코오롱우,13800,13950,150,1.09,8021,109238950
120110,코오롱인더,33050,32350,-700,-2.12,131715,4268414750
120115,코오롱인더우,18550,18300,-250,-1.35,7746,141637650
138490,코오롱플라스틱,4300,4465,165,3.84,641194,2910850765
021240,코웨이,86500,84000,-2500,-2.89,135283,11397573000
031820,콤텍시스템,1175,1310,135,11.49,34663555,46309113495
192400,쿠쿠홀딩스,93800,94100,300,0.32,6527,609053300
284740,쿠쿠홈시스,44550,42150,-2400,-5.39,109906,4662032950
015590,큐로,576,591,15,2.6,2777407,1666114278
264900,크라운제과,8250,8280,30,0.36,12247,100696550
26490K,크라운제과우,8430,8490,60,0.71,5104,43106190
005740,크라운해태홀딩스,8500,8520,20,0.24,27691,234255130
005745,크라운해태홀딩스우,11600,11950,350,3.02,5647,66897950
020120,키다리스튜디오,8700,8720,20,0.23,268069,2347818610
039490,키움증권,111500,111500,0,0.0,101464,11247098500
012170,키위미디어그룹,150,150,0,0.0,0,0
014580,태경비케이,3640,3635,-5,-0.14,253927,924031725
015890,태경산업,4895,4900,5,0.1,34396,167812205
006890,태경케미컬,8640,8310,-330,-3.82,485030,4064149320
003240,태광산업,668000,666000,-2000,-0.3,1094,726123000
011280,태림포장,3220,3300,80,2.48,657846,2193114875
004100,태양금속,1000,1000,0,0.0,168526,168684567
004105,태양금속우,3355,3365,10,0.3,32583,108795515
009410,태영건설,19700,20650,950,4.82,2767783,55964441150
009415,태영건설우,25200,29550,4350,17.26,624613,17794510000
001420,태원물산,3340,3340,0,0.0,5910,19741445
007980,태평양물산,1735,1755,20,1.15,1882066,3311436465
055490,테이팩스,23950,24000,50,0.21,46996,1108642200
078000,텔코웨어,12150,12250,100,0.82,18244,222127150
214420,토니모리,10150,10000,-150,-1.48,163422,1628536390
019180,티에이치엔,2450,2410,-40,-1.63,124671,299494870
091810,티웨이항공,2680,2715,35,1.31,118523,319462975
004870,티웨이홀딩스,1000,990,-10,-1.0,195174,192698742
005690,파미셀,22350,22700,350,1.57,4131622,93771464200
036580,팜스코,5320,5270,-50,-0.94,110803,580825130
028670,팬오션,3575,3525,-50,-1.4,840302,2973963950
010820,퍼스텍,2115,2125,10,0.47,1015192,2158112120
016800,퍼시스,28450,28300,-150,-0.53,2391,67769750
001020,페이퍼코리아,1450,1505,55,3.79,199302,298268490
090080,평화산업,1100,1070,-30,-2.73,157246,168726265
010770,평화홀딩스,2920,2905,-15,-0.51,13419,38694205
058430,포스코강판,12750,12600,-150,-1.18,43887,553123150
047050,포스코인터내셔널,14250,14000,-250,-1.75,188566,2652751000
003670,포스코케미칼,90700,91700,1000,1.1,782081,71125657100
007630,폴루스바이오팜,1225,1225,0,0.0,0,0
017810,풀무원,19100,19750,650,3.4,389163,7631722050
103140,풍산,23950,23550,-400,-1.67,219061,5182321800
005810,풍산홀딩스,25350,25100,-250,-0.99,1562,39376100
033180,필룩스,3355,3320,-35,-1.04,1660599,5521830815
086790,하나금융지주,29350,29150,-200,-0.68,948210,27516239850
293480,하나제약,25500,25650,150,0.59,249114,6296003700
039130,하나투어,38300,38450,150,0.39,85931,3262751350
172580,하이골드12호,2015,2015,0,0.0,2912,5881575
153360,하이골드3호,1360,1340,-20,-1.47,6273,8218170
071090,하이스틸,16450,16100,-350,-2.13,4173,66912200
019490,하이트론,2845,2845,0,0.0,22895,65813665
000080,하이트진로,39000,37900,-1100,-2.82,651013,24795122150
000087,하이트진로2우B,21650,21200,-450,-2.08,4276,90730600
000140,하이트진로홀딩스,19000,18500,-500,-2.63,73533,1354592800
000145,하이트진로홀딩스우,16800,16850,50,0.3,5822,97252200
152550,한국ANKOR유전,1685,1680,-5,-0.3,31962,53570380
036460,한국가스공사,24600,24400,-200,-0.81,184292,4469218700
005430,한국공항,30800,30700,-100,-0.32,9081,277440350
071050,한국금융지주,63400,62700,-700,-1.1,389741,24275491300
071055,한국금융지주우,48300,47950,-350,-0.72,76030,3650777800
010040,한국내화,3145,3260,115,3.66,733295,2428293700
025540,한국단자,45000,46650,1650,3.67,105383,4896586950
004090,한국석유,99100,99000,-100,-0.1,2360,231235700
002200,한국수출포장,17450,17700,250,1.43,8007,140026100
002960,한국쉘석유,240500,240000,-500,-0.21,1869,446532000
123890,한국자산신탁,3500,3460,-40,-1.14,448612,1554275075
015760,한국전력,21000,20450,-550,-2.62,3812835,78244240200
006200,한국전자홀딩스,540,539,-1,-0.19,32814,17571024
009540,한국조선해양,90500,89100,-1400,-1.55,390394,35063171300
023350,한국종합기술,3835,3810,-25,-0.65,40134,152992015
025890,한국주강,1380,1335,-45,-3.26,26797,36135515
000970,한국주철관,8800,8920,120,1.36,81109,711675790
104700,한국철강,4495,4480,-15,-0.33,104328,467031460
017960,한국카본,9250,9040,-210,-2.27,3287812,29947082440
161890,한국콜마,47900,46950,-950,-1.98,190464,8945040450
024720,한국콜마홀딩스,30800,30100,-700,-2.27,161377,4844065300
161390,한국타이어앤테크놀로지,31550,30250,-1300,-4.12,1245957,38932123700
000240,한국테크놀로지그룹,17600,16350,-1250,-7.1,12566006,224652152200
034830,한국토지신탁,1700,1690,-10,-0.59,886904,1491760885
007280,한국특수형강,1415,1420,5,0.35,216827,303646575
168490,한국패러랠,1940,1925,-15,-0.77,40686,78331735
010100,한국프랜지,2290,2440,150,6.55,9074268,22939042310
047810,한국항공우주,23100,22750,-350,-1.52,404078,9216205400
123690,한국화장품,13450,13200,-250,-1.86,253298,3341053100
003350,한국화장품제조,40900,39900,-1000,-2.44,105127,4219695100
011500,한농화성,5600,5520,-80,-1.43,105463,585111530
002390,한독,36550,37750,1200,3.28,266904,9920359300
014790,한라,3475,3415,-60,-1.73,81944,278795090
060980,한라홀딩스,28250,27800,-450,-1.59,63664,1769340650
053690,한미글로벌,8080,7900,-180,-2.23,58706,463670940
042700,한미반도체,10300,10100,-200,-1.94,392112,3960021510
008930,한미사이언스,61700,60000,-1700,-2.76,526759,31880021500
128940,한미약품,307000,317000,10000,3.26,142210,44078472000
009240,한샘,98000,100000,2000,2.04,91092,9059858200
020000,한섬,31600,31100,-500,-1.58,76039,2381468550
003680,한성기업,14450,14350,-100,-0.69,177570,2567518650
105630,한세실업,15400,14900,-500,-3.25,503962,7601761350
069640,한세엠케이,2770,2795,25,0.9,20626,57800850
016450,한세예스24홀딩스,4420,4465,45,1.02,90126,400334660
010420,한솔PNS,1440,1425,-15,-1.04,145511,207741765
009180,한솔로지스틱스,2055,2160,105,5.11,1413287,3031752215
213500,한솔제지,13350,13100,-250,-1.87,141881,1862224000
014680,한솔케미칼,154000,155000,1000,0.65,123739,19097094500
004710,한솔테크닉스,8660,8690,30,0.35,310867,2663773400
004150,한솔홀딩스,3540,3530,-10,-0.28,128225,448720040
025750,한솔홈데코,1120,1095,-25,-2.23,821891,901112910
004960,한신공영,13950,13950,0,0.0,29593,411314450
011700,한신기계,1375,1375,0,0.0,391375,539620820
001750,한양증권,9000,8890,-110,-1.22,81035,715435680
001755,한양증권우,12400,12400,0,0.0,6530,79351250
018880,한온시스템,13050,13200,150,1.15,1475197,19393873450
009420,한올바이오파마,34600,33950,-650,-1.88,3692619,130882608250
014130,한익스프레스,4640,4700,60,1.29,276464,1304172825
300720,한일시멘트,79600,79200,-400,-0.5,2890,228520200
002220,한일철강,1700,1670,-30,-1.76,43759,73386870
006390,한일현대시멘트,27750,27500,-250,-0.9,26307,721310250
003300,한일홀딩스,45500,46000,500,1.1,3976,182730950
051600,한전KPS,28800,28600,-200,-0.69,130295,3723676750
052690,한전기술,16300,16000,-300,-1.84,84577,1353420400
130660,한전산업,3330,3325,-5,-0.15,30141,99746490
002320,한진,44200,43950,-250,-0.57,78844,3459685200
097230,한진중공업,6270,6260,-10,-0.16,207013,1313054940
003480,한진중공업홀딩스,3245,3200,-45,-1.39,56495,180503995
180640,한진칼,76300,75000,-1300,-1.7,154705,11639309700
18064K,한진칼우,50300,50600,300,0.6,7363,370881800
005110,한창,1285,1280,-5,-0.39,385255,488240725
009460,한창제지,1875,1875,0,0.0,741059,1390815930
000880,한화,26650,26500,-150,-0.56,616336,16263932800
00088K,한화3우B,12900,12650,-250,-1.94,48110,610157750
088350,한화생명,1585,1570,-15,-0.95,4880679,7586293570
000370,한화손해보험,2790,2810,20,0.72,298058,838686275
009830,한화솔루션,35350,34800,-550,-1.56,4845248,166748625800
009835,한화솔루션우,30400,29850,-550,-1.81,128788,3816966950
272210,한화시스템,10200,10050,-150,-1.47,376073,3764968100
012450,한화에어로스페이스,26300,26300,0,0.0,392912,10378865800
000885,한화우,56800,56000,-800,-1.41,28085,1577299000
003530,한화투자증권,1830,1805,-25,-1.37,634087,1136370035
003535,한화투자증권우,3200,3210,10,0.31,238661,758945345
195870,해성디에스,19450,19600,150,0.77,170643,3325596500
101530,해태제과식품,8130,8130,0,0.0,24494,198203970
143210,핸즈코퍼레이션,6550,7250,700,10.69,466630,3387080060
000720,현대건설,33000,32950,-50,-0.15,598809,19586175000
267270,현대건설기계,22700,22350,-350,-1.54,103706,2305378750
000725,현대건설우,230000,222500,-7500,-3.26,22060,4957918500
005440,현대그린푸드,7460,7310,-150,-2.01,379863,2787354620
086280,현대글로비스,127000,129000,2000,1.57,153001,19405595500
064350,현대로템,15450,15250,-200,-1.29,1344497,20473572650
079430,현대리바트,16750,17150,400,2.39,192955,3251485550
012330,현대모비스,219500,223500,4000,1.82,345505,76303167000
010620,현대미포조선,31800,31450,-350,-1.1,141912,4492557400
069960,현대백화점,57400,56600,-800,-1.39,179178,10124684800
004560,현대비앤지스틸,7500,7450,-50,-0.67,34271,253213130
004565,현대비앤지스틸우,76100,75000,-1100,-1.45,1982,148325000
011760,현대상사,13900,13750,-150,-1.08,54114,739730450
004310,현대약품,6310,6410,100,1.58,1633957,10425160290
322000,현대에너지솔루션,29300,28700,-600,-2.05,197224,5641441300
126560,현대에이치씨엔,3840,3870,30,0.78,214282,815112865
017800,현대엘리베이,42600,41900,-700,-1.64,179560,7527141350
307950,현대오토에버,41100,41600,500,1.22,59697,2447656650
011210,현대위아,41450,42100,650,1.57,306034,12793574150
267260,현대일렉트릭,12050,11800,-250,-2.07,436885,5223846950
004020,현대제철,27000,26350,-650,-2.41,863354,22622612800
267250,현대중공업지주,242000,236500,-5500,-2.27,42609,10080547500
005380,현대차,166000,167500,1500,0.9,2638394,439643843500
005387,현대차2우B,85600,86200,600,0.7,106404,9115384900
005389,현대차3우B,73700,73900,200,0.27,40328,2972572300
005385,현대차우,84000,84900,900,1.07,116665,9813431600
001500,현대차증권,9830,9840,10,0.1,117643,1146598320
227840,현대코퍼레이션홀딩스,10100,10150,50,0.5,30223,303746690
001450,현대해상,22900,22500,-400,-1.75,243423,5455857800
057050,현대홈쇼핑,60000,58900,-1100,-1.83,32098,1894239500
093240,형지엘리트,2140,2070,-70,-3.27,1931204,4058357620
003010,혜인,4785,4775,-10,-0.21,158902,756410670
111110,호전실업,8180,8240,60,0.73,32036,262026050
008770,호텔신라,71600,70900,-700,-0.98,342028,24180974000
008775,호텔신라우,60500,60100,-400,-0.66,10779,645495700
002460,화성산업,12250,12300,50,0.41,86189,1046614850
013520,화승알앤에이,1635,1665,30,1.83,863336,1496299575
241590,화승엔터프라이즈,11600,11250,-350,-3.02,361139,4051740100
006060,화승인더,6890,6870,-20,-0.29,192775,1305284390
010690,화신,2320,2295,-25,-1.08,106444,240750900
133820,화인베스틸,2345,2350,5,0.21,262273,612883675
010660,화천기계,3280,3195,-85,-2.59,473536,1525622970
000850,화천기공,31100,31200,100,0.32,7709,240074900
016580,환인제약,15700,16000,300,1.91,151009,2390242600
032560,황금에스티,6730,6680,-50,-0.74,113735,757898840
004800,효성,67700,67100,-600,-0.89,48073,3222832100
094280,효성ITX,27000,26900,-100,-0.37,28259,754450550
298040,효성중공업,41800,40950,-850,-2.03,177924,7291209600
298050,효성첨단소재,139500,137500,-2000,-1.43,152843,20841411000
298020,효성티앤씨,100500,100500,0,0.0,26480,2657356000
298000,효성화학,100000,100000,0,0.0,15379,1537938500
093370,후성,8040,7890,-150,-1.87,906770,7171567180
081660,휠라홀딩스,36200,36300,100,0.28,506371,17983261600
005870,휴니드,6070,6040,-30,-0.49,261614,1579003540
079980,휴비스,7570,8530,960,12.68,5568948,46591330750
005010,휴스틸,6710,6700,-10,-0.15,4602,30599800
069260,휴켐스,18500,18900,400,2.16,1141540,21131343700
000540,흥국화재,2220,2200,-20,-0.9,10624,23521625
000547,흥국화재2우B,22500,22450,-50,-0.22,4034,90109200
000545,흥국화재우,5620,5630,10,0.18,5357,29995300
003280,흥아해운,258,258,0,0.0,0,0
