티커,종목명,시가,종가,변동폭,등락률,거래량,거래대금
095570,AJ네트웍스,3310,3280,-30,-0.91,163585,540229730
006840,AK홀딩스,19000,18950,-50,-0.26,57943,1095441200
027410,BGF,4220,4235,15,0.36,134015,562686845
282330,BGF리테일,127000,126000,-1000,-0.79,30145,3816754000
138930,BNK금융지주,5090,5120,30,0.59,1342177,6917774780
001460,BYC,206000,207000,1000,0.49,1034,213659000
001465,BYC우,125000,121000,-4000,-3.2,1981,242405000
001040,CJ,84100,82900,-1200,-1.43,115831,9650884100
079160,CJCGV,19300,19350,50,0.26,182779,3539473500
00104K,CJ4우전환,59000,58500,-500,-0.85,20132,1174157800
000120,CJ대한통운,154500,155000,500,0.32,102547,16046983500
011150,CJ씨푸드,3570,3560,-10,-0.28,516817,1858906055
011155,CJ씨푸드1우,47400,45450,-1950,-4.11,16975,786788850
001045,CJ우,43200,43000,-200,-0.46,7607,327541950
097950,CJ제일제당,369500,366500,-3000,-0.81,63561,23250160000
097955,CJ제일제당우,141500,144500,3000,2.12,9765,1392583000
000590,CS홀딩스,65100,64700,-400,-0.61,1740,112802700
012030,DB,705,700,-5,-0.71,674016,473183885
016610,DB금융투자,3565,3570,5,0.14,138259,492708550
005830,DB손해보험,46100,46600,500,1.08,152647,7122489850
000990,DB하이텍,31050,33300,2250,7.25,5179315,171737312750
000995,DB하이텍1우,60000,66100,6100,10.17,34222,2356002200
139130,DGB금융지주,5110,5110,0,0.0,639848,3284466190
001530,DI동일,74000,73700,-300,-0.41,11575,855751300
004840,DRB동일,6800,6750,-50,-0.74,42758,286235950
155660,DSR,4150,4105,-45,-1.08,64024,261749885
069730,DSR제강,4475,4395,-80,-1.79,136393,601772010
017940,E1,36250,37400,1150,3.17,22402,829767150
007700,FF,80900,80400,-500,-0.62,79676,6441787700
114090,GKL,12700,12700,0,0.0,371854,4714107300
078930,GS,35050,34900,-150,-0.43,314826,11021077700
006360,GS건설,26450,26400,-50,-0.19,439138,11553157200
001250,GS글로벌,1715,1720,5,0.29,197543,339597045
007070,GS리테일,34700,34550,-150,-0.43,202961,7022960650
078935,GS우,29500,29600,100,0.34,5460,160554500
012630,HDC,9490,9580,90,0.95,428174,4075725720
039570,HDC아이콘트롤스,7970,8050,80,1.0,27756,224462980
089470,HDC현대EP,4085,4135,50,1.22,59882,244085490
294870,HDC현대산업개발,21950,21800,-150,-0.68,2307781,50990263350
011200,HMM,5200,5170,-30,-0.58,1407530,7321770520
082740,HSD엔진,4940,4830,-110,-2.23,536832,2600548025
003560,IHQ,1505,1510,5,0.33,390029,588717555
175330,JB금융지주,4740,4715,-25,-0.53,219866,1041712885
234080,JW생명과학,19750,19700,-50,-0.25,220787,4384475150
001060,JW중외제약,37800,37600,-200,-0.53,268232,10171363350
001067,JW중외제약2우B,61700,66100,4400,7.13,12159,780586300
001065,JW중외제약우,69700,73000,3300,4.73,52025,3774293500
096760,JW홀딩스,5510,5480,-30,-0.54,260129,1424243610
105560,KB금융,35450,35700,250,0.71,1739731,62069042400
002380,KCC,135000,134500,-500,-0.37,28485,3849369000
009070,KCTC,2310,2290,-20,-0.87,128001,295204990
009440,KC그린홀딩스,4265,4190,-75,-1.76,92880,387094140
119650,KC코트렐,6120,5980,-140,-2.29,292056,1764151000
092220,KEC,835,834,-1,-0.12,482453,403434997
016380,KG동부제철,12500,12200,-300,-2.4,60172,739459700
016385,KG동부제철우,107500,104500,-3000,-2.79,1817,190446500
001390,KG케미칼,14000,13900,-100,-0.71,139998,1943598550
001940,KISCO홀딩스,11600,11400,-200,-1.72,3675,42053550
025000,KPX케미칼,45900,45600,-300,-0.65,1689,77312650
092230,KPX홀딩스,42200,42150,-50,-0.12,758,31935750
000040,KR모터스,738,724,-14,-1.9,706397,516560577
044450,KSS해운,8490,8390,-100,-1.18,24520,206146840
030200,KT,23600,23700,100,0.42,894018,21257060400
033780,KTG,80600,81200,600,0.74,286483,23225738200
030210,KTB투자증권,2490,2500,10,0.4,206415,517337490
058850,KTcs,1810,1825,15,0.83,244249,446427180
058860,KTis,2250,2245,-5,-0.22,183143,409653285
093050,LF,12200,12100,-100,-0.82,49166,597127000
003550,LG,74300,75800,1500,2.02,315872,23707071300
034220,LG디스플레이,12250,12400,150,1.22,2331110,28909476450
001120,LG상사,15100,15100,0,0.0,172269,2603902250
051900,LG생활건강,1346000,1350000,4000,0.3,37319,50113969000
051905,LG생활건강우,699000,706000,7000,1.0,2715,1912113000
003555,LG우,47450,48400,950,2.0,11403,547767450
032640,LG유플러스,11400,11600,200,1.75,2006886,23078410200
011070,LG이노텍,157000,163000,6000,3.82,292320,47644367000
066570,LG전자,73600,72500,-1100,-1.49,975596,71009610600
066575,LG전자우,27100,27050,-50,-0.18,98030,2648715950
108670,LG하우시스,61200,61300,100,0.16,54276,3323581100
108675,LG하우시스우,28450,28350,-100,-0.35,7598,215976000
037560,LG헬로비전,3960,4005,45,1.14,150613,607759650
051910,LG화학,517000,528000,11000,2.13,372041,196245903000
051915,LG화학우,251000,255500,4500,1.79,29331,7471441000
079550,LIG넥스원,33700,33350,-350,-1.04,117186,3943848450
006260,LS,43600,42450,-1150,-2.64,226085,9736508900
010120,LSELECTRIC,60000,56200,-3800,-6.33,311409,17910179500
000680,LS네트웍스,2305,2280,-25,-1.08,647693,1448791900
229640,LS전선아시아,6830,6900,70,1.02,87453,601566030
023150,MH에탄올,7070,6990,-80,-1.13,70785,499234750
035420,NAVER,284500,288000,3500,1.23,978238,282133831000
181710,NHN,82400,82000,-400,-0.49,67829,5585955400
005940,NH투자증권,8850,8790,-60,-0.68,1336590,11798268870
005945,NH투자증권우,7560,7550,-10,-0.13,66698,502944080
338100,NH프라임리츠,4470,4470,0,0.0,36267,161708990
034310,NICE,20750,20750,0,0.0,36435,755686000
008260,NI스틸,2295,2225,-70,-3.05,302928,682746540
004250,NPC,3450,3425,-25,-0.72,21762,74973735
004255,NPC우,2435,2370,-65,-2.67,8901,21494360
010060,OCI,53700,52900,-800,-1.49,465498,24878396400
005490,POSCO,196000,202000,6000,3.06,466607,93215424000
100840,STC,15800,15650,-150,-0.95,11603,182341550
064960,ST모티브,43800,43750,-50,-0.11,48621,2122556550
003570,ST중공업,5090,5190,100,1.96,110377,572031830
036530,ST홀딩스,15150,15100,-50,-0.33,6091,91928550
010950,S-Oil,61200,61600,400,0.65,299380,18378571500
010955,S-Oil우,34350,34650,300,0.87,7126,245945400
034120,SBS,16000,16250,250,1.56,33733,545087250
101060,SBS미디어홀딩스,1880,1880,0,0.0,44147,83231305
004060,SG세계물산,645,629,-16,-2.48,2280655,1450635415
001380,SG충방,1760,1695,-65,-3.69,1208068,2082931805
002360,SH에너지화학,829,829,0,0.0,1080895,898453737
009160,SIMPAC,2400,2395,-5,-0.21,56769,135399935
123700,SJM,2555,2540,-15,-0.59,8507,21666580
025530,SJM홀딩스,2535,2520,-15,-0.59,18881,47354190
034730,SK,226500,226500,0,0.0,314574,71199314000
011790,SKC,69300,70400,1100,1.59,275240,19331775700
018670,SK가스,81400,83700,2300,2.83,48159,4011159800
001740,SK네트웍스,5170,5190,20,0.39,643285,3352877190
001745,SK네트웍스우,186000,180500,-5500,-2.96,8834,1602168500
006120,SK디스커버리,52100,52000,-100,-0.19,1634073,85914614850
006125,SK디스커버리우,59000,65900,6900,11.69,985085,65101397600
210980,SK디앤디,34900,33750,-1150,-3.3,147401,5083578100
068400,SK렌터카,9190,9200,10,0.11,59499,546233680
326030,SK바이오팜,191500,190000,-1500,-0.78,351351,66917044500
03473K,SK우,233000,230000,-3000,-1.29,33934,7823460500
096770,SK이노베이션,131000,133000,2000,1.53,560167,74284945500
096775,SK이노베이션우,90200,90700,500,0.55,8575,775928700
001510,SK증권,843,836,-7,-0.83,8276591,6972641873
001515,SK증권우,6550,6430,-120,-1.83,386266,2487199170
285130,SK케미칼,310000,292500,-17500,-5.65,1216222,360612089500
28513K,SK케미칼우,202500,202500,0,0.0,0,0
017670,SK텔레콤,208500,214000,5500,2.64,418247,89405256000
000660,SK하이닉스,82800,83100,300,0.36,4538720,378147743500
005610,SPC삼립,66900,66800,-100,-0.15,11356,762052700
011810,STX,5680,5630,-50,-0.88,35992,202379280
077970,STX엔진,5900,5820,-80,-1.36,34774,202809520
071970,STX중공업,2435,2355,-80,-3.29,120525,286680205
084870,TBH글로벌,1915,1825,-90,-4.7,424851,780117150
002710,TCC스틸,1865,1850,-15,-0.8,38427,71060325
024070,WISCOM,2270,2275,5,0.22,32618,74132890
037270,YGPLUS,3300,3300,0,0.0,1203199,3995781480
000500,가온전선,16700,16700,0,0.0,3021,50365400
000860,강남제비스코,15100,15250,150,0.99,9817,148881150
035250,강원랜드,22950,22750,-200,-0.87,668609,15305201200
011420,갤럭시아에스엠,1385,1415,30,2.17,283294,419558470
002100,경농,14200,13550,-650,-4.58,612624,8386138600
009450,경동나비엔,51400,51800,400,0.78,56820,2941549200
267290,경동도시가스,16750,16800,50,0.3,9567,159704050
012320,경동인베스트,28000,27900,-100,-0.36,1578,44163250
000050,경방,12000,11700,-300,-2.5,23249,276202100
214390,경보제약,10400,10750,350,3.37,400938,4197684000
012610,경인양행,8800,8680,-120,-1.36,814998,7127365770
009140,경인전자,18700,18850,150,0.8,839,16254350
013580,계룡건설,27050,23850,-3200,-11.83,712538,17735495950
012200,계양전기,2830,2780,-50,-1.77,139675,392265190
012205,계양전기우,8090,8000,-90,-1.11,41503,334660750
002140,고려산업,3760,3705,-55,-1.46,391800,1461261705
010130,고려아연,430500,433500,3000,0.7,179845,79351686000
002240,고려제강,16050,16100,50,0.31,58810,948964700
009290,광동제약,9810,9550,-260,-2.65,3138431,31464691480
017040,광명전기,1905,1900,-5,-0.26,249710,474129075
017900,광전자,2345,2460,115,4.9,21110272,56214593365
037710,광주신세계,135000,135000,0,0.0,211,28610000
030610,교보증권,6850,6830,-20,-0.29,113348,779443790
007690,국도화학,38150,37600,-550,-1.44,13816,522268550
005320,국동,2825,2990,165,5.84,2307780,6721778965
001140,국보,2470,2350,-120,-4.86,1418892,3371273440
002720,국제약품,10550,10800,250,2.37,817660,8566482250
083420,그린케미칼,3315,3320,5,0.15,98298,324485925
014530,극동유화,3070,3085,15,0.49,62614,192989620
014280,금강공업,3605,3565,-40,-1.11,59046,210573845
014285,금강공업우,12150,12400,250,2.06,89244,1095731550
008870,금비,58300,57500,-800,-1.37,1516,87813400
001570,금양,4150,4060,-90,-2.17,377115,1540132055
002990,금호산업,6590,7120,530,8.04,5705902,42779421200
002995,금호산업우,35600,46200,10600,29.78,436352,19519633900
011780,금호석유,87600,85900,-1700,-1.94,207488,17904799900
011785,금호석유우,33650,33100,-550,-1.63,43026,1444478400
214330,금호에이치티,2750,2490,-260,-9.45,3067384,7926123750
001210,금호전기,3725,3600,-125,-3.36,111657,408223945
073240,금호타이어,2960,2945,-15,-0.51,605036,1779205240
092440,기신정기,3080,3100,20,0.65,26920,83382390
000270,기아차,37700,37700,0,0.0,1698056,63906871050
024110,기업은행,8290,8300,10,0.12,1916364,15923650500
013700,까뮤이앤씨,1310,1295,-15,-1.15,277338,360972530
004540,깨끗한나라,3995,3840,-155,-3.88,492010,1905126815
004545,깨끗한나라우,25950,24000,-1950,-7.51,27299,665382100
001260,남광토건,10800,10850,50,0.46,24996,270447450
008350,남선알미늄,5520,5530,10,0.18,2856390,15889670210
008355,남선알미우,78300,79000,700,0.89,20664,1631459300
004270,남성,2890,2920,30,1.04,395694,1152843380
003920,남양유업,273000,270000,-3000,-1.1,3128,849015500
003925,남양유업우,167500,157000,-10500,-6.27,3133,500327500
002070,남영비비안,1125,1060,-65,-5.78,7884328,8397171930
025860,남해화학,8030,7900,-130,-1.62,256237,2023853580
005720,넥센,3965,3985,20,0.5,47731,188955565
005725,넥센우,3120,3110,-10,-0.32,18379,56736475
002350,넥센타이어,5220,5190,-30,-0.57,200167,1040773770
002355,넥센타이어1우B,2305,2305,0,0.0,10345,23842660
003580,넥스트사이언스,5180,5150,-30,-0.58,247141,1266862360
251270,넷마블,125500,127500,2000,1.59,594652,76668092500
090350,노루페인트,7460,7460,0,0.0,41463,311764370
090355,노루페인트우,14350,14050,-300,-2.09,17517,247502300
000320,노루홀딩스,9330,9350,20,0.21,4397,41120570
000325,노루홀딩스우,19250,19350,100,0.52,2245,43252600
006280,녹십자,237500,235500,-2000,-0.84,305430,71950356500
005250,녹십자홀딩스,26950,27050,100,0.37,196132,5297193550
005257,녹십자홀딩스2우,113000,129000,16000,14.16,91859,11462093500
004370,농심,365000,365000,0,0.0,35075,12725897000
072710,농심홀딩스,82300,81900,-400,-0.49,1966,160425300
058730,다스코,5000,4975,-25,-0.5,18160,90554520
023590,다우기술,20750,21250,500,2.41,228238,4833650450
019680,대교,4085,4085,0,0.0,51477,211145955
019685,대교우B,2650,2650,0,0.0,66696,176492095
006370,대구백화점,4895,4900,5,0.1,3774,18509790
008060,대덕,6630,6720,90,1.36,699429,4724738090
00806K,대덕1우,6660,6680,20,0.3,19308,129820560
353200,대덕전자,12700,13600,900,7.09,16105680,217772348650
35320K,대덕전자1우,7240,7320,80,1.1,447854,3361191520
000490,대동공업,6890,6790,-100,-1.45,136722,937419510
008110,대동전자,4195,4225,30,0.72,14891,62622450
005750,대림BCo,5240,5190,-50,-0.95,34544,180112740
001880,대림건설,30250,27750,-2500,-8.26,387325,11500347350
000210,대림산업,84300,83700,-600,-0.71,236271,19782531000
000215,대림산업우,38950,38250,-700,-1.8,13916,533987700
004440,대림씨엔에스,7040,7000,-40,-0.57,39925,279250740
006570,대림통상,4305,4425,120,2.79,246,1081340
001680,대상,25650,25400,-250,-0.97,265523,6790101750
001685,대상우,14650,14450,-200,-1.37,10548,152327500
084690,대상홀딩스,8480,8500,20,0.24,201719,1738124750
084695,대상홀딩스우,6950,6830,-120,-1.73,18251,127302310
128820,대성산업,3275,3200,-75,-2.29,123501,398144295
117580,대성에너지,4905,4905,0,0.0,21453,105088705
016710,대성홀딩스,13800,14000,200,1.45,66149,914597550
003540,대신증권,10350,10400,50,0.48,54943,570999350
003547,대신증권2우B,9330,9270,-60,-0.64,38821,361469340
003545,대신증권우,9370,9380,10,0.11,63760,598330950
009190,대양금속,4610,4650,40,0.87,3458445,16192118900
014160,대영포장,1055,1060,5,0.47,758199,806288790
047040,대우건설,3505,3755,250,7.13,5826855,21423585905
009320,대우부품,2395,2410,15,0.63,621749,1494904700
042660,대우조선해양,23650,23550,-100,-0.42,226488,5342666600
003090,대웅,26050,26000,-50,-0.19,498067,12911808150
069620,대웅제약,109500,109500,0,0.0,96929,10661413500
000430,대원강업,3110,3090,-20,-0.64,11844,36783690
006340,대원전선,1020,1010,-10,-0.98,462054,471010610
006345,대원전선우,3930,3835,-95,-2.42,88401,344187395
003220,대원제약,21050,21500,450,2.14,1491421,31530150650
024890,대원화성,1790,1760,-30,-1.68,201289,355980560
002880,대유에이텍,677,675,-2,-0.3,128691,87429557
000300,대유플러스,638,635,-3,-0.47,206984,131347173
012800,대창,1205,1235,30,2.49,5399636,6715277200
015230,대창단조,26750,26500,-250,-0.93,6081,161611150
001070,대한방직,33450,33150,-300,-0.9,7810,260825050
006650,대한유화,124500,129500,5000,4.02,87545,11124707500
001440,대한전선,976,931,-45,-4.61,10228360,9524250969
084010,대한제강,6660,6620,-40,-0.6,36330,241377660
001790,대한제당,19800,19700,-100,-0.51,18603,366448250
001795,대한제당우,14700,14550,-150,-1.02,5463,79270400
001130,대한제분,154000,156500,2500,1.62,9065,1414807500
003490,대한항공,17600,17900,300,1.7,5418736,98467824850
003495,대한항공우,18100,18950,850,4.7,597995,12013594000
005880,대한해운,15950,16000,50,0.31,66151,1059678400
003830,대한화섬,87100,87900,800,0.92,889,78082700
016090,대현,1780,1750,-30,-1.69,152591,268779530
069460,대호에이엘,2235,2315,80,3.58,332401,769134600
192080,더블유게임즈,76100,76300,200,0.26,138461,10514525700
012510,더존비즈온,105000,105000,0,0.0,45597,4799543000
004830,덕성,4630,4500,-130,-2.81,423476,1921070240
004835,덕성우,11050,10800,-250,-2.26,67924,729511450
024900,덕양산업,1565,1545,-20,-1.28,634892,995332075
145720,덴티움,43900,44900,1000,2.28,227470,10065861150
002150,도화엔지니어링,7960,7940,-20,-0.25,84379,672974300
001230,동국제강,6050,6010,-40,-0.66,504737,3045846240
023450,동남합성,32350,32250,-100,-0.31,1934,62091300
004140,동방,1915,1900,-15,-0.78,274892,524896420
007590,동방아그로,6530,6470,-60,-0.92,27332,176144190
005960,동부건설,11900,11900,0,0.0,85856,1014261650
005965,동부건설우,32200,33050,850,2.64,6279,205576950
026960,동서,20800,21000,200,0.96,308461,6551824650
002210,동성제약,13650,12900,-750,-5.49,1390305,18270603250
102260,동성코퍼레이션,3895,3905,10,0.26,27764,107544855
005190,동성화학,16300,16150,-150,-0.92,8667,140491400
000640,동아쏘시오홀딩스,103000,103000,0,0.0,21678,2250617000
170900,동아에스티,96700,96700,0,0.0,48109,4672407400
028100,동아지질,15600,15750,150,0.96,113194,1779379400
282690,동아타이어,10800,10700,-100,-0.93,408,4394650
001520,동양,1215,1195,-20,-1.65,1037709,1250782675
001527,동양2우B,13600,17650,4050,29.78,45911,786065600
001529,동양3우B,27450,28400,950,3.46,15167,452166150
084670,동양고속,26500,26450,-50,-0.19,3445,91221050
002900,동양물산,1100,1070,-30,-2.73,2020578,2193690620
082640,동양생명,2995,3005,10,0.33,39895,119860815
001525,동양우,7430,7800,370,4.98,116792,915324500
008970,동양철관,1045,1050,5,0.48,1219363,1270938310
092780,동양피스톤,5070,5240,170,3.35,245694,1268709000
049770,동원FB,188000,183500,-4500,-2.39,7351,1361373000
018500,동원금속,690,688,-2,-0.29,227998,156506373
006040,동원산업,196500,195500,-1000,-0.51,4577,897472000
030720,동원수산,9240,9160,-80,-0.87,40779,373897560
014820,동원시스템즈,21450,21200,-250,-1.17,19092,411053000
014825,동원시스템즈우,31000,30400,-600,-1.94,550,16564550
163560,동일고무벨트,8150,8100,-50,-0.61,51897,420968660
004890,동일산업,69000,69500,500,0.72,3788,262299400
002690,동일제강,1895,1895,0,0.0,28151,53358405
000020,동화약품,23000,23450,450,1.96,1924723,45505522450
000150,두산,44000,42350,-1650,-3.75,156360,6683569200
000157,두산2우B,84100,85100,1000,1.19,14218,1200614600
241560,두산밥캣,28150,27950,-200,-0.71,380374,10692743250
336370,두산솔루스,36400,38150,1750,4.81,1764085,67550860100
33637K,두산솔루스1우,17750,18250,500,2.82,302925,5656241550
33637L,두산솔루스2우B,36300,37700,1400,3.86,59460,2242141050
000155,두산우,37600,38500,900,2.39,39148,1484096500
042670,두산인프라코어,7440,7380,-60,-0.81,11403199,83249070060
034020,두산중공업,8710,9950,1240,14.24,7321406,68699254490
336260,두산퓨얼셀,45200,46000,800,1.77,2055749,93871482050
33626K,두산퓨얼셀1우,13600,13550,-50,-0.37,343467,4681117600
33626L,두산퓨얼셀2우B,21850,21900,50,0.23,64373,1422086050
016740,두올,3495,3810,315,9.01,3805182,14222832330
192650,드림텍,11200,11600,400,3.57,6506890,77470086750
024090,디씨엠,11000,11050,50,0.45,4404,48782300
003160,디아이,4130,4115,-15,-0.36,151781,628814935
092200,디아이씨,1590,1590,0,0.0,182124,291812220
013570,디와이,4020,4145,125,3.11,210844,864509345
210540,디와이파워,11900,11800,-100,-0.84,336541,3990054450
007340,디티알오토모티브,23850,23900,50,0.21,7134,170120650
026890,디피씨,16750,17600,850,5.07,6385704,111345883900
115390,락앤락,10800,10800,0,0.0,94440,1019462700
032350,롯데관광개발,16600,16200,-400,-2.41,333961,5489183050
330590,롯데리츠,5130,5100,-30,-0.58,332577,1699160860
000400,롯데손해보험,1750,1770,20,1.14,432012,761557100
023530,롯데쇼핑,78100,78000,-100,-0.13,71920,5627335800
004000,롯데정밀화학,42800,41900,-900,-2.1,112054,4715226300
286940,롯데정보통신,33900,33800,-100,-0.29,23595,794503850
280360,롯데제과,106500,105500,-1000,-0.94,11976,1265539500
004990,롯데지주,31500,31350,-150,-0.48,195308,6151200150
00499K,롯데지주우,69000,68400,-600,-0.87,26856,1843766800
005300,롯데칠성,101500,100000,-1500,-1.48,21086,2119415000
005305,롯데칠성우,64900,63900,-1000,-1.54,8448,541791100
011170,롯데케미칼,171000,171500,500,0.29,154676,26556473500
002270,롯데푸드,332500,333000,500,0.15,2947,980037000
071840,롯데하이마트,31550,31500,-50,-0.16,100494,3174175800
027740,마니커,788,762,-26,-3.3,7128129,5453127631
204320,만도,23250,23400,150,0.65,372231,8703082550
001080,만호제강,14800,14500,-300,-2.03,5608,81441950
088980,맥쿼리인프라,11300,11300,0,0.0,423768,4791930250
094800,맵스리얼티1,4005,4000,-5,-0.12,53064,212765105
138040,메리츠금융지주,8840,8710,-130,-1.47,154304,1352693860
008560,메리츠증권,3155,3150,-5,-0.16,1817814,5764366520
000060,메리츠화재,12700,12650,-50,-0.39,165342,2094161700
090370,메타랩스,1190,1205,15,1.26,202300,245222410
017180,명문제약,6060,5950,-110,-1.82,2181004,13093745640
012690,모나리자,5980,5900,-80,-1.34,437766,2589229890
005360,모나미,8780,8390,-390,-4.44,25316680,216573769030
204210,모두투어리츠,2825,2755,-70,-2.48,2910,8139305
009680,모토닉,7300,7340,40,0.55,46049,336666910
009580,무림PP,2995,2995,0,0.0,103686,312946090
009200,무림페이퍼,2050,2060,10,0.49,67027,138066690
033920,무학,5330,5370,40,0.75,69278,368208820
008420,문배철강,2775,2685,-90,-3.24,392329,1062665080
025560,미래산업,3325,3325,0,0.0,140479,467774300
007120,미래아이앤지,379,377,-2,-0.53,680894,256430692
006800,미래에셋대우,7540,7540,0,0.0,2233695,16887008210
00680K,미래에셋대우2우B,4200,4200,0,0.0,720818,3038418275
006805,미래에셋대우우,4770,4800,30,0.63,56925,272794145
085620,미래에셋생명,3285,3260,-25,-0.76,197676,640692710
002840,미원상사,80800,81300,500,0.62,4161,337033700
268280,미원에스씨,80500,80200,-300,-0.37,2748,219914000
107590,미원홀딩스,47550,47000,-550,-1.16,1701,80398200
134380,미원화학,52500,52300,-200,-0.38,426,22350600
003650,미창석유,58100,57700,-400,-0.69,458,26340800
155900,바다로19호,2625,2630,5,0.19,1409,3702125
003610,방림,1730,1730,0,0.0,69133,119411140
001340,백광산업,3515,3710,195,5.55,6674660,24173456410
035150,백산,5040,5030,-10,-0.2,137556,693253760
002410,범양건영,5190,5320,130,2.5,1226240,6391639560
096300,베트남개발1,289,291,2,0.69,63000,18278680
007210,벽산,1850,1810,-40,-2.16,494888,901471290
002760,보락,1885,1880,-5,-0.27,469534,883785870
003850,보령제약,16150,16050,-100,-0.62,624377,10170373800
000890,보해양조,897,882,-15,-1.67,2423285,2153544723
003000,부광약품,38750,38100,-650,-1.68,3264523,125514229800
001270,부국증권,19150,18900,-250,-1.31,1783,33907550
001275,부국증권우,18000,18000,0,0.0,730,13117650
026940,부국철강,5290,5360,70,1.32,591496,3210168660
015350,부산가스,36550,36450,-100,-0.27,1535,55734100
011390,부산산업,130500,129500,-1000,-0.77,20449,2680174500
005030,부산주공,338,339,1,0.3,93294,31842490
100220,비상교육,7020,7030,10,0.14,29710,208413430
030790,비케이탑스,6900,6740,-160,-2.32,179061,1203996250
101140,비티원,3955,3930,-25,-0.63,786687,3175004620
005180,빙그레,61800,61200,-600,-0.97,22302,1370274800
003960,사조대림,14700,14500,-200,-1.36,44279,649597100
008040,사조동아원,873,880,7,0.8,378874,332942184
007160,사조산업,35250,34250,-1000,-2.84,393435,14650605250
014710,사조씨푸드,3965,3935,-30,-0.76,200225,804686845
006090,사조오양,8500,8310,-190,-2.24,77887,656848520
005090,삼광글라스,28750,28600,-150,-0.52,3721,106365650
001470,삼부토건,718,713,-5,-0.7,690735,492340964
006400,삼성SDI,378000,393000,15000,3.97,1061859,415716361500
006405,삼성SDI우,223500,229500,6000,2.68,23813,5439017500
006660,삼성공조,6290,6360,70,1.11,8657,55051820
028260,삼성물산,106500,108500,2000,1.88,554410,60264967500
02826K,삼성물산우B,86700,88900,2200,2.54,22177,1972609300
207940,삼성바이오로직스,754000,761000,7000,0.93,167728,128162881500
032830,삼성생명,46600,47100,500,1.07,414355,19447118550
018260,삼성에스디에스,173500,174000,500,0.29,112175,19553036000
028050,삼성엔지니어링,12100,12000,-100,-0.83,1014370,12278715850
009150,삼성전기,138000,144500,6500,4.71,1373437,197757902000
009155,삼성전기우,60600,63100,2500,4.13,112796,7108179600
005930,삼성전자,55600,58600,3000,5.4,48431566,2803148376939
005935,삼성전자우,47500,49500,2000,4.21,6280763,307868958650
001360,삼성제약,4405,4250,-155,-3.52,5610721,24297837430
010140,삼성중공업,5650,5680,30,0.53,3613044,20518739300
010145,삼성중공우,517000,499000,-18000,-3.48,17026,8572974500
016360,삼성증권,29400,29550,150,0.51,440454,13054436600
068290,삼성출판사,22200,21750,-450,-2.03,87793,1928049600
029780,삼성카드,28150,28050,-100,-0.36,220003,6205807800
000810,삼성화재,177000,175500,-1500,-0.85,177633,31195437000
000815,삼성화재우,123500,123500,0,0.0,10309,1270553500
006110,삼아알미늄,5680,5270,-410,-7.22,273085,1474501920
145990,삼양사,68100,67000,-1100,-1.62,74520,4887243900
145995,삼양사우,55500,52400,-3100,-5.59,72426,3736179400
003230,삼양식품,124000,122000,-2000,-1.61,54672,6707662000
002170,삼양통상,56500,56300,-200,-0.35,2476,138923100
272550,삼양패키징,18500,18400,-100,-0.54,15266,281551650
000070,삼양홀딩스,72000,71100,-900,-1.25,42067,2993517300
000075,삼양홀딩스우,55100,52600,-2500,-4.54,11259,582022300
002810,삼영무역,12350,12550,200,1.62,107257,1341623100
005680,삼영전자,7610,7690,80,1.05,43862,336572490
003720,삼영화학,1425,1645,220,15.44,6309433,10591836140
023000,삼원강재,2020,2015,-5,-0.25,15313,30874700
004380,삼익THK,10200,10300,100,0.98,39017,400099350
002450,삼익악기,1465,1450,-15,-1.02,371323,538038770
000520,삼일제약,19700,19550,-150,-0.76,96873,1886082950
009770,삼정펄프,25400,25400,0,0.0,2668,67623750
005500,삼진제약,29400,29400,0,0.0,169699,4983502600
004690,삼천리,78000,78200,200,0.26,9915,779517100
010960,삼호개발,4315,4395,80,1.85,374643,1665654390
004450,삼화왕관,42900,41750,-1150,-2.68,1771,74724300
009470,삼화전기,18500,19200,700,3.78,228028,4368443300
011230,삼화전자,3190,3080,-110,-3.45,279109,864126825
001820,삼화콘덴서,54900,59500,4600,8.38,1193068,69516641000
000390,삼화페인트,4900,4915,15,0.31,32297,159461665
001290,상상인증권,1060,1050,-10,-0.94,45867,48355295
041650,상신브레이크,2450,2400,-50,-2.04,264916,654586285
075180,새론오토모티브,4020,4065,45,1.12,29488,120814325
007540,샘표,62700,59900,-2800,-4.47,110949,6676058600
248170,샘표식품,48000,46350,-1650,-3.44,76996,3586092450
007860,서연,6550,6530,-20,-0.31,645643,4231982580
200880,서연이화,3705,3630,-75,-2.02,208122,754557945
017390,서울가스,68600,68100,-500,-0.73,454,31240600
004410,서울식품,158,157,-1,-0.63,3157740,496711545
004415,서울식품우,4630,4530,-100,-2.16,623544,2994873860
021050,서원,3680,3680,0,0.0,1076443,3960838085
008490,서흥,56500,56600,100,0.18,54797,3090077000
007610,선도전기,2560,2630,70,2.73,212892,561794605
136490,선진,10050,10050,0,0.0,55372,553716670
002820,선창산업,3570,3570,0,0.0,17838,63490645
014910,성문전자,1540,1530,-10,-0.65,166175,255586265
014915,성문전자우,11450,11200,-250,-2.18,20031,227236550
003080,성보화학,4435,4400,-35,-0.79,14697,64526265
004980,성신양회,8520,7830,-690,-8.1,1772894,14122608430
004985,성신양회우,23400,19950,-3450,-14.74,1093859,26391204900
011300,성안,390,394,4,1.03,74845,29385764
000180,성창기업지주,1675,1720,45,2.69,213235,361875290
002420,세기상사,62200,63700,1500,2.41,2048,129883000
004360,세방,10250,10300,50,0.49,37290,380131850
004365,세방우,6160,6190,30,0.49,373,2303760
004490,세방전지,29300,29250,-50,-0.17,25370,746967600
001430,세아베스틸,11750,11300,-450,-3.83,292363,3390012700
306200,세아제강,58500,56800,-1700,-2.91,13683,786779400
003030,세아제강지주,38900,38700,-200,-0.51,4637,179685800
019440,세아특수강,10400,10450,50,0.48,6435,67417350
058650,세아홀딩스,73500,73000,-500,-0.68,27,1979000
013000,세우글로벌,1905,1895,-10,-0.52,461516,881555530
091090,세원셀론텍,2895,2865,-30,-1.04,454938,1308860665
021820,세원정공,8090,8090,0,0.0,0,0
067830,세이브존IC,2175,2185,10,0.46,25754,56395320
033530,세종공업,6700,6480,-220,-3.28,662746,4326561230
075580,세진중공업,5550,5880,330,5.95,662740,3804025780
027970,세하,1605,1615,10,0.62,580933,960551045
145210,세화아이엠씨,1100,1175,75,6.82,4473070,5342713500
308170,센트랄모텍,28800,28950,150,0.52,117689,3418461350
068270,셀트리온,317000,317500,500,0.16,666062,212455859000
004430,송원산업,13100,13250,150,1.15,91113,1198939300
017550,수산중공업,1760,1730,-30,-1.7,566915,986750930
053210,스카이라이프,8920,8840,-80,-0.9,2816560,27232108440
134790,시디즈,50300,50300,0,0.0,2312,116169400
016590,신대양제지,56400,56600,200,0.35,9489,534245400
029530,신도리코,23400,23300,-100,-0.43,17279,403650100
004970,신라교역,9850,9910,60,0.61,4726,46586440
011930,신성이엔지,1410,1415,5,0.35,3854336,5445794850
005390,신성통상,2370,2240,-130,-5.49,33547722,75329808570
004170,신세계,209000,209500,500,0.24,49358,10331959500
035510,신세계IC,121500,119500,-2000,-1.65,4093,490824000
034300,신세계건설,21350,21400,50,0.23,4230,90532750
031430,신세계인터내셔날,149500,149000,-500,-0.33,24706,3695409000
031440,신세계푸드,54600,54300,-300,-0.55,8937,483887200
006880,신송홀딩스,3950,3830,-120,-3.04,34044,131352720
005800,신영와코루,92300,92200,-100,-0.11,321,29237600
001720,신영증권,44850,44800,-50,-0.11,3971,178388400
001725,신영증권우,43400,43800,400,0.92,2568,112442950
009270,신원,1625,1645,20,1.23,1511961,2500450965
009275,신원우,55200,54000,-1200,-2.17,5627,310236200
002700,신일전자,1900,1935,35,1.84,6043912,11739077470
019170,신풍제약,73500,71600,-1900,-2.59,36371681,2456090347400
019175,신풍제약우,109000,135000,26000,23.85,2041642,236303152900
002870,신풍제지,1610,1630,20,1.24,1262829,2043611490
293940,신한알파리츠,6480,6500,20,0.31,83348,541659560
055550,신한지주,30500,30750,250,0.82,1723733,52984486450
001770,신화실업,20700,20250,-450,-2.17,3894,79116300
004080,신흥,9160,9170,10,0.11,1786,16335580
102280,쌍방울,806,779,-27,-3.35,3129150,2452418958
003410,쌍용양회,4940,4940,0,0.0,816737,4040133560
003415,쌍용양회우,15000,14450,-550,-3.67,9083,131430700
003620,쌍용차,3870,3800,-70,-1.81,2032729,7703444235
004770,써니전자,3800,3755,-45,-1.18,1531293,5823605165
015540,쎌마테라퓨틱스,9460,9570,110,1.16,682097,6413417230
004920,씨아이테크,1095,1100,5,0.46,243390,263591600
112610,씨에스윈드,68500,72000,3500,5.11,474131,32912133500
008700,아남전자,1745,1750,5,0.29,647773,1135207930
002790,아모레G,53800,53100,-700,-1.3,84062,4482832900
00279K,아모레G3우전환,34050,33900,-150,-0.44,8089,274427450
002795,아모레G우,23200,23000,-200,-0.86,30638,708493050
090430,아모레퍼시픽,164500,163000,-1500,-0.91,167352,27361002500
090435,아모레퍼시픽우,60100,59900,-200,-0.33,45436,2731317900
002030,아세아,75200,74800,-400,-0.53,2630,197159600
183190,아세아시멘트,61200,60700,-500,-0.82,13565,824305100
002310,아세아제지,28950,28650,-300,-1.04,87403,2541561600
267850,아시아나IDT,14150,18350,4200,29.68,6450162,112582924000
020560,아시아나항공,3560,4295,735,20.65,75616105,321825374175
122900,아이마켓코리아,8400,8380,-20,-0.24,58445,489497360
010780,아이에스동서,47950,46500,-1450,-3.02,313833,14763333050
033660,아주캐피탈,11400,11200,-200,-1.75,72801,824289550
001780,알루코,2125,2060,-65,-3.06,588771,1221535685
018250,애경산업,22700,22350,-350,-1.54,95424,2140602100
161000,애경유화,6800,6800,0,0.0,81033,547517440
011090,에넥스,1155,1140,-15,-1.3,542109,620139920
005850,에스엘,11850,11750,-100,-0.84,187636,2198152250
012750,에스원,84700,85800,1100,1.3,70920,6089081242
023960,에쓰씨엔지니어링,1240,1260,20,1.61,40453,50606630
298690,에어부산,3420,3950,530,15.5,10417580,41583551970
140910,에이리츠,6400,6460,60,0.94,3076,19773380
078520,에이블씨엔씨,8350,8310,-40,-0.48,81896,680481100
015260,에이엔피,230,183,-47,-20.43,8290094,1535630102
007460,에이프로젠KIC,2800,2785,-15,-0.54,3020693,8409685655
003060,에이프로젠제약,1540,1530,-10,-0.65,6391726,9806707190
036570,엔씨소프트,785000,794000,9000,1.15,177440,140613700000
138250,엔에스쇼핑,12050,12300,250,2.07,91672,1119108750
085310,엔케이,1085,1115,30,2.76,806682,878517630
009810,엔케이물산,538,530,-8,-1.49,353496,189557507
900140,엘브이엠씨홀딩스,3770,3700,-70,-1.86,185350,685939100
014440,영보화학,4800,4360,-440,-9.17,1459969,6510279610
111770,영원무역,24700,24550,-150,-0.61,109867,2711511750
009970,영원무역홀딩스,33750,33400,-350,-1.04,11838,395683000
003520,영진약품,6950,6710,-240,-3.45,14929410,102615172710
000670,영풍,529000,534000,5000,0.95,6466,3532515000
006740,영풍제지,3450,3410,-40,-1.16,58744,199880715
012280,영화금속,1905,1965,60,3.15,10993874,21604126790
012160,영흥,1215,1190,-25,-2.06,1462784,1786451225
015360,예스코홀딩스,34100,34500,400,1.17,2363,83288350
007310,오뚜기,556000,556000,0,0.0,4224,2354759000
002630,오리엔트바이오,774,758,-16,-2.07,2077211,1591346753
271560,오리온,132000,134500,2500,1.89,81639,10932251500
001800,오리온홀딩스,13000,12900,-100,-0.77,93814,1211848300
070960,용평리조트,4390,4450,60,1.37,413484,1846625390
316140,우리금융지주,8780,8680,-100,-1.14,2168806,18900970200
004720,우리들제약,7630,7340,-290,-3.8,1002086,7588083550
118000,우리들휴브레인,3320,3385,65,1.96,2969496,10107954710
010050,우리종금,595,586,-9,-1.51,2289906,1360936539
006980,우성사료,3335,3235,-100,-3.0,907819,2957308585
017370,우신시스템,2880,2855,-25,-0.87,72215,207646190
105840,우진,3710,3650,-60,-1.62,164281,604033195
010400,우진아이엔에스,6990,6990,0,0.0,16416,115034170
049800,우진플라임,3650,3610,-40,-1.1,30893,110194275
016880,웅진,1125,1105,-20,-1.78,153235,170475635
095720,웅진씽크빅,2520,2505,-15,-0.6,253728,638288920
005820,원림,16750,17600,850,5.07,2054,35849350
010600,웰바이오텍,3545,3480,-65,-1.83,935772,3245014740
008600,윌비스,1310,1290,-20,-1.53,1056933,1372465575
033270,유나이티드제약,25100,25350,250,1.0,198708,5012999300
014830,유니드,42050,43500,1450,3.45,55907,2422104350
000910,유니온,9100,8310,-790,-8.68,7396107,60657228360
047400,유니온머티리얼,5630,5230,-400,-7.1,11124243,57655583930
011330,유니켐,1410,1400,-10,-0.71,202798,285575115
077500,유니퀘스트,10700,10350,-350,-3.27,662788,6935459800
002920,유성기업,2460,2460,0,0.0,11360,27994105
000700,유수홀딩스,5700,5740,40,0.7,27927,159021850
003470,유안타증권,2830,2825,-5,-0.18,365642,1038427270
003475,유안타증권우,2230,2215,-15,-0.67,171253,383000905
011690,유양디앤유,1220,1220,0,0.0,0,0
072130,유엔젤,3235,3220,-15,-0.46,98268,318349120
000220,유유제약,16000,17200,1200,7.5,2077270,35275045600
000225,유유제약1우,14450,18750,4300,29.76,1307730,22680091800
000227,유유제약2우B,44600,57900,13300,29.82,105771,6003348600
001200,유진투자증권,3540,3550,10,0.28,860252,3074841615
000100,유한양행,56700,56300,-400,-0.71,1006262,56714112200
000105,유한양행우,72200,69700,-2500,-3.46,80279,5685127100
003460,유화증권,2190,2180,-10,-0.46,5113,11121565
003465,유화증권우,2480,2600,120,4.84,10311,26634410
008730,율촌화학,16850,16550,-300,-1.78,210570,3498373000
008250,이건산업,7650,7600,-50,-0.65,72146,549891680
025820,이구산업,1625,1595,-30,-1.85,343102,549983905
214320,이노션,48900,48800,-100,-0.2,61368,3023713500
088260,이리츠코크렙,5220,5220,0,0.0,33088,172712250
139480,이마트,111000,111000,0,0.0,219664,24450441500
007660,이수페타시스,4400,4390,-10,-0.23,785001,3419309420
005950,이수화학,8790,8670,-120,-1.37,113273,987425730
015020,이스타코,769,772,3,0.39,142092,109096987
093230,이아이디,250,263,13,5.2,27348634,7136416918
074610,이엔플러스,5750,5620,-130,-2.26,782981,4475112840
102460,이연제약,15600,15500,-100,-0.64,100831,1566728100
084680,이월드,3880,3840,-40,-1.03,347219,1341817150
334890,이지스밸류리츠,4465,4455,-10,-0.22,326197,1454379340
000760,이화산업,14250,14250,0,0.0,2438,34387400
014990,인디에프,2010,2015,5,0.25,562094,1132195470
006490,인스코비,2200,2170,-30,-1.36,752649,1637263550
023800,인지컨트롤스,5160,5170,10,0.19,103040,539215280
034590,인천도시가스,24150,24050,-100,-0.41,1536,37024800
129260,인터지스,2900,2860,-40,-1.38,577852,1671302035
023810,인팩,4655,4655,0,0.0,10706,49393895
249420,일동제약,16000,16150,150,0.94,97271,1551399900
000230,일동홀딩스,9250,9150,-100,-1.08,15868,145747680
013360,일성건설,971,966,-5,-0.51,98667,95277430
003120,일성신약,88000,85600,-2400,-2.73,33275,2848940800
003200,일신방직,70900,69200,-1700,-2.4,16676,1166256000
007110,일신석재,2350,2350,0,0.0,940324,2218449155
007570,일양약품,87000,89200,2200,2.53,1241604,110538512700
007575,일양약품우,99700,108000,8300,8.32,42168,4486624000
008500,일정실업,13000,12650,-350,-2.69,2431,31036900
081000,일진다이아,56300,56500,200,0.36,314173,17874724000
020760,일진디스플,2990,3030,40,1.34,155430,467667655
020150,일진머티리얼즈,49850,49650,-200,-0.4,410098,20511977250
103590,일진전기,2790,2825,35,1.25,186518,533040140
015860,일진홀딩스,4880,4800,-80,-1.64,313975,1516700450
226320,잇츠한불,21950,22100,150,0.68,286044,6465767800
317400,자이에스앤디,5940,6420,480,8.08,1031762,6499445390
033240,자화전자,11650,13300,1650,14.16,2847493,37341284700
000950,전방,25450,26550,1100,4.32,155735,4282973900
194370,제이에스코퍼레이션,6850,6800,-50,-0.73,25271,171312280
025620,제이준코스메틱,2880,2820,-60,-2.08,520560,1474474925
036420,제이콘텐트리,30000,30000,0,0.0,63444,1908360800
030000,제일기획,18200,19800,1600,8.79,2419211,46378896300
271980,제일약품,48900,48800,-100,-0.2,507940,25120363700
001560,제일연마,6650,6650,0,0.0,12187,81889420
002620,제일파마홀딩스,21750,21550,-200,-0.92,125067,2736466750
006220,제주은행,3090,3095,5,0.16,17802,55092565
089590,제주항공,15700,15900,200,1.27,809066,13441662900
004910,조광페인트,5520,5520,0,0.0,14159,77471420
004700,조광피혁,52800,51600,-1200,-2.27,4172,218411900
001550,조비,26550,24600,-1950,-7.34,504195,12555680550
000480,조선내화,72800,72500,-300,-0.41,3238,234273900
120030,조선선재,111000,109000,-2000,-1.8,12208,1335443500
018470,조일알미늄,601,600,-1,-0.17,284570,170503369
002600,조흥,155000,156000,1000,0.65,205,31926000
185750,종근당,140000,137000,-3000,-2.14,93916,13055626500
063160,종근당바이오,39900,39700,-200,-0.5,65680,2614534000
001630,종근당홀딩스,116000,123000,7000,6.03,78832,9617317500
044380,주연테크,1195,1220,25,2.09,4455801,5716459065
013890,지누스,80600,81600,1000,1.24,60888,4986098800
013870,지엠비코리아,5010,4955,-55,-1.1,129290,646579010
071320,지역난방공사,35150,34950,-200,-0.57,6517,226753800
010580,지코,306,306,0,0.0,0,0
035000,지투알,4970,5000,30,0.6,63675,321067940
088790,진도,2520,2570,50,1.98,61002,155148045
003780,진양산업,3660,3665,5,0.14,330180,1217753210
010640,진양폴리,2935,2955,20,0.68,65741,193892745
100250,진양홀딩스,2400,2405,5,0.21,58828,141654905
051630,진양화학,3625,3610,-15,-0.41,203793,741112190
272450,진에어,10050,10150,100,1.0,818526,8737872550
011000,진원생명과학,9450,9230,-220,-2.33,2383565,22240182440
002780,진흥기업,2535,2515,-20,-0.79,309909,778208805
002787,진흥기업2우B,17000,16350,-650,-3.82,36232,602522200
002785,진흥기업우B,6250,6080,-170,-2.72,37097,225643880
009310,참엔지니어링,1345,1325,-20,-1.49,105924,140260305
000650,천일고속,63900,62600,-1300,-2.03,3134,196407900
012600,청호컴넷,4330,4470,140,3.23,558920,2722051570
033250,체시스,2865,2830,-35,-1.22,774855,2187730110
035720,카카오,326500,329500,3000,0.92,873063,289967787500
006380,카프로,2655,2625,-30,-1.13,186276,487808385
109070,컨버즈,4100,4100,0,0.0,0,0
001620,케이비아이동국실업,548,552,4,0.73,29315,16133853
029460,케이씨,22250,23650,1400,6.29,391823,9158962750
344820,케이씨씨글라스,33100,32400,-700,-2.11,56962,1865498100
281820,케이씨텍,22650,23100,450,1.99,250785,5836411200
145270,케이탑리츠,757,754,-3,-0.4,132267,99403654
007815,코리아써우,5940,5750,-190,-3.2,12276,70577520
007810,코리아써키트,16200,15400,-800,-4.94,967529,15036585400
00781K,코리아써키트2우B,6780,6610,-170,-2.51,24798,162689200
152330,코리아오토글라스,14350,14050,-300,-2.09,77451,1094260250
003690,코리안리,7110,7010,-100,-1.41,346461,2438873070
192820,코스맥스,90600,90900,300,0.33,61835,5648546400
044820,코스맥스비티아이,23250,21700,-1550,-6.67,94372,2101226700
005070,코스모신소재,14100,14550,450,3.19,1048882,15157887200
005420,코스모화학,8900,8800,-100,-1.12,468259,4142295510
071950,코아스,1145,1135,-10,-0.87,277227,314727240
002020,코오롱,19250,18900,-350,-1.82,41666,794924600
003070,코오롱글로벌,10300,10650,350,3.4,323557,3450069350
003075,코오롱글로벌우,25600,26250,650,2.54,7282,188925100
144620,코오롱머티리얼,2995,2980,-15,-0.5,1281310,3806998515
002025,코오롱우,12400,12300,-100,-0.81,11962,146506150
120110,코오롱인더,34550,34050,-500,-1.45,214548,7381544350
120115,코오롱인더우,19200,19200,0,0.0,17336,332566000
138490,코오롱플라스틱,4240,4205,-35,-0.83,76360,320687825
021240,코웨이,74600,75600,1000,1.34,316122,23893698300
031820,콤텍시스템,1265,1270,5,0.4,417103,529691200
192400,쿠쿠홀딩스,80900,80500,-400,-0.49,7570,609489000
284740,쿠쿠홈시스,36750,36450,-300,-0.82,25975,955635450
015590,큐로,717,692,-25,-3.49,2159720,1502140463
264900,크라운제과,9010,8840,-170,-1.89,16695,148121610
26490K,크라운제과우,10500,9620,-880,-8.38,108336,1064622230
005740,크라운해태홀딩스,8520,8570,50,0.59,15655,133477320
005745,크라운해태홀딩스우,13400,13400,0,0.0,13421,177233500
020120,키다리스튜디오,8480,8360,-120,-1.42,279278,2324654130
039490,키움증권,96600,97800,1200,1.24,97102,9508751600
012170,키위미디어그룹,150,150,0,0.0,0,0
014580,태경비케이,3725,3720,-5,-0.13,784629,2949721770
015890,태경산업,4770,4855,85,1.78,106277,514335075
006890,태경케미컬,6410,7800,1390,21.68,4558813,33910053750
003240,태광산업,699000,690000,-9000,-1.29,1351,935164000
011280,태림포장,3405,3420,15,0.44,164129,563086315
004100,태양금속,1060,1065,5,0.47,163692,174276265
004105,태양금속우,3380,3375,-5,-0.15,36492,123579370
009410,태영건설,16550,16050,-500,-3.02,358892,5822048500
009415,태영건설우,13100,13000,-100,-0.76,81296,1064324900
001420,태원물산,3480,3515,35,1.01,23077,82129835
007980,태평양물산,1775,1785,10,0.56,220066,391550290
055490,테이팩스,23950,24050,100,0.42,22747,546650000
078000,텔코웨어,12600,12450,-150,-1.19,27619,343674800
214420,토니모리,10300,10200,-100,-0.97,75519,776744300
019180,티에이치엔,2650,2650,0,0.0,146758,387998790
091810,티웨이항공,2365,2430,65,2.75,2232029,5845268730
004870,티웨이홀딩스,1030,1050,20,1.94,2019333,2258522245
005690,파미셀,22300,22500,200,0.9,19166172,462723676350
036580,팜스코,6280,6150,-130,-2.07,66754,413474810
028670,팬오션,3565,3560,-5,-0.14,1127854,4049781285
010820,퍼스텍,2370,2355,-15,-0.63,859480,2021620625
016800,퍼시스,28600,28650,50,0.17,711,20293250
001020,페이퍼코리아,1505,1485,-20,-1.33,82664,122553975
090080,평화산업,1205,1205,0,0.0,168588,203359335
010770,평화홀딩스,3020,3010,-10,-0.33,31844,95692525
058430,포스코강판,13050,13000,-50,-0.38,33406,434979400
047050,포스코인터내셔널,14150,14150,0,0.0,225872,3207726150
003670,포스코케미칼,71500,72900,1400,1.96,485592,35457342100
007630,폴루스바이오팜,1225,1225,0,0.0,0,0
017810,풀무원,18900,18350,-550,-2.91,238820,4406183750
103140,풍산,23750,23500,-250,-1.05,274497,6478240300
005810,풍산홀딩스,26550,26300,-250,-0.94,14454,382646400
033180,필룩스,4480,4480,0,0.0,1020652,4585058655
086790,하나금융지주,28750,28700,-50,-0.17,1765082,50440454550
293480,하나제약,22350,22500,150,0.67,58500,1312843450
039130,하나투어,37250,37800,550,1.48,97228,3649240950
172580,하이골드12호,2230,2195,-35,-1.57,13422,29686420
153360,하이골드3호,1360,1355,-5,-0.37,905,1223250
071090,하이스틸,17000,16900,-100,-0.59,4350,73563300
019490,하이트론,2755,2870,115,4.17,56454,153525630
000080,하이트진로,42950,42200,-750,-1.75,364298,15417589850
000087,하이트진로2우B,22250,22200,-50,-0.22,6494,142883350
000140,하이트진로홀딩스,20850,20800,-50,-0.24,19410,403134000
000145,하이트진로홀딩스우,21450,19900,-1550,-7.23,26943,530079400
152550,한국ANKOR유전,1715,1700,-15,-0.87,10260,17563685
036460,한국가스공사,25450,25300,-150,-0.59,217753,5525503800
005430,한국공항,33400,33450,50,0.15,13055,438241400
071050,한국금융지주,50000,49850,-150,-0.3,302470,15214236250
071055,한국금융지주우,36150,36500,350,0.97,20235,739174050
010040,한국내화,3565,3440,-125,-3.51,340001,1192158100
025540,한국단자,37750,38000,250,0.66,126667,4947527250
004090,한국석유,96200,96500,300,0.31,2375,228836000
002200,한국수출포장,18600,18650,50,0.27,9306,173298000
002960,한국쉘석유,234000,233500,-500,-0.21,912,213489500
123890,한국자산신탁,2820,2820,0,0.0,172433,485212270
015760,한국전력,19300,19150,-150,-0.78,3267280,62742143700
006200,한국전자홀딩스,530,531,1,0.19,144607,77121453
009540,한국조선해양,87700,90800,3100,3.53,317567,28562648000
023350,한국종합기술,4055,3995,-60,-1.48,42772,172119265
025890,한국주강,1360,1370,10,0.74,34162,46490580
000970,한국주철관,9210,9350,140,1.52,1086629,10221925170
104700,한국철강,4580,4545,-35,-0.76,74706,339408860
017960,한국카본,8400,8340,-60,-0.71,537572,4486343130
161890,한국콜마,44250,44750,500,1.13,147837,6587228050
024720,한국콜마홀딩스,30750,30200,-550,-1.79,254304,7652725350
161390,한국타이어앤테크놀로지,25350,25700,350,1.38,333619,8550279950
000240,한국테크놀로지그룹,11650,11600,-50,-0.43,485424,5700826450
034830,한국토지신탁,1735,1720,-15,-0.86,416972,720614090
007280,한국특수형강,1460,1480,20,1.37,126277,186181750
168490,한국패러랠,1970,1975,5,0.25,65606,129228025
010100,한국프랜지,2465,2390,-75,-3.04,511218,1230834050
047810,한국항공우주,24600,25450,850,3.46,1069644,26965820900
123690,한국화장품,13800,13650,-150,-1.09,191935,2628006450
003350,한국화장품제조,40250,41150,900,2.24,67975,2766741300
011500,한농화성,4845,4830,-15,-0.31,11950,57852860
002390,한독,35450,36250,800,2.26,1138821,43008329450
014790,한라,3300,3435,135,4.09,1359858,4656124670
060980,한라홀딩스,27750,27500,-250,-0.9,44465,1231084200
053690,한미글로벌,8150,8360,210,2.58,383970,3176444000
042700,한미반도체,12200,12250,50,0.41,1560660,19154708800
008930,한미사이언스,35550,46200,10650,29.96,5604461,244460955150
128940,한미약품,247000,284500,37500,15.18,1627889,462525776000
009240,한샘,105500,105000,-500,-0.47,116931,12388492500
020000,한섬,32700,31900,-800,-2.45,102374,3294766600
003680,한성기업,18250,16650,-1600,-8.77,590961,10170806000
105630,한세실업,10600,10600,0,0.0,101296,1073982250
069640,한세엠케이,2555,2525,-30,-1.17,29035,72772280
016450,한세예스24홀딩스,3965,3955,-10,-0.25,40928,161193615
010420,한솔PNS,1425,1420,-5,-0.35,114290,163788200
009180,한솔로지스틱스,1995,1910,-85,-4.26,1263427,2471846880
213500,한솔제지,14350,14550,200,1.39,230510,3330897450
014680,한솔케미칼,149500,153500,4000,2.68,106118,16455141000
004710,한솔테크닉스,9270,9250,-20,-0.22,1221887,11260230950
004150,한솔홀딩스,3240,3420,180,5.56,725715,2443338560
025750,한솔홈데코,1100,1085,-15,-1.36,1246074,1373046420
004960,한신공영,15400,14300,-1100,-7.14,262477,3770273800
011700,한신기계,1300,1305,5,0.38,98422,128088205
001750,한양증권,8100,8050,-50,-0.62,49111,396173700
001755,한양증권우,14950,14100,-850,-5.69,13617,195244650
018880,한온시스템,9500,9500,0,0.0,1384832,13155335610
009420,한올바이오파마,31000,30500,-500,-1.61,482300,14826775500
014130,한익스프레스,5130,5040,-90,-1.75,188986,954508410
300720,한일시멘트,85300,83700,-1600,-1.88,2865,241870600
002220,한일철강,1810,1775,-35,-1.93,189561,337402860
006390,한일현대시멘트,28600,28150,-450,-1.57,34805,997539050
003300,한일홀딩스,44350,43900,-450,-1.01,1221,53777750
051600,한전KPS,29950,29700,-250,-0.83,186226,5543214250
052690,한전기술,16300,16350,50,0.31,65783,1076417450
130660,한전산업,3220,3205,-15,-0.47,50506,162060315
002320,한진,56800,55500,-1300,-2.29,180736,9948296200
097230,한진중공업,6600,6500,-100,-1.52,107896,703728260
003480,한진중공업홀딩스,3600,3590,-10,-0.28,21476,77119175
180640,한진칼,86500,87200,700,0.81,542820,47322325600
18064K,한진칼우,52200,52400,200,0.38,203822,11331247500
005110,한창,1885,1870,-15,-0.8,884867,1666352785
009460,한창제지,2000,1995,-5,-0.25,649641,1298986485
000880,한화,23850,23800,-50,-0.21,459708,11133249750
00088K,한화3우B,11800,11850,50,0.42,115266,1378656400
088350,한화생명,1490,1485,-5,-0.34,2914708,4327365925
000370,한화손해보험,2890,2885,-5,-0.17,335133,959440245
009830,한화솔루션,26600,25550,-1050,-3.95,3184768,82512295750
009835,한화솔루션우,25400,25200,-200,-0.79,185116,4771183700
272210,한화시스템,9760,9730,-30,-0.31,846691,8293547650
012450,한화에어로스페이스,25000,25600,600,2.4,886977,22549709600
000885,한화우,53500,52900,-600,-1.12,182319,9378950050
003530,한화투자증권,1770,1770,0,0.0,685216,1211433455
003535,한화투자증권우,3275,3180,-95,-2.9,690877,2252387990
195870,해성디에스,19350,18850,-500,-2.58,378851,7184528450
101530,해태제과식품,8300,8580,280,3.37,99200,848803350
143210,핸즈코퍼레이션,6180,6200,20,0.32,11324,69801340
000720,현대건설,34550,34300,-250,-0.72,1049335,36075231800
267270,현대건설기계,22350,22150,-200,-0.89,120129,2660087400
000725,현대건설우,228000,232000,4000,1.75,23353,5437879500
005440,현대그린푸드,8050,7970,-80,-0.99,229830,1839902550
086280,현대글로비스,111000,110500,-500,-0.45,134679,15067118500
064350,현대로템,16000,17600,1600,10.0,16865720,301553654150
079430,현대리바트,20000,19750,-250,-1.25,329914,6581195000
012330,현대모비스,203500,204000,500,0.25,333839,68085272000
010620,현대미포조선,31850,32250,400,1.26,143686,4654010400
069960,현대백화점,59500,59600,100,0.17,106283,6364564900
004560,현대비앤지스틸,7550,7540,-10,-0.13,60126,457464830
004565,현대비앤지스틸우,79900,79700,-200,-0.25,3840,305602400
011760,현대상사,15150,15050,-100,-0.66,59823,907294950
004310,현대약품,6200,6170,-30,-0.48,1002559,6177399870
322000,현대에너지솔루션,31000,29500,-1500,-4.84,474838,14161282200
126560,현대에이치씨엔,4460,4105,-355,-7.96,2364167,10274621445
017800,현대엘리베이,46350,46250,-100,-0.22,332412,15496509950
307950,현대오토에버,39350,39350,0,0.0,29675,1167165500
011210,현대위아,37900,37200,-700,-1.85,158549,5946957900
267260,현대일렉트릭,10300,10050,-250,-2.43,901333,9285338160
004020,현대제철,25950,25700,-250,-0.96,1469626,37677928150
267250,현대중공업지주,233000,239500,6500,2.79,62185,14879618000
005380,현대차,123500,123000,-500,-0.4,1765179,217376981000
005387,현대차2우B,67800,67300,-500,-0.74,139673,9377961700
005389,현대차3우B,62700,62000,-700,-1.12,22728,1412808500
005385,현대차우,66800,66400,-400,-0.6,162126,10746517900
001500,현대차증권,9320,9350,30,0.32,78212,732206880
227840,현대코퍼레이션홀딩스,10100,9990,-110,-1.09,22944,229643480
001450,현대해상,23300,23450,150,0.64,197097,4610896700
057050,현대홈쇼핑,62200,61600,-600,-0.96,28530,1771133900
093240,형지엘리트,1535,1570,35,2.28,2666492,4188125165
003010,혜인,5160,5010,-150,-2.91,452406,2282474015
111110,호전실업,9360,9250,-110,-1.18,20151,185785000
008770,호텔신라,69900,70200,300,0.43,354464,24840661900
008775,호텔신라우,62300,62300,0,0.0,13584,841948500
002460,화성산업,10450,10500,50,0.48,104100,1106757050
013520,화승알앤에이,1605,1710,105,6.54,559017,927938965
241590,화승엔터프라이즈,10750,10950,200,1.86,329769,3598458400
006060,화승인더,7030,6980,-50,-0.71,343158,2397110200
010690,화신,2220,2170,-50,-2.25,358355,782614610
133820,화인베스틸,2635,2650,15,0.57,537415,1414043645
010660,화천기계,3475,3415,-60,-1.73,537554,1831832940
000850,화천기공,30950,31400,450,1.45,4190,130513550
016580,환인제약,16100,15550,-550,-3.42,136861,2148318300
032560,황금에스티,6220,6270,50,0.8,496947,3214049090
004800,효성,72700,71700,-1000,-1.38,108056,7779483000
094280,효성ITX,26300,25750,-550,-2.09,64109,1645650150
298040,효성중공업,46500,48350,1850,3.98,663610,31834196900
298050,효성첨단소재,129500,128000,-1500,-1.16,175806,22343389500
298020,효성티앤씨,115000,112500,-2500,-2.17,22666,2571770500
298000,효성화학,110000,108500,-1500,-1.36,15976,1739570000
093370,후성,8050,8090,40,0.5,854973,6934303850
081660,휠라홀딩스,33800,33900,100,0.3,305060,10393933000
005870,휴니드,6990,6950,-40,-0.57,178641,1245426910
079980,휴비스,6450,6450,0,0.0,146392,939941380
005010,휴스틸,7060,7160,100,1.42,11400,80599240
069260,휴켐스,16550,16950,400,2.42,174598,2938646250
000540,흥국화재,2255,2245,-10,-0.44,18908,42348355
000547,흥국화재2우B,25850,25750,-100,-0.39,14984,388864950
000545,흥국화재우,6270,6240,-30,-0.48,10038,62150910
003280,흥아해운,258,258,0,0.0,0,0
