티커,종목명,시가,종가,변동폭,등락률,거래량,거래대금
095570,AJ네트웍스,4610,4610,0,0.0,155764,714989900
006840,AK홀딩스,24950,24550,-400,-1.6,41056,1007337150
027410,BGF,4935,4730,-205,-4.15,709702,3410693505
282330,BGF리테일,137000,137500,500,0.36,74665,10329830000
138930,BNK금융지주,5830,5800,-30,-0.51,1747434,10193248720
001460,BYC,280000,278000,-2000,-0.71,934,259423000
001465,BYC우,140000,139500,-500,-0.36,87,12103500
001040,CJ,83900,82300,-1600,-1.91,105241,8784845800
079160,CJCGV,23650,23300,-350,-1.48,371807,8764903300
00104K,CJ4우전환,63900,63700,-200,-0.31,17727,1134266800
000120,CJ대한통운,163500,161500,-2000,-1.22,74180,12140225500
011150,CJ씨푸드,5360,5120,-240,-4.48,2140182,11327175040
011155,CJ씨푸드1우,43400,42700,-700,-1.61,810,34382400
001045,CJ우,51700,51200,-500,-0.97,5373,277343700
097950,CJ제일제당,376500,379000,2500,0.66,128762,49550003500
097955,CJ제일제당우,164000,164500,500,0.3,16099,2683620500
000590,CS홀딩스,57700,57800,100,0.17,6896,399179500
012030,DB,722,714,-8,-1.11,1371348,992169028
016610,DB금융투자,4800,4810,10,0.21,412660,1984460880
005830,DB손해보험,45300,44750,-550,-1.21,122400,5515750650
000990,DB하이텍,36500,39000,2500,6.85,6964980,273056238850
000995,DB하이텍1우,105500,111000,5500,5.21,7100,807442500
139130,DGB금융지주,7300,7300,0,0.0,417956,3056191340
001530,DI동일,127000,126000,-1000,-0.79,20512,2615425500
004840,DRB동일,6960,6780,-180,-2.59,45667,313473810
155660,DSR,6300,6240,-60,-0.95,249791,1560303680
069730,DSR제강,4905,4755,-150,-3.06,195249,937668715
017940,E1,45900,45350,-550,-1.2,21784,992779950
007700,FF,84700,83900,-800,-0.94,50998,4284612500
114090,GKL,16800,16200,-600,-3.57,683079,11186034200
078930,GS,38200,37250,-950,-2.49,299262,11282690950
006360,GS건설,37050,35500,-1550,-4.18,917280,32965188100
001250,GS글로벌,2020,1975,-45,-2.23,485776,969264935
007070,GS리테일,34600,34100,-500,-1.45,261097,8959696850
078935,GS우,31650,31450,-200,-0.63,20596,646599850
012630,HDC,11150,10800,-350,-3.14,472893,5169506050
039570,HDC아이콘트롤스,10200,10050,-150,-1.47,61016,613924410
089470,HDC현대EP,6330,6100,-230,-3.63,223089,1380679980
294870,HDC현대산업개발,26550,25200,-1350,-5.08,1205277,30957625700
011200,HMM,13600,13000,-600,-4.41,5611117,74061334650
082740,HSD엔진,8400,8030,-370,-4.4,1166795,9593436400
003560,IHQ,1610,1565,-45,-2.8,2674774,4232689615
175330,JB금융지주,5900,5910,10,0.17,305916,1819789890
234080,JW생명과학,21650,20550,-1100,-5.08,574275,12097489900
001060,JW중외제약,36500,35250,-1250,-3.42,317735,11347917050
001067,JW중외제약2우B,54900,54600,-300,-0.55,646,34790200
001065,JW중외제약우,41350,40800,-550,-1.33,1851,76641900
096760,JW홀딩스,5990,6040,50,0.83,1495983,9164802420
105560,KB금융,45150,44550,-600,-1.33,1261666,56551168300
002380,KCC,189000,184500,-4500,-2.38,51379,9638782000
009070,KCTC,3995,3690,-305,-7.63,1566679,5960876800
009440,KC그린홀딩스,5260,5130,-130,-2.47,408475,2138571500
119650,KC코트렐,10650,10150,-500,-4.69,935974,9685452450
092220,KEC,3060,2995,-65,-2.12,18412938,56556709850
016380,KG동부제철,11450,10750,-700,-6.11,307638,3380650800
016385,KG동부제철우,121000,117500,-3500,-2.89,974,115464000
001390,KG케미칼,24650,23500,-1150,-4.67,575729,13764606950
001940,KISCO홀딩스,15650,14450,-1200,-7.67,44032,654321950
025000,KPX케미칼,57800,56500,-1300,-2.25,11907,679577600
092230,KPX홀딩스,64300,63500,-800,-1.24,93946,6161453200
000040,KR모터스,1215,1120,-95,-7.82,1669400,1937802625
044450,KSS해운,10550,10500,-50,-0.47,161692,1693187350
030200,KT,25600,25200,-400,-1.56,1334306,33929674400
033780,KTG,88600,87300,-1300,-1.47,645049,56589692900
030210,KTB투자증권,3305,3170,-135,-4.08,392958,1262692285
058850,KTcs,2295,2280,-15,-0.65,460301,1055079835
058860,KTis,2570,2505,-65,-2.53,219250,557826705
093050,LF,14900,14650,-250,-1.68,99505,1478636000
003550,LG,78600,78300,-300,-0.38,425319,33480642300
034220,LG디스플레이,17600,17150,-450,-2.56,3079683,53666094100
001120,LG상사,24950,24550,-400,-1.6,408937,10142239350
051900,LG생활건강,1630000,1606000,-24000,-1.47,18079,29289507000
051905,LG생활건강우,700000,696000,-4000,-0.57,4865,3396815000
003555,LG우,61300,60400,-900,-1.47,27859,1699752200
032640,LG유플러스,12200,11950,-250,-2.05,3421295,41297795800
011070,LG이노텍,169500,164000,-5500,-3.24,167230,27903343500
066570,LG전자,94900,92200,-2700,-2.85,943385,87891221400
066575,LG전자우,37950,36550,-1400,-3.69,196682,7283292450
108670,LG하우시스,78500,76400,-2100,-2.68,75066,5761761800
108675,LG하우시스우,31350,30700,-650,-2.07,9792,302045650
037560,LG헬로비전,3880,3855,-25,-0.64,382368,1483230590
051910,LG화학,815000,797000,-18000,-2.21,306523,246193517000
051915,LG화학우,394000,377500,-16500,-4.19,53502,20443781000
079550,LIG넥스원,29950,29250,-700,-2.34,78330,2309658800
006260,LS,72800,69900,-2900,-3.98,281148,19925974100
010120,LSELECTRIC,64000,59900,-4100,-6.41,358437,21989875800
000680,LS네트웍스,3200,2850,-350,-10.94,1225009,3658588010
229640,LS전선아시아,8020,7640,-380,-4.74,887352,6885421890
023150,MH에탄올,8780,8550,-230,-2.62,101936,880954940
035420,NAVER,284000,284000,0,0.0,750095,216615913000
181710,NHN,72800,72000,-800,-1.1,77631,5606504700
005940,NH투자증권,11700,11350,-350,-2.99,1693188,19489596550
005945,NH투자증권우,9250,9130,-120,-1.3,265979,2441088870
338100,NH프라임리츠,4300,4300,0,0.0,41070,176163995
034310,NICE,18700,18400,-300,-1.6,41409,764519750
008260,NI스틸,2595,2510,-85,-3.28,297343,758492485
004250,NPC,3330,3250,-80,-2.4,123280,402930740
004255,NPC우,2295,2295,0,0.0,18347,42077450
010060,OCI,87600,82300,-5300,-6.05,861249,72837506200
005490,POSCO,274500,267500,-7000,-2.55,256129,68984309000
100840,STC,15750,15550,-200,-1.27,24842,387786950
064960,ST모티브,48900,48300,-600,-1.23,32148,1559011100
003570,ST중공업,5850,5780,-70,-1.2,134598,784665240
036530,ST홀딩스,15500,15200,-300,-1.94,13489,206415400
010950,S-Oil,70200,69300,-900,-1.28,331904,23086652700
010955,S-Oil우,39100,38300,-800,-2.05,21426,831084100
034120,SBS,21150,20250,-900,-4.26,162419,3360021300
101060,SBS미디어홀딩스,1840,1795,-45,-2.45,160382,291032890
005090,SGC에너지,36450,35900,-550,-1.51,136451,4914839500
004060,SG세계물산,633,613,-20,-3.16,1099754,680093810
001380,SG충방,2190,2145,-45,-2.05,576249,1260588690
002360,SH에너지화학,819,804,-15,-1.83,824677,667017153
009160,SIMPAC,2470,2435,-35,-1.42,83319,203098375
123700,SJM,3030,3035,5,0.17,13726,41428870
025530,SJM홀딩스,3030,3015,-15,-0.5,53639,162189315
034730,SK,240500,235500,-5000,-2.08,256393,60999628500
011790,SKC,93700,90000,-3700,-3.95,424790,38877322700
018670,SK가스,107000,106000,-1000,-0.93,17776,1898116000
001740,SK네트웍스,4790,4715,-75,-1.57,726541,3455573285
001745,SK네트웍스우,110000,106000,-4000,-3.64,525,55135500
006120,SK디스커버리,66900,65500,-1400,-2.09,95379,6282654200
006125,SK디스커버리우,58300,55900,-2400,-4.12,29504,1682606300
210980,SK디앤디,43650,42550,-1100,-2.52,137322,5898655100
068400,SK렌터카,8980,8860,-120,-1.34,54257,483231490
326030,SK바이오팜,177000,172500,-4500,-2.54,173246,30036601500
03473K,SK우,243000,237000,-6000,-2.47,10633,2543902000
096770,SK이노베이션,187500,182000,-5500,-2.93,667168,122487101500
096775,SK이노베이션우,136500,132500,-4000,-2.93,18121,2431932500
001510,SK증권,813,799,-14,-1.72,7489882,6013778074
001515,SK증권우,5450,5150,-300,-5.5,101388,526235340
285130,SK케미칼,403000,385000,-18000,-4.47,266611,104464298500
28513K,SK케미칼우,183000,175000,-8000,-4.37,30733,5457861000
017670,SK텔레콤,249000,244000,-5000,-2.01,232208,57211143000
000660,SK하이닉스,116000,112500,-3500,-3.02,4270842,485295511328
005610,SPC삼립,71400,70600,-800,-1.12,11394,806246100
011810,STX,6100,5820,-280,-4.59,106725,632496050
077970,STX엔진,7560,7600,40,0.53,58055,434385140
071970,STX중공업,3990,3900,-90,-2.26,188187,741660095
084870,TBH글로벌,1865,1820,-45,-2.41,44567,82433375
002710,TCC스틸,5150,4815,-335,-6.5,1159097,5751668885
024070,WISCOM,2630,2525,-105,-3.99,281831,732207395
037270,YGPLUS,4595,4380,-215,-4.68,929213,4129112910
000500,가온전선,22800,21950,-850,-3.73,32783,727960700
000860,강남제비스코,21950,20900,-1050,-4.78,173536,3635165500
035250,강원랜드,23300,22900,-400,-1.72,867030,19985898250
011420,갤럭시아에스엠,1445,1415,-30,-2.08,252527,362141780
002100,경농,11850,11650,-200,-1.69,69882,818781250
009450,경동나비엔,53100,52000,-1100,-2.07,55430,2900306500
267290,경동도시가스,19150,18950,-200,-1.04,16411,312576200
012320,경동인베스트,30950,31450,500,1.62,15574,491592800
000050,경방,12100,11950,-150,-1.24,32204,388947150
214390,경보제약,19000,19400,400,2.11,6405778,134041948500
012610,경인양행,6960,6830,-130,-1.87,285801,1965670300
009140,경인전자,24250,23800,-450,-1.86,1246,29768500
013580,계룡건설,27150,26200,-950,-3.5,197955,5272216500
012200,계양전기,4370,3920,-450,-10.3,2540594,10330863535
012205,계양전기우,7490,7200,-290,-3.87,12263,88895070
002140,고려산업,4285,4070,-215,-5.02,577279,2393179270
010130,고려아연,423000,413500,-9500,-2.25,62437,25947279000
002240,고려제강,16450,16200,-250,-1.52,40481,658173700
009290,광동제약,11200,10550,-650,-5.8,3322758,36708579900
017040,광명전기,2060,2040,-20,-0.97,687581,1413407760
017900,광전자,2385,2310,-75,-3.14,329377,770975280
037710,광주신세계,156000,153500,-2500,-1.6,2899,445828500
030610,교보증권,7830,7750,-80,-1.02,83045,646549080
339770,교촌에프앤비,21100,20700,-400,-1.9,201823,4210054850
007690,국도화학,56900,54300,-2600,-4.57,46203,2542854600
005320,국동,3560,3605,45,1.26,936122,3414794430
001140,국보,1910,1875,-35,-1.83,643537,1210082915
002720,국제약품,10500,11400,900,8.57,6721403,76706753600
083420,그린케미칼,9850,9300,-550,-5.58,1193732,11278404420
014530,극동유화,3630,3555,-75,-2.07,165244,590320465
014280,금강공업,4910,4740,-170,-3.46,128221,615967605
014285,금강공업우,11500,10950,-550,-4.78,6857,76141500
008870,금비,61900,60700,-1200,-1.94,902,55117600
001570,금양,6920,6440,-480,-6.94,1816811,11910468120
002990,금호산업,9410,9230,-180,-1.91,271950,2533002120
002995,금호산업우,33650,32550,-1100,-3.27,5647,186120250
011780,금호석유,140500,138000,-2500,-1.78,234014,32437176524
011785,금호석유우,53800,53400,-400,-0.74,28732,1533048100
214330,금호에이치티,2445,2375,-70,-2.86,3638494,8844483150
001210,금호전기,3385,3240,-145,-4.28,105261,344812145
073240,금호타이어,3855,3800,-55,-1.43,423464,1609713890
092440,기신정기,3575,3465,-110,-3.08,154935,545791830
000270,기아차,61300,59800,-1500,-2.45,1645392,99008995800
024110,기업은행,9410,9330,-80,-0.85,1714044,16062714920
013700,까뮤이앤씨,2665,3185,520,19.51,118177078,357412412040
004540,깨끗한나라,4725,4475,-250,-5.29,366002,1675896780
004545,깨끗한나라우,22600,22300,-300,-1.33,969,21714400
001260,남광토건,14350,13200,-1150,-8.01,398083,5344540600
008350,남선알미늄,4840,4645,-195,-4.03,3180106,14941136285
008355,남선알미우,46400,46000,-400,-0.86,2288,105334650
004270,남성,4150,4295,145,3.49,10935144,48467193655
003920,남양유업,290000,282500,-7500,-2.59,2077,593304000
003925,남양유업우,136000,135000,-1000,-0.74,359,48519000
025860,남해화학,8250,8120,-130,-1.58,291466,2378782020
005720,넥센,4825,4700,-125,-2.59,89017,421509995
005725,넥센우,3200,3200,0,0.0,36350,116303950
002350,넥센타이어,6300,6040,-260,-4.13,321984,1978732340
002355,넥센타이어1우B,2675,2615,-60,-2.24,9242,24326840
003580,넥스트사이언스,5470,5380,-90,-1.65,328340,1785287520
251270,넷마블,124500,122500,-2000,-1.61,227472,28045365500
090350,노루페인트,9310,8920,-390,-4.19,280321,2536347580
090355,노루페인트우,13500,13250,-250,-1.85,2765,36751500
000320,노루홀딩스,11400,11100,-300,-2.63,106355,1186076000
000325,노루홀딩스우,17900,17700,-200,-1.12,490,8644950
006280,녹십자,404000,388000,-16000,-3.96,300878,120423581000
005250,녹십자홀딩스,37400,36550,-850,-2.27,643676,24041688000
005257,녹십자홀딩스2우,115000,117000,2000,1.74,6179,726689500
004370,농심,306000,303000,-3000,-0.98,86970,26862216500
072710,농심홀딩스,74800,74500,-300,-0.4,11517,860927700
058730,다스코,5180,5070,-110,-2.12,52680,267668790
023590,다우기술,21850,21250,-600,-2.75,263747,5689675250
019680,대교,3710,3730,20,0.54,367406,1367508975
019685,대교우B,2525,2515,-10,-0.4,75037,188615715
006370,대구백화점,10150,9820,-330,-3.25,52029,512077980
008060,대덕,6880,6710,-170,-2.47,285794,1937576340
00806K,대덕1우,8900,8550,-350,-3.93,22450,194113350
353200,대덕전자,11650,11100,-550,-4.72,1368740,15552387500
35320K,대덕전자1우,8510,8320,-190,-2.23,30169,253380980
000490,대동공업,6820,6590,-230,-3.37,303841,2024545480
008110,대동전자,4545,4430,-115,-2.53,32600,144483835
005750,대림BCo,6500,6260,-240,-3.69,117963,749410030
001880,대림건설,30600,29250,-1350,-4.41,193565,5754172850
000210,대림산업,93500,90000,-3500,-3.74,551150,50480206300
000215,대림산업우,56600,54300,-2300,-4.06,80215,4447394000
006570,대림통상,4060,3975,-85,-2.09,4404,17812670
001680,대상,26100,26100,0,0.0,643567,17156663700
001685,대상우,18900,19050,150,0.79,15227,291571150
084690,대상홀딩스,10200,10200,0,0.0,481849,5001102250
084695,대상홀딩스우,8340,8340,0,0.0,3045,25375200
128820,대성산업,3180,3135,-45,-1.42,75631,239065715
117580,대성에너지,5550,5510,-40,-0.72,25755,141752190
016710,대성홀딩스,24500,24350,-150,-0.61,75902,1836102850
003540,대신증권,13550,13550,0,0.0,111509,1514770800
003547,대신증권2우B,10700,10750,50,0.47,76942,828002900
003545,대신증권우,11200,11150,-50,-0.45,192602,2153145750
009190,대양금속,3875,3685,-190,-4.9,939503,3529385195
014160,대영포장,1995,1805,-190,-9.52,9423909,17799523020
047040,대우건설,4610,4455,-155,-3.36,2752769,12394448300
009320,대우부품,2755,2655,-100,-3.63,915302,2473426320
042660,대우조선해양,26750,26100,-650,-2.43,446169,11938223700
003090,대웅,67300,77700,10400,15.45,7436720,577275599800
069620,대웅제약,275500,238500,-37000,-13.43,633248,164552710000
000430,대원강업,3850,3800,-50,-1.3,120709,460201565
006340,대원전선,1110,1050,-60,-5.41,1454964,1561985570
006345,대원전선우,2640,2595,-45,-1.7,24519,64724115
003220,대원제약,20800,19850,-950,-4.57,736947,15228744150
024890,대원화성,1795,1765,-30,-1.67,9197294,17559251400
002880,대유에이텍,856,846,-10,-1.17,339777,287660263
000300,대유플러스,782,767,-15,-1.92,805698,622163923
012800,대창,1360,1305,-55,-4.04,2166644,2884130925
015230,대창단조,7010,6900,-110,-1.57,63383,440057520
001070,대한방직,39700,39350,-350,-0.88,9256,364406650
006650,대한유화,223500,217500,-6000,-2.68,43770,9617424000
001440,대한전선,1525,1450,-75,-4.92,12436607,18387030840
084010,대한제강,10400,10050,-350,-3.37,167351,1694085950
001790,대한제당,21950,22150,200,0.91,13354,294483550
001795,대한제당우,14500,14500,0,0.0,4621,67103500
001130,대한제분,157000,153500,-3500,-2.23,5034,781444000
003490,대한항공,26700,26000,-700,-2.62,1823251,47640843150
003495,대한항공우,37750,39050,1300,3.44,38725,1446557850
005880,대한해운,3045,2900,-145,-4.76,5976462,17708315805
003830,대한화섬,106000,102500,-3500,-3.3,1130,117733000
016090,대현,1900,1840,-60,-3.16,283263,532092805
069460,대호에이엘,2660,2595,-65,-2.44,694152,1807407185
192080,더블유게임즈,62100,59700,-2400,-3.86,158634,9618211200
012510,더존비즈온,108000,104500,-3500,-3.24,74260,7888991000
004830,덕성,8570,7870,-700,-8.17,1341078,11026660930
004835,덕성우,15050,14100,-950,-6.31,67440,953905700
024900,덕양산업,1745,1695,-50,-2.87,286157,487139480
145720,덴티움,41650,40700,-950,-2.28,45321,1859968800
002150,도화엔지니어링,8370,8170,-200,-2.39,125818,1040158530
001230,동국제강,8180,7780,-400,-4.89,856420,6810080920
023450,동남합성,49900,49600,-300,-0.6,2248,112387350
004140,동방,2265,2190,-75,-3.31,1406401,3131124495
007590,동방아그로,6520,6460,-60,-0.92,10708,69297480
005960,동부건설,13900,13400,-500,-3.6,102742,1392765400
005965,동부건설우,23500,23700,200,0.85,1053,24743750
026960,동서,31900,32350,450,1.41,950663,32487039200
002210,동성제약,12950,12400,-550,-4.25,663569,8430789350
102260,동성코퍼레이션,5230,4985,-245,-4.68,540719,2729919220
005190,동성화학,17350,16700,-650,-3.75,113677,1908043600
000640,동아쏘시오홀딩스,129000,124000,-5000,-3.88,65195,8197740500
170900,동아에스티,90200,87100,-3100,-3.44,73651,6485865300
028100,동아지질,15850,15600,-250,-1.58,101066,1585601700
282690,동아타이어,9850,9820,-30,-0.3,7487,73264440
001520,동양,1235,1210,-25,-2.02,810229,985411690
001527,동양2우B,12400,12400,0,0.0,21,260800
001529,동양3우B,29200,29200,0,0.0,250,7256900
084670,동양고속,26750,27050,300,1.12,23219,623659750
002900,동양물산,1565,1515,-50,-3.19,2036407,3130013890
082640,동양생명,3705,3710,5,0.13,185747,690070685
001525,동양우,7000,6920,-80,-1.14,170,1189700
008970,동양철관,1130,1100,-30,-2.65,1419554,1581290965
092780,동양피스톤,5460,5390,-70,-1.28,74865,402771330
049770,동원FB,180000,177000,-3000,-1.67,128675,23152382500
018500,동원금속,792,754,-38,-4.8,839127,647953628
006040,동원산업,217000,219000,2000,0.92,9649,2118153500
030720,동원수산,9650,9300,-350,-3.63,160033,1516164670
014820,동원시스템즈,31600,30900,-700,-2.22,76475,2422059100
014825,동원시스템즈우,30100,29350,-750,-2.49,1046,31108200
163560,동일고무벨트,10050,10100,50,0.5,184514,1838565240
004890,동일산업,75300,75000,-300,-0.4,5069,380859900
002690,동일제강,2405,2370,-35,-1.46,43385,103872930
000020,동화약품,23450,23900,450,1.92,7361077,174696601350
000150,두산,53500,52400,-1100,-2.06,109380,5761721100
000157,두산2우B,72100,69800,-2300,-3.19,1131,79775200
241560,두산밥캣,29800,29250,-550,-1.85,200368,5909260650
336370,두산솔루스,54900,51300,-3600,-6.56,1060499,55544570000
33637K,두산솔루스1우,17750,16500,-1250,-7.04,149069,2519870250
33637L,두산솔루스2우B,34100,32850,-1250,-3.67,21143,698404500
000155,두산우,44050,44150,100,0.23,22247,984151650
042670,두산인프라코어,8120,7980,-140,-1.72,2558144,20559217200
034020,두산중공업,13900,13400,-500,-3.6,2891737,39458293650
336260,두산퓨얼셀,58100,54600,-3500,-6.02,1432594,79033990100
33626K,두산퓨얼셀1우,14400,13700,-700,-4.86,179642,2509123650
33626L,두산퓨얼셀2우B,19850,19450,-400,-2.02,16616,322385100
016740,두올,3395,3300,-95,-2.8,252102,841784835
192650,드림텍,12000,11550,-450,-3.75,486103,5684368800
024090,디씨엠,12250,12000,-250,-2.04,15500,186473150
003160,디아이,4365,4240,-125,-2.86,176075,751282730
092200,디아이씨,3630,3825,195,5.37,27486994,114977190535
013570,디와이,4525,4430,-95,-2.1,114863,513467070
210540,디와이파워,12550,11700,-850,-6.77,268998,3221743550
007340,디티알오토모티브,25850,25400,-450,-1.74,35364,909162400
026890,디피씨,8800,8510,-290,-3.3,1000051,8621682470
115390,락앤락,10300,10150,-150,-1.46,159470,1629861700
032350,롯데관광개발,15650,14950,-700,-4.47,552073,8364398300
330590,롯데리츠,5460,5420,-40,-0.73,375881,2040853940
000400,롯데손해보험,1850,1800,-50,-2.7,695260,1258657615
023530,롯데쇼핑,99600,99200,-400,-0.4,104427,10433033900
004000,롯데정밀화학,55400,53900,-1500,-2.71,114099,6229009100
286940,롯데정보통신,37600,37000,-600,-1.6,38345,1424704550
280360,롯데제과,104000,102500,-1500,-1.44,17371,1795229500
004990,롯데지주,34550,34150,-400,-1.16,210221,7275568100
00499K,롯데지주우,65500,66200,700,1.07,3802,251260000
005300,롯데칠성,108000,107000,-1000,-0.93,52531,5704780000
005305,롯데칠성우,60700,60600,-100,-0.16,1850,112437200
011170,롯데케미칼,264500,260000,-4500,-1.7,172290,45017334500
002270,롯데푸드,337500,336500,-1000,-0.3,4998,1683551000
071840,롯데하이마트,31150,30950,-200,-0.64,61528,1910333850
027740,마니커,688,679,-9,-1.31,2202113,1507387860
204320,만도,52000,53600,1600,3.08,1354932,73363663000
001080,만호제강,17900,18100,200,1.12,33378,596626400
088980,맥쿼리인프라,11200,11200,0,0.0,1310170,14670275750
094800,맵스리얼티1,4160,4150,-10,-0.24,88095,366220705
138040,메리츠금융지주,10500,10400,-100,-0.95,208261,2171312350
008560,메리츠증권,3845,3795,-50,-1.3,2016966,7709796895
000060,메리츠화재,16000,15900,-100,-0.63,226773,3625708550
090370,메타랩스,1155,1125,-30,-2.6,501188,566697075
017180,명문제약,9420,9490,70,0.74,47671390,500411768180
009900,명신산업,51800,49700,-2100,-4.05,18098979,918747488550
012690,모나리자,5190,5140,-50,-0.96,632317,3319630670
005360,모나미,5970,5620,-350,-5.86,726804,4180468920
204210,모두투어리츠,2980,2950,-30,-1.01,18405,54524600
009680,모토닉,10900,10950,50,0.46,183897,2039887700
009580,무림PP,3670,3600,-70,-1.91,305169,1113883500
009200,무림페이퍼,2935,2800,-135,-4.6,559731,1595118185
033920,무학,7300,7100,-200,-2.74,113196,804863280
008420,문배철강,3430,3330,-100,-2.92,1167889,4032598265
025560,미래산업,3500,3280,-220,-6.29,670917,2270674715
007120,미래아이앤지,350,352,2,0.57,1248856,438820965
006800,미래에셋대우,9600,9440,-160,-1.67,1509074,14362761070
00680K,미래에셋대우2우B,4780,4750,-30,-0.63,736328,3519316755
006805,미래에셋대우우,5350,5280,-70,-1.31,64459,341504030
357250,미래에셋맵스리츠,4885,4875,-10,-0.2,24381,118935315
085620,미래에셋생명,3965,3965,0,0.0,106706,423471320
002840,미원상사,108500,110000,1500,1.38,4056,443490500
268280,미원에스씨,103000,102000,-1000,-0.97,1520,155593000
107590,미원홀딩스,75400,75300,-100,-0.13,1104,83416800
134380,미원화학,61600,61900,300,0.49,1002,62032100
003650,미창석유,66500,65900,-600,-0.9,478,31604200
155900,바다로19호,2375,2385,10,0.42,3897,9286450
003610,방림,1960,1910,-50,-2.55,111156,214613340
001340,백광산업,3370,3260,-110,-3.26,602558,1994720475
035150,백산,5070,4950,-120,-2.37,240087,1201479635
002410,범양건영,4840,4860,20,0.41,574552,2853268935
096300,베트남개발1,239,239,0,0.0,215181,51402966
007210,벽산,2420,2270,-150,-6.2,1682963,3942286485
002760,보락,2640,2510,-130,-4.92,4186611,10860779115
003850,보령제약,21150,20350,-800,-3.78,1350515,28348234650
000890,보해양조,965,932,-33,-3.42,3872941,3647574340
003000,부광약품,35100,33200,-1900,-5.41,4269266,143562025150
001270,부국증권,22900,22600,-300,-1.31,8953,204568300
001275,부국증권우,20750,20700,-50,-0.24,2042,42374100
026940,부국철강,4340,4260,-80,-1.84,151465,651864935
015350,부산가스,50800,55800,5000,9.84,53722,2840150500
011390,부산산업,118000,115000,-3000,-2.54,8805,1025629000
005030,부산주공,734,731,-3,-0.41,845483,619833967
002070,비비안,3750,3635,-115,-3.07,639220,2344148575
100220,비상교육,6790,6630,-160,-2.36,18081,121456160
030790,비케이탑스,16750,16150,-600,-3.58,137105,2260432950
352820,빅히트,158500,154500,-4000,-2.52,166164,25858112000
005180,빙그레,55600,55200,-400,-0.72,25032,1388265400
003960,사조대림,17000,16550,-450,-2.65,82005,1380166550
008040,사조동아원,968,939,-29,-3.0,669294,636789948
007160,사조산업,31450,31050,-400,-1.27,22408,699642700
014710,사조씨푸드,6440,6180,-260,-4.04,354397,2220479900
006090,사조오양,9960,9700,-260,-2.61,99498,976088810
001470,삼부토건,4345,4385,40,0.92,8231814,36439884380
006400,삼성SDI,566000,555000,-11000,-1.94,241689,134895955000
006405,삼성SDI우,289500,284000,-5500,-1.9,17463,4981738500
006660,삼성공조,7180,7080,-100,-1.39,50332,357247190
028260,삼성물산,127500,132500,5000,3.92,2365555,314539521000
02826K,삼성물산우B,120000,126000,6000,5.0,128265,16218783500
207940,삼성바이오로직스,823000,803000,-20000,-2.43,107220,87173221000
032830,삼성생명,75800,80000,4200,5.54,2136409,171171152900
018260,삼성에스디에스,179500,177500,-2000,-1.11,220873,39523468000
028050,삼성엔지니어링,13000,12600,-400,-3.08,1967384,25141804100
009150,삼성전기,168000,164000,-4000,-2.38,474488,78667594000
009155,삼성전기우,87900,85500,-2400,-2.73,59871,5159606600
005930,삼성전자,73000,72300,-700,-0.96,16304910,1183242835700
005935,삼성전자우,68800,68500,-300,-0.44,2109156,144308205200
001360,삼성제약,4910,4615,-295,-6.01,5461139,26024895145
010140,삼성중공업,7230,7040,-190,-2.63,22693305,165250796710
010145,삼성중공우,375000,366500,-8500,-2.27,2500,933050000
016360,삼성증권,42600,41900,-700,-1.64,454730,19207296000
068290,삼성출판사,24500,23800,-700,-2.86,126203,3038154200
029780,삼성카드,35400,34900,-500,-1.41,142295,5022346450
000810,삼성화재,196500,194000,-2500,-1.27,149141,29248259500
000815,삼성화재우,155500,153500,-2000,-1.29,38527,5998819000
006110,삼아알미늄,9430,8800,-630,-6.68,438161,3968096840
145990,삼양사,58200,57200,-1000,-1.72,91210,5224771100
145995,삼양사우,45550,45250,-300,-0.66,1342,60684900
003230,삼양식품,101000,100500,-500,-0.5,129794,13256670500
002170,삼양통상,63300,62500,-800,-1.26,7935,499597400
272550,삼양패키징,22200,21750,-450,-2.03,40944,900432450
000070,삼양홀딩스,75500,72900,-2600,-3.44,30629,2260791300
000075,삼양홀딩스우,50400,49800,-600,-1.19,985,49031250
002810,삼영무역,14450,14400,-50,-0.35,24524,355439100
005680,삼영전자,9970,9400,-570,-5.72,158926,1521204320
003720,삼영화학,2520,2470,-50,-1.98,598477,1490738650
023000,삼원강재,2665,2620,-45,-1.69,39457,104212145
004380,삼익THK,12050,11900,-150,-1.24,87002,1030192550
002450,삼익악기,1485,1460,-25,-1.68,386519,569249290
004440,삼일씨엔에스,9820,9430,-390,-3.97,71237,679901760
000520,삼일제약,21950,21050,-900,-4.1,87277,1871293300
009770,삼정펄프,29300,29600,300,1.02,2538,75431150
005500,삼진제약,28550,28200,-350,-1.23,142613,4068454900
004690,삼천리,81900,81800,-100,-0.12,3740,305830900
010960,삼호개발,4390,4285,-105,-2.39,118290,511616115
004450,삼화왕관,39500,39100,-400,-1.01,966,37852200
009470,삼화전기,19700,19300,-400,-2.03,242779,4799646350
011230,삼화전자,4080,3935,-145,-3.55,104451,413177585
001820,삼화콘덴서,58500,56800,-1700,-2.91,106850,6162697800
000390,삼화페인트,17400,14800,-2600,-14.94,2748127,41852219150
001290,상상인증권,1090,1055,-35,-3.21,179153,190984565
041650,상신브레이크,3505,3345,-160,-4.56,324030,1101837780
075180,새론오토모티브,6070,6100,30,0.49,32782,200289620
007540,샘표,49000,48250,-750,-1.53,11827,575491000
248170,샘표식품,48750,48550,-200,-0.41,61863,3051787800
007860,서연,10100,9550,-550,-5.45,481474,4702706240
200880,서연이화,8100,7950,-150,-1.85,1999976,16178017480
017390,서울가스,97900,96000,-1900,-1.94,6440,619677100
004410,서울식품,270,254,-16,-5.93,37836392,9880184264
004415,서울식품우,6180,5750,-430,-6.96,41482,244150340
021050,서원,2880,2785,-95,-3.3,608571,1716663760
008490,서흥,50600,50900,300,0.59,83422,4250888600
007610,선도전기,3150,3040,-110,-3.49,238215,732152160
136490,선진,11350,10850,-500,-4.41,261488,2880815000
002820,선창산업,4900,4850,-50,-1.02,31031,149761720
014910,성문전자,1885,1810,-75,-3.98,174046,320531840
014915,성문전자우,9060,8750,-310,-3.42,5794,51331260
003080,성보화학,4575,4415,-160,-3.5,42402,187642070
004980,성신양회,7470,7290,-180,-2.41,197064,1447245580
004985,성신양회우,12450,11800,-650,-5.22,13346,158503250
011300,성안,360,352,-8,-2.22,253953,89418540
000180,성창기업지주,2380,2400,20,0.84,5099786,12624755620
002420,세기상사,61600,61600,0,0.0,0,0
004360,세방,11000,10500,-500,-4.55,197994,2097038050
004365,세방우,6470,6580,110,1.7,49054,324756280
004490,세방전지,51100,47100,-4000,-7.83,276653,13571697800
001430,세아베스틸,10800,10450,-350,-3.24,344257,3631101400
306200,세아제강,91400,87700,-3700,-4.05,18527,1656298500
003030,세아제강지주,44800,44550,-250,-0.56,9599,427517850
019440,세아특수강,12200,12200,0,0.0,10180,124648950
058650,세아홀딩스,81100,78000,-3100,-3.82,585,46632900
013000,세우글로벌,3090,3030,-60,-1.94,643348,1962694150
091090,세원셀론텍,2980,2945,-35,-1.17,1774472,5330381135
021820,세원정공,8090,8090,0,0.0,0,0
067830,세이브존IC,3005,2960,-45,-1.5,181514,541031795
033530,세종공업,8370,8210,-160,-1.91,269308,2232729560
075580,세진중공업,6980,6620,-360,-5.16,1010643,6808529180
027970,세하,1945,1840,-105,-5.4,1506699,2842618615
145210,세화아이엠씨,564,553,-11,-1.95,2217945,1227704013
308170,센트랄모텍,35250,29350,-5900,-16.74,4138922,128972566800
012600,센트럴인사이트,9000,9060,60,0.67,405459,3721069730
068270,셀트리온,367000,359000,-8000,-2.18,1358477,494741796000
004430,송원산업,16550,15800,-750,-4.53,619664,9961985150
017550,수산중공업,3255,3135,-120,-3.69,1495128,4779369305
053210,스카이라이프,9060,8880,-180,-1.99,126054,1131665920
134790,시디즈,56900,56200,-700,-1.23,10072,562600500
016590,신대양제지,66100,63100,-3000,-4.54,22402,1440676000
029530,신도리코,27250,26650,-600,-2.2,27763,751752650
004970,신라교역,9390,9360,-30,-0.32,65856,618296620
011930,신성이엔지,3715,3420,-295,-7.94,15886080,55752381425
005390,신성통상,1710,1655,-55,-3.22,1073883,1815732775
004170,신세계,238000,233000,-5000,-2.1,99301,23373260500
035510,신세계IC,126000,124500,-1500,-1.19,5279,661632500
034300,신세계건설,24350,23700,-650,-2.67,53453,1282034400
031430,신세계인터내셔날,160500,157000,-3500,-2.18,42400,6725379000
031440,신세계푸드,65700,64900,-800,-1.22,15370,1004592900
006880,신송홀딩스,4110,4115,5,0.12,124316,509679745
005800,신영와코루,106500,105000,-1500,-1.41,808,84729000
001720,신영증권,52400,52400,0,0.0,4642,244073000
001725,신영증권우,50600,50600,0,0.0,826,41828500
009270,신원,1480,1440,-40,-2.7,673450,977527160
009275,신원우,39700,39100,-600,-1.51,234,9207150
002700,신일전자,1820,1800,-20,-1.1,1282490,2307791550
019170,신풍제약,122500,120500,-2000,-1.63,9862901,1177890668000
019175,신풍제약우,122000,117000,-5000,-4.1,191748,22691843500
002870,신풍제지,4650,4525,-125,-2.69,16211625,77575708475
293940,신한알파리츠,7160,7120,-40,-0.56,32690,232484110
055550,신한지주,33500,33150,-350,-1.04,1832455,61244281750
001770,신화실업,20900,20150,-750,-3.59,16005,326244600
004080,신흥,11000,10000,-1000,-9.09,69988,726690890
102280,쌍방울,648,632,-16,-2.47,3760773,2408166182
003410,쌍용양회,7160,6960,-200,-2.79,2029135,14272422680
003620,쌍용차,2770,2770,0,0.0,0,0
004770,써니전자,4830,4555,-275,-5.69,16993914,78580948055
015540,쎌마테라퓨틱스,6750,8770,2020,29.93,9290001,76153994590
004920,씨아이테크,911,902,-9,-0.99,134955,122776591
112610,씨에스윈드,165500,155000,-10500,-6.34,561087,87040115500
008700,아남전자,2245,2305,60,2.67,18441291,44411533605
002790,아모레G,54800,53600,-1200,-2.19,98049,5329476100
00279K,아모레G3우전환,35650,35500,-150,-0.42,18703,655587350
002795,아모레G우,20150,19950,-200,-0.99,24423,489698400
090430,아모레퍼시픽,207000,202500,-4500,-2.17,124874,25605425000
090435,아모레퍼시픽우,59900,59300,-600,-1.0,54117,3235559600
002030,아세아,90300,87800,-2500,-2.77,5321,471498400
183190,아세아시멘트,74100,72500,-1600,-2.16,10140,741265200
002310,아세아제지,39150,37500,-1650,-4.21,126027,4824473650
267850,아시아나IDT,24450,23150,-1300,-5.32,127400,3019236900
020560,아시아나항공,4390,4270,-120,-2.73,3056061,13209920350
122900,아이마켓코리아,9500,9370,-130,-1.37,72752,684566010
010780,아이에스동서,51000,49950,-1050,-2.06,163419,8222306600
033660,아주캐피탈,13050,12800,-250,-1.92,50091,644072650
001780,알루코,4465,4630,165,3.7,6792157,31911849315
018250,애경산업,24300,24000,-300,-1.23,79630,1922232800
161000,애경유화,9290,9100,-190,-2.05,233893,2138935930
011090,에넥스,1265,1205,-60,-4.74,5761892,7242164395
005850,에스엘,16000,15500,-500,-3.13,164691,2585450300
012750,에스원,86300,84300,-2000,-2.32,53562,4554546500
023960,에쓰씨엔지니어링,5190,5090,-100,-1.93,410663,2111936500
298690,에어부산,3605,3465,-140,-3.88,592102,2079847840
140910,에이리츠,8680,8760,80,0.92,87037,769492110
078520,에이블씨엔씨,7670,7550,-120,-1.56,74978,568144650
015260,에이엔피,1975,1510,-465,-23.54,6655781,10442192585
007460,에이프로젠KIC,2080,2015,-65,-3.13,3094337,6334888915
003060,에이프로젠제약,1370,1335,-35,-2.55,3790605,5135292485
244920,에이플러스에셋,5700,5640,-60,-1.05,151428,858800370
036570,엔씨소프트,864000,865000,1000,0.12,84346,73435580000
138250,엔에스쇼핑,12950,12200,-750,-5.79,93541,1174392600
085310,엔케이,1165,1125,-40,-3.43,1161670,1321022505
009810,엔케이물산,553,541,-12,-2.17,455895,250749813
900140,엘브이엠씨홀딩스,3695,3540,-155,-4.19,1200716,4325404255
014440,영보화학,3845,3785,-60,-1.56,52040,197845130
111770,영원무역,32250,31050,-1200,-3.72,252921,7980025100
009970,영원무역홀딩스,39300,38250,-1050,-2.67,23559,908806700
003520,영진약품,8590,8830,240,2.79,61260533,570353567340
000670,영풍,538000,537000,-1000,-0.19,2591,1398255000
006740,영풍제지,7930,7310,-620,-7.82,1230742,9451354590
012280,영화금속,2225,2335,110,4.94,40610936,102068935490
012160,영흥,1270,1250,-20,-1.57,744676,948695400
015360,예스코홀딩스,36500,35950,-550,-1.51,3253,118736200
007310,오뚜기,562000,571000,9000,1.6,14898,8508712000
002630,오리엔트바이오,1395,1325,-70,-5.02,2600382,3508183120
271560,오리온,126500,122000,-4500,-3.56,89577,11101607000
001800,오리온홀딩스,13900,13600,-300,-2.16,290291,3991506500
070960,용평리조트,4260,4060,-200,-4.69,724296,2979168005
316140,우리금융지주,10000,9970,-30,-0.3,1770197,17743565350
004720,우리들제약,12850,13250,400,3.11,2299885,30512659300
118000,우리들휴브레인,2875,2750,-125,-4.35,1769213,4923440950
010050,우리종금,555,545,-10,-1.8,3084480,1696388264
006980,우성사료,3105,3055,-50,-1.61,590174,1808497410
017370,우신시스템,3705,3520,-185,-4.99,235766,847285915
105840,우진,4305,4165,-140,-3.25,161597,682524410
010400,우진아이엔에스,8100,8100,0,0.0,20921,169356130
049800,우진플라임,5180,5060,-120,-2.32,35962,182628990
016880,웅진,1125,1100,-25,-2.22,188573,208139040
095720,웅진씽크빅,2950,2850,-100,-3.39,1060203,3119420140
005820,원림,20300,20000,-300,-1.48,12544,252042250
010600,웰바이오텍,2430,2255,-175,-7.2,735595,1704498830
008600,윌비스,1420,1350,-70,-4.93,1701167,2337278925
033270,유나이티드제약,65000,74700,9700,14.92,19396459,1424663433600
014830,유니드,49150,48100,-1050,-2.14,69802,3363764100
000910,유니온,6190,5950,-240,-3.88,395147,2383794130
047400,유니온머티리얼,4145,4025,-120,-2.9,2084714,8572446385
011330,유니켐,1435,1395,-40,-2.79,406127,573384855
077500,유니퀘스트,12900,12550,-350,-2.71,796493,10342481150
002920,유성기업,2795,2760,-35,-1.25,100371,278701575
000700,유수홀딩스,5700,5620,-80,-1.4,18749,104908600
003470,유안타증권,3005,2965,-40,-1.33,402205,1200282450
003475,유안타증권우,2420,2385,-35,-1.45,54568,131662420
011690,유양디앤유,1220,1220,0,0.0,0,0
072130,유엔젤,4190,4035,-155,-3.7,124453,509791525
000220,유유제약,15600,15900,300,1.92,1653473,26995253300
000225,유유제약1우,14250,14250,0,0.0,61740,898172750
000227,유유제약2우B,32800,32800,0,0.0,1302,43192150
001200,유진투자증권,3910,3830,-80,-2.05,474047,1828511270
000100,유한양행,78500,74300,-4200,-5.35,1377799,105137029900
000105,유한양행우,73500,70400,-3100,-4.22,27493,1976851600
003460,유화증권,2395,2370,-25,-1.04,28265,67242715
003465,유화증권우,2495,2485,-10,-0.4,7883,19621005
008730,율촌화학,20200,19900,-300,-1.49,145890,2942435250
008250,이건산업,9860,9380,-480,-4.87,294071,2810565920
025820,이구산업,2035,1950,-85,-4.18,578701,1142241065
214320,이노션,60700,59300,-1400,-2.31,71329,4253442000
088260,이리츠코크렙,5520,5480,-40,-0.72,62179,342364570
139480,이마트,152500,150500,-2000,-1.31,127324,19244927500
007660,이수페타시스,3845,3755,-90,-2.34,549395,2079073910
005950,이수화학,14000,13450,-550,-3.93,623689,8536677000
015020,이스타코,710,670,-40,-5.63,664768,453949688
093230,이아이디,360,367,7,1.94,57886968,21488993530
074610,이엔플러스,3535,3415,-120,-3.39,592569,2043564140
102460,이연제약,23050,22650,-400,-1.74,193747,4435847800
084680,이월드,3265,3180,-85,-2.6,443181,1422323940
350520,이지스레지던스리츠,5040,5030,-10,-0.2,82195,413282210
334890,이지스밸류리츠,4725,4720,-5,-0.11,66685,314803150
000760,이화산업,16250,16250,0,0.0,4849,78517000
014990,인디에프,1565,1520,-45,-2.88,409323,631307510
101140,인바이오젠,5970,6250,280,4.69,6484843,41178854950
006490,인스코비,2140,2050,-90,-4.21,880284,1839579105
023800,인지컨트롤스,11300,10800,-500,-4.42,299623,3302589500
034590,인천도시가스,26100,26000,-100,-0.38,876,22797150
129260,인터지스,3570,3405,-165,-4.62,1992870,7053346780
023810,인팩,6120,5780,-340,-5.56,59632,351026210
249420,일동제약,19950,19100,-850,-4.26,551398,10731783950
000230,일동홀딩스,13500,12650,-850,-6.3,359886,4628229200
013360,일성건설,1215,1135,-80,-6.58,1231907,1439505900
003120,일성신약,95600,87700,-7900,-8.26,56626,5142839900
003200,일신방직,80900,79100,-1800,-2.22,5079,406373100
007110,일신석재,1965,1935,-30,-1.53,775530,1509714560
007570,일양약품,82000,69700,-12300,-15.0,3437090,263439021000
007575,일양약품우,93600,84500,-9100,-9.72,46282,4294188600
008500,일정실업,17750,17450,-300,-1.69,3197,56784100
081000,일진다이아,48800,47550,-1250,-2.56,143003,6852183750
020760,일진디스플,6030,5980,-50,-0.83,479549,2896921710
020150,일진머티리얼즈,50100,48600,-1500,-2.99,392958,19316777050
103590,일진전기,3280,3205,-75,-2.29,201129,654164660
015860,일진홀딩스,5430,5370,-60,-1.1,743856,4028688960
226320,잇츠한불,26200,25700,-500,-1.91,64234,1679382450
317400,자이에스앤디,12650,12300,-350,-2.77,287637,3541063100
033240,자화전자,19300,18850,-450,-2.33,563535,10759089350
000950,전방,29250,28950,-300,-1.03,3988,115599650
348950,제이알글로벌리츠,5350,5300,-50,-0.93,292067,1550161060
194370,제이에스코퍼레이션,7400,7290,-110,-1.49,22644,165790190
025620,제이준코스메틱,2475,2450,-25,-1.01,177591,438918440
036420,제이콘텐트리,33100,31800,-1300,-3.93,164936,5286032550
030000,제일기획,21250,20900,-350,-1.65,292689,6161369700
271980,제일약품,67900,66500,-1400,-2.06,501839,34717913600
001560,제일연마,7230,7070,-160,-2.21,25501,180610970
002620,제일파마홀딩스,22500,22150,-350,-1.56,62120,1416658000
006220,제주은행,3415,3360,-55,-1.61,26635,89838495
089590,제주항공,17900,17550,-350,-1.96,176107,3095543150
004910,조광페인트,6720,6370,-350,-5.21,142986,933321630
004700,조광피혁,55700,54800,-900,-1.62,3891,212987000
001550,조비,18150,17850,-300,-1.65,17836,319316000
000480,조선내화,86200,85900,-300,-0.35,1683,144737100
120030,조선선재,106500,104500,-2000,-1.88,4925,518805500
018470,조일알미늄,748,739,-9,-1.2,80998,60524862
002600,조흥,186000,178500,-7500,-4.03,899,162038000
185750,종근당,261000,245000,-16000,-6.13,813404,205596308500
063160,종근당바이오,100500,96900,-3600,-3.58,420184,41275036300
001630,종근당홀딩스,137000,133000,-4000,-2.92,183944,24855562000
044380,주연테크,1135,1100,-35,-3.08,986713,1103093610
013890,지누스,100000,99000,-1000,-1.0,62605,6230657100
013870,지엠비코리아,7530,7300,-230,-3.05,194668,1435562290
071320,지역난방공사,40850,40050,-800,-1.96,20456,824203350
010580,지코,306,306,0,0.0,0,0
035000,지투알,5790,5680,-110,-1.9,23693,134562020
088790,진도,4210,4065,-145,-3.44,166216,685942455
003780,진양산업,4820,4880,60,1.24,490341,2377288670
010640,진양폴리,3735,3635,-100,-2.68,178496,653529110
100250,진양홀딩스,2860,2810,-50,-1.75,196991,559753265
051630,진양화학,5110,5080,-30,-0.59,448527,2267377935
272450,진에어,13350,13600,250,1.87,602122,8077647750
011000,진원생명과학,24200,22600,-1600,-6.61,2316378,53715238000
002780,진흥기업,2500,2430,-70,-2.8,179745,443608055
002787,진흥기업2우B,12050,11950,-100,-0.83,1682,20172750
002785,진흥기업우B,6660,6340,-320,-4.8,9341,59688340
009310,참엔지니어링,1480,1420,-60,-4.05,1030210,1485297370
000650,천일고속,72000,71300,-700,-0.97,3343,237834200
033250,체시스,1995,1885,-110,-5.51,684598,1316414185
035720,카카오,379500,376000,-3500,-0.92,876516,335998684500
006380,카프로,3930,3765,-165,-4.2,519443,1974568250
109070,컨버즈,4100,4100,0,0.0,0,0
001620,케이비아이동국실업,677,668,-9,-1.33,193735,129808640
029460,케이씨,26550,25900,-650,-2.45,91995,2408898450
344820,케이씨씨글라스,40750,39400,-1350,-3.31,226645,8965992800
281820,케이씨텍,28150,27250,-900,-3.2,286590,7924921200
145270,케이탑리츠,1220,1170,-50,-4.1,833474,1016266785
357120,코람코에너지리츠,4825,4810,-15,-0.31,97417,468637890
007815,코리아써우,6810,7210,400,5.87,56147,404078300
007810,코리아써키트,14300,13950,-350,-2.45,447426,6335436350
00781K,코리아써키트2우B,6940,7060,120,1.73,2587,18282990
003690,코리안리,8520,8790,270,3.17,1186823,10371595320
192820,코스맥스,98700,98100,-600,-0.61,72139,7100147200
044820,코스맥스비티아이,18150,17850,-300,-1.65,35503,639443300
005070,코스모신소재,19100,18050,-1050,-5.5,2122592,39042619800
005420,코스모화학,13300,12000,-1300,-9.77,2127002,26288347350
071950,코아스,1135,1110,-25,-2.2,250693,280070125
002020,코오롱,21950,21500,-450,-2.05,95016,2049626050
003070,코오롱글로벌,19950,19100,-850,-4.26,215472,4179429350
003075,코오롱글로벌우,35150,32500,-2650,-7.54,7325,247853650
144620,코오롱머티리얼,3395,3245,-150,-4.42,461643,1543825080
002025,코오롱우,15300,15000,-300,-1.96,3832,57998700
120110,코오롱인더,40550,39350,-1200,-2.96,173837,6928317950
120115,코오롱인더우,22700,22200,-500,-2.2,22608,505407950
138490,코오롱플라스틱,4640,4505,-135,-2.91,140105,638052595
021240,코웨이,71800,71000,-800,-1.11,181493,12919945200
031820,콤텍시스템,1645,1545,-100,-6.08,3698612,5825621605
192400,쿠쿠홀딩스,100000,99100,-900,-0.9,5651,561114300
284740,쿠쿠홈시스,39400,38400,-1000,-2.54,71016,2751079150
015590,큐로,660,649,-11,-1.67,2026782,1323673194
264900,크라운제과,9080,9010,-70,-0.77,13165,118512410
26490K,크라운제과우,10400,10550,150,1.44,12419,129628600
005740,크라운해태홀딩스,8980,8930,-50,-0.56,22667,201936410
005745,크라운해태홀딩스우,13000,12800,-200,-1.54,9002,114675550
020120,키다리스튜디오,9120,8790,-330,-3.62,143037,1271213070
039490,키움증권,124000,124000,0,0.0,209413,26067393500
012170,키위미디어그룹,1485,1485,0,0.0,0,0
014580,태경비케이,3940,3770,-170,-4.31,489435,1887946165
015890,태경산업,6100,5980,-120,-1.97,129205,776753190
006890,태경케미컬,15750,14350,-1400,-8.89,930264,13690796450
003240,태광산업,777000,776000,-1000,-0.13,1764,1371258000
011280,태림포장,6910,6670,-240,-3.47,3201172,21771341700
004100,태양금속,1120,1080,-40,-3.57,275582,300739790
004105,태양금속우,2900,2845,-55,-1.9,22032,63037130
009410,태영건설,11350,11250,-100,-0.88,517855,5897961550
009415,태영건설우,12950,12900,-50,-0.39,46573,602357250
001420,태원물산,3995,3910,-85,-2.13,53887,212027850
007980,태평양물산,2070,1980,-90,-4.35,1420239,2888171950
055490,테이팩스,36200,35200,-1000,-2.76,103952,3727495700
078000,텔코웨어,12400,12300,-100,-0.81,16602,203590350
214420,토니모리,9090,8980,-110,-1.21,47733,430145470
019180,티에이치엔,2470,2455,-15,-0.61,143867,354351635
363280,티와이홀딩스,26500,25200,-1300,-4.91,436154,11205849550
36328K,티와이홀딩스우,26600,25800,-800,-3.01,28157,732953200
091810,티웨이항공,2500,2415,-85,-3.4,542119,1322244510
004870,티웨이홀딩스,1060,1025,-35,-3.3,256796,263242985
005690,파미셀,18150,18200,50,0.28,2305774,42127476250
036580,팜스코,4570,4475,-95,-2.08,159358,724661955
028670,팬오션,4625,4460,-165,-3.57,5481799,24683813315
010820,퍼스텍,2110,2105,-5,-0.24,342353,723622375
016800,퍼시스,30250,30500,250,0.83,1540,46695600
001020,페이퍼코리아,2620,2450,-170,-6.49,536874,1375659965
090080,평화산업,1145,1135,-10,-0.87,208735,238699965
010770,평화홀딩스,3405,3430,25,0.73,49497,169494560
058430,포스코강판,17900,17050,-850,-4.75,86668,1504356500
047050,포스코인터내셔널,15200,14700,-500,-3.29,718232,10727305350
003670,포스코케미칼,107000,105500,-1500,-1.4,572447,60940404000
007630,폴루스바이오팜,1225,1225,0,0.0,0,0
017810,풀무원,16800,16950,150,0.89,376611,6436143800
103140,풍산,28200,27550,-650,-2.3,230671,6449499300
005810,풍산홀딩스,28850,28550,-300,-1.04,19468,557666100
033180,필룩스,4155,4055,-100,-2.41,3178612,13215835180
086790,하나금융지주,36050,35550,-500,-1.39,1069827,38337072250
293480,하나제약,26750,26150,-600,-2.24,180068,4738527900
039130,하나투어,53400,52500,-900,-1.69,128557,6805081000
172580,하이골드12호,1990,1985,-5,-0.25,4309,8457270
153360,하이골드3호,1250,1230,-20,-1.6,31304,38534515
071090,하이스틸,19150,19050,-100,-0.52,30971,595642700
019490,하이트론,4580,4350,-230,-5.02,317700,1406282705
000080,하이트진로,32050,31600,-450,-1.4,423607,13459351200
000087,하이트진로2우B,20600,20700,100,0.49,2797,57587250
000140,하이트진로홀딩스,15350,15100,-250,-1.63,26101,394933550
000145,하이트진로홀딩스우,14750,14800,50,0.34,313,4618250
152550,한국ANKOR유전,1635,1635,0,0.0,45568,74277330
036460,한국가스공사,31050,30050,-1000,-3.22,574600,17452664800
005430,한국공항,38250,37500,-750,-1.96,19332,726832450
071050,한국금융지주,76800,77100,300,0.39,512620,39971702600
071055,한국금융지주우,63300,63800,500,0.79,60487,3875421300
010040,한국내화,3460,3490,30,0.87,804924,2866351730
025540,한국단자,53000,51700,-1300,-2.45,55997,2915198900
004090,한국석유,97100,96500,-600,-0.62,2268,219708600
002200,한국수출포장,24000,23000,-1000,-4.17,41788,975029800
002960,한국쉘석유,293500,288000,-5500,-1.87,6527,1889824000
123890,한국자산신탁,4395,4255,-140,-3.19,598677,2577131490
015760,한국전력,28050,26800,-1250,-4.46,10254371,280164458550
006200,한국전자홀딩스,935,911,-24,-2.57,711965,656585734
009540,한국조선해양,110000,109500,-500,-0.45,675400,75710697500
023350,한국종합기술,4650,4560,-90,-1.94,102946,471189140
025890,한국주강,1585,1525,-60,-3.79,41739,65236535
000970,한국주철관,8330,8180,-150,-1.8,60406,496646830
104700,한국철강,6840,6630,-210,-3.07,256484,1712161490
017960,한국카본,13100,13400,300,2.29,2743419,37157203900
161890,한국콜마,48250,47100,-1150,-2.38,641726,30936804250
024720,한국콜마홀딩스,26600,25800,-800,-3.01,100658,2628711700
161390,한국타이어앤테크놀로지,40200,39300,-900,-2.24,232318,9172617150
000240,한국테크놀로지그룹,14850,14250,-600,-4.04,431559,6237817050
034830,한국토지신탁,2175,2075,-100,-4.6,2786579,5860546680
007280,한국특수형강,1930,1925,-5,-0.26,181823,358601000
168490,한국패러랠,1910,1905,-5,-0.26,64342,122611360
010100,한국프랜지,2990,2690,-300,-10.03,1837605,5096235765
047810,한국항공우주,25950,25050,-900,-3.47,575718,14586437100
123690,한국화장품,12950,12650,-300,-2.32,145518,1856055250
003350,한국화장품제조,37350,36800,-550,-1.47,24939,925475150
011500,한농화성,8990,8680,-310,-3.45,310096,2724844130
002390,한독,35400,34600,-800,-2.26,369498,13056627150
014790,한라,4820,4760,-60,-1.24,295932,1426225955
060980,한라홀딩스,37750,38000,250,0.66,73149,2789342850
053690,한미글로벌,10400,10400,0,0.0,288009,2988100100
042700,한미반도체,17050,16950,-100,-0.59,1103389,18789196700
008930,한미사이언스,74800,71200,-3600,-4.81,326958,23828551200
128940,한미약품,355500,338000,-17500,-4.92,103708,35799656000
009240,한샘,105000,101000,-4000,-3.81,68209,7014839000
020000,한섬,29700,29000,-700,-2.36,121592,3528798500
003680,한성기업,8800,8480,-320,-3.64,78938,685307900
105630,한세실업,18100,17200,-900,-4.97,512984,8912943750
069640,한세엠케이,4010,3450,-560,-13.97,810427,3220699775
016450,한세예스24홀딩스,7840,7570,-270,-3.44,338533,2590268030
010420,한솔PNS,1675,1625,-50,-2.99,166476,276020570
009180,한솔로지스틱스,2325,2210,-115,-4.95,657508,1480820475
213500,한솔제지,14200,13950,-250,-1.76,222072,3126689850
014680,한솔케미칼,181000,174500,-6500,-3.59,76867,13580100500
004710,한솔테크닉스,9760,9750,-10,-0.1,821468,8087011200
004150,한솔홀딩스,3600,3555,-45,-1.25,223126,801236260
025750,한솔홈데코,2095,2050,-45,-2.15,4261400,8930704185
004960,한신공영,16500,16000,-500,-3.03,53142,856847250
011700,한신기계,1640,1585,-55,-3.35,332650,532891935
001750,한양증권,9560,9380,-180,-1.88,111127,1049546980
001755,한양증권우,18700,18150,-550,-2.94,2004,36483150
018880,한온시스템,15250,15300,50,0.33,865288,13360206600
009420,한올바이오파마,39900,37200,-2700,-6.77,1144296,44021436350
014130,한익스프레스,8290,7710,-580,-7.0,594933,4705142890
300720,한일시멘트,105500,107500,2000,1.9,10425,1117939000
002220,한일철강,1935,1950,15,0.78,111578,215977070
006390,한일현대시멘트,28800,28000,-800,-2.78,27729,785486350
003300,한일홀딩스,11300,10850,-450,-3.98,58679,645687300
051600,한전KPS,31100,30150,-950,-3.05,439030,13412913750
052690,한전기술,17950,17050,-900,-5.01,273057,4742208650
130660,한전산업,5350,5020,-330,-6.17,1438864,7368776495
002320,한진,46900,46100,-800,-1.71,149851,6918864800
097230,한진중공업,7500,7410,-90,-1.2,205674,1525637370
003480,한진중공업홀딩스,4195,4070,-125,-2.98,142207,585624800
180640,한진칼,60600,60000,-600,-0.99,103915,6240264500
18064K,한진칼우,47950,46700,-1250,-2.61,10762,504880850
005110,한창,1345,1455,110,8.18,12075167,17415978840
009460,한창제지,2740,2560,-180,-6.57,4991563,13159740260
000880,한화,26550,26200,-350,-1.32,645216,16941293500
00088K,한화3우B,14300,14050,-250,-1.75,109310,1542314500
088350,한화생명,2505,2505,0,0.0,10663673,27053910385
000370,한화손해보험,3905,3815,-90,-2.3,1011930,3907599325
009830,한화솔루션,46150,45600,-550,-1.19,6332684,288797479250
009835,한화솔루션우,66200,64500,-1700,-2.57,59647,3873480800
272210,한화시스템,14750,15150,400,2.71,1674879,25305497600
012450,한화에어로스페이스,28700,27650,-1050,-3.66,451522,12622377050
000885,한화우,45250,44800,-450,-0.99,2336,104735050
003530,한화투자증권,2125,2060,-65,-3.06,1131859,2359703180
003535,한화투자증권우,3475,3320,-155,-4.46,43223,142997605
195870,해성디에스,20450,20050,-400,-1.96,276814,5620565900
101530,해태제과식품,8290,8200,-90,-1.09,32676,269079350
143210,핸즈코퍼레이션,9010,8320,-690,-7.66,592956,5020192060
000720,현대건설,37250,36550,-700,-1.88,720850,26533589700
267270,현대건설기계,33450,32400,-1050,-3.14,157819,5153311500
000725,현대건설우,180000,176500,-3500,-1.94,1069,189132500
005440,현대그린푸드,8880,8780,-100,-1.13,1467637,13086185000
086280,현대글로비스,180500,179500,-1000,-0.55,223805,40537130500
064350,현대로템,17050,16500,-550,-3.23,3320360,56542649850
079430,현대리바트,15600,15150,-450,-2.88,241382,3691479550
012330,현대모비스,249000,244000,-5000,-2.01,243658,60077744500
010620,현대미포조선,50700,49250,-1450,-2.86,523530,26389509550
069960,현대백화점,70400,70100,-300,-0.43,163250,11511181200
004560,현대비앤지스틸,9870,9440,-430,-4.36,129713,1247951850
004565,현대비앤지스틸우,68300,67500,-800,-1.17,327,22031500
011760,현대상사,16200,15700,-500,-3.09,90376,1432651100
004310,현대약품,6730,8740,2010,29.87,70565316,574513179570
322000,현대에너지솔루션,39150,37800,-1350,-3.45,241818,9307805100
017800,현대엘리베이,40900,40050,-850,-2.08,318351,12838189950
307950,현대오토에버,115500,112500,-3000,-2.6,425174,49594049000
011210,현대위아,48150,46600,-1550,-3.22,188783,8902326750
267260,현대일렉트릭,16500,15900,-600,-3.64,247779,3980487150
004020,현대제철,38800,37350,-1450,-3.74,1144405,43269383800
267250,현대중공업지주,313500,310000,-3500,-1.12,67261,21135109000
005380,현대차,187000,184000,-3000,-1.6,1381697,255079388000
005387,현대차2우B,91100,89900,-1200,-1.32,114415,10312337500
005389,현대차3우B,87400,86300,-1100,-1.26,18413,1592717700
005385,현대차우,87900,87300,-600,-0.68,94040,8224733900
001500,현대차증권,12900,13350,450,3.49,621357,8250236150
227840,현대코퍼레이션홀딩스,11650,11350,-300,-2.58,81188,930011950
126560,현대퓨처넷,3255,4015,760,23.35,15476493,57415159230
001450,현대해상,23500,23250,-250,-1.06,407332,9541928100
057050,현대홈쇼핑,83800,81700,-2100,-2.51,25096,2078357400
093240,형지엘리트,3685,3460,-225,-6.11,7989182,28959155465
003010,혜인,5200,5050,-150,-2.88,193795,989604000
111110,호전실업,9710,9270,-440,-4.53,93948,885643830
008770,호텔신라,81100,80400,-700,-0.86,346592,27963948300
008775,호텔신라우,78100,78700,600,0.77,42968,3438818100
002460,화성산업,12900,12600,-300,-2.33,130258,1652837250
013520,화승알앤에이,2165,2140,-25,-1.15,144173,308469620
241590,화승엔터프라이즈,13700,13500,-200,-1.46,213266,2917703500
006060,화승인더,7110,6990,-120,-1.69,331896,2331895430
010690,화신,3515,3215,-300,-8.53,1764477,5795493770
133820,화인베스틸,2520,2530,10,0.4,515455,1319383065
010660,화천기계,3120,3300,180,5.77,10761445,36305490000
000850,화천기공,33100,33200,100,0.3,7366,244248900
016580,환인제약,17800,17250,-550,-3.09,401438,7087236950
032560,황금에스티,8330,7970,-360,-4.32,231856,1880915590
004800,효성,82000,79600,-2400,-2.93,159263,12808840200
094280,효성ITX,21300,20700,-600,-2.82,30475,641240050
298040,효성중공업,61200,59700,-1500,-2.45,90510,5471625600
298050,효성첨단소재,147500,143500,-4000,-2.71,64832,9388204500
298020,효성티앤씨,211500,203500,-8000,-3.78,58792,12281673500
298000,효성화학,158000,153000,-5000,-3.16,45216,6998237500
093370,후성,11450,10800,-650,-5.68,4766165,52643979350
081660,휠라홀딩스,43350,42500,-850,-1.96,268348,11514169100
005870,휴니드,5810,5720,-90,-1.55,78370,450753540
079980,휴비스,8420,8330,-90,-1.07,306014,2570185060
005010,휴스틸,7520,7390,-130,-1.73,19304,142235310
069260,휴켐스,24500,24250,-250,-1.02,195397,4737945800
000540,흥국화재,2995,2900,-95,-3.17,83051,244817500
000547,흥국화재2우B,21450,21100,-350,-1.63,505,10734150
000545,흥국화재우,8240,8000,-240,-2.91,21467,171511390
003280,흥아해운,258,258,0,0.0,0,0
