티커,종목명,시가,종가,변동폭,등락률,거래량,거래대금
095570,AJ네트웍스,3260,3230,-30,-0.92,176190,565294095
006840,AK홀딩스,18850,18150,-700,-3.71,78180,1439877500
027410,BGF,4210,4245,35,0.83,124616,525038300
282330,BGF리테일,124500,125000,500,0.4,27562,3450523500
138930,BNK금융지주,5270,5240,-30,-0.57,1035199,5445812690
001460,BYC,204000,209500,5500,2.7,7541,1633671000
001465,BYC우,120500,132000,11500,9.54,18701,2517247500
001040,CJ,81800,82200,400,0.49,67461,5532080500
079160,CJCGV,19300,19500,200,1.04,113311,2199934400
00104K,CJ4우전환,57300,57500,200,0.35,8708,498697800
000120,CJ대한통운,155000,152000,-3000,-1.94,48392,7405664000
011150,CJ씨푸드,3565,3590,25,0.7,438021,1571508970
011155,CJ씨푸드1우,45700,45000,-700,-1.53,5066,229378700
001045,CJ우,42750,42750,0,0.0,7659,326722550
097950,CJ제일제당,366000,367000,1000,0.27,62059,22760515500
097955,CJ제일제당우,143500,142000,-1500,-1.05,7691,1093382000
000590,CS홀딩스,65700,63500,-2200,-3.35,5414,345942300
012030,DB,708,708,0,0.0,461928,324892136
016610,DB금융투자,3555,3570,15,0.42,117003,416967730
005830,DB손해보험,46500,46600,100,0.22,74965,3490782250
000990,DB하이텍,33450,35150,1700,5.08,2990949,104032298950
000995,DB하이텍1우,64700,71200,6500,10.05,26693,1942235600
139130,DGB금융지주,5230,5250,20,0.38,594840,3134155760
001530,DI동일,72700,74500,1800,2.48,14165,1052133400
004840,DRB동일,6750,6770,20,0.3,81157,544129920
155660,DSR,4065,4065,0,0.0,17319,70168715
069730,DSR제강,4395,4350,-45,-1.02,121070,524656525
017940,E1,37500,38150,650,1.73,21048,801776850
007700,FF,80900,80800,-100,-0.12,91982,7492567000
114090,GKL,12750,13000,250,1.96,584061,7599082900
078930,GS,35100,35450,350,1.0,199280,7022885450
006360,GS건설,26650,26700,50,0.19,432152,11602044800
001250,GS글로벌,1730,1725,-5,-0.29,121620,210009390
007070,GS리테일,34900,34650,-250,-0.72,149030,5171584000
078935,GS우,29500,29300,-200,-0.68,6026,176852800
012630,HDC,9520,10000,480,5.04,4905737,51889894580
039570,HDC아이콘트롤스,8070,8130,60,0.74,27643,227473970
089470,HDC현대EP,4110,4155,45,1.09,217212,900204295
294870,HDC현대산업개발,21350,22500,1150,5.39,3161481,71438906000
011200,HMM,5490,5850,360,6.56,6111882,34737853840
082740,HSD엔진,4715,4635,-80,-1.7,511430,2371395590
003560,IHQ,1485,1500,15,1.01,317236,472947095
175330,JB금융지주,4720,4710,-10,-0.21,245994,1159315760
234080,JW생명과학,19400,18800,-600,-3.09,230852,4375852800
001060,JW중외제약,37900,36400,-1500,-3.96,311367,11406050250
001067,JW중외제약2우B,65600,61500,-4100,-6.25,7761,483045500
001065,JW중외제약우,72900,66800,-6100,-8.37,38722,2641893900
096760,JW홀딩스,5490,5370,-120,-2.19,168259,907421300
105560,KB금융,36200,35950,-250,-0.69,1773544,64154415450
002380,KCC,139500,136500,-3000,-2.15,37028,5086816000
009070,KCTC,2310,2360,50,2.16,194101,457327075
009440,KC그린홀딩스,4145,4130,-15,-0.36,43431,180125755
119650,KC코트렐,5990,6100,110,1.84,299329,1825664320
092220,KEC,823,825,2,0.24,308328,254682448
016380,KG동부제철,11950,12050,100,0.84,44196,525181350
016385,KG동부제철우,104000,105500,1500,1.44,1547,160887500
001390,KG케미칼,13900,13600,-300,-2.16,161968,2224962050
001940,KISCO홀딩스,11500,11500,0,0.0,4381,50565600
025000,KPX케미칼,45350,45500,150,0.33,2295,103894850
092230,KPX홀딩스,42050,42050,0,0.0,2202,92538100
000040,KR모터스,724,716,-8,-1.1,734432,525695077
044450,KSS해운,8340,8380,40,0.48,45579,381303520
030200,KT,23850,23800,-50,-0.21,797423,19032067250
033780,KTG,81200,82100,900,1.11,281870,23034884300
030210,KTB투자증권,2510,2510,0,0.0,95405,238696050
058850,KTcs,1815,1815,0,0.0,171126,311328785
058860,KTis,2220,2250,30,1.35,312674,710106195
093050,LF,12150,12050,-100,-0.82,74851,907308450
003550,LG,74200,73400,-800,-1.08,208248,15363889700
034220,LG디스플레이,12550,12800,250,1.99,2070225,26279846850
001120,LG상사,15250,15200,-50,-0.33,219970,3341847450
051900,LG생활건강,1390000,1385000,-5000,-0.36,31061,43392791000
051905,LG생활건강우,712000,712000,0,0.0,2301,1637087000
003555,LG우,48200,48000,-200,-0.41,8475,407083850
032640,LG유플러스,11750,11650,-100,-0.85,1910810,22265061550
011070,LG이노텍,162000,162000,0,0.0,114044,18611760500
066570,LG전자,72000,72100,100,0.14,735701,53358572000
066575,LG전자우,26800,26850,50,0.19,50863,1365724200
108670,LG하우시스,63000,61000,-2000,-3.17,73704,4595578400
108675,LG하우시스우,28750,28400,-350,-1.22,9474,268538250
037560,LG헬로비전,4005,3990,-15,-0.37,80301,320923925
051910,LG화학,527000,530000,3000,0.57,244581,129129743031
051915,LG화학우,253500,256500,3000,1.18,31325,8003253500
079550,LIG넥스원,34900,34900,0,0.0,146100,5126204100
006260,LS,42550,42250,-300,-0.71,105509,4494783750
010120,LSELECTRIC,55500,53900,-1600,-2.88,196085,10622956100
000680,LS네트웍스,2210,2185,-25,-1.13,132941,289899570
229640,LS전선아시아,6890,6820,-70,-1.02,127680,870610580
023150,MH에탄올,7160,7150,-10,-0.14,314229,2308415910
035420,NAVER,292000,294000,2000,0.68,1150474,337799333500
181710,NHN,81500,81300,-200,-0.25,71002,5777820800
005940,NH투자증권,8750,8800,50,0.57,1042743,9169964200
005945,NH투자증권우,7500,7480,-20,-0.27,71546,535070980
338100,NH프라임리츠,4470,4465,-5,-0.11,21917,97971715
034310,NICE,20250,20450,200,0.99,54120,1102858950
008260,NI스틸,2235,2200,-35,-1.57,1667470,3839372130
004250,NPC,3450,3450,0,0.0,23209,79562430
004255,NPC우,2315,2300,-15,-0.65,8182,18736215
010060,OCI,55200,56200,1000,1.81,815693,46335139300
005490,POSCO,201500,199000,-2500,-1.24,361731,72028949500
100840,STC,15800,15700,-100,-0.63,8648,134902000
064960,ST모티브,43850,45800,1950,4.45,140810,6432782850
003570,ST중공업,5150,5160,10,0.19,78565,403352330
036530,ST홀딩스,15000,15300,300,2.0,8999,135860750
010950,S-Oil,61700,61500,-200,-0.32,311229,19236704100
010955,S-Oil우,34800,35100,300,0.86,10867,380233650
034120,SBS,16150,15950,-200,-1.24,86900,1388778800
101060,SBS미디어홀딩스,1870,1890,20,1.07,50682,95258280
004060,SG세계물산,630,635,5,0.79,1415204,896905291
001380,SG충방,1625,1625,0,0.0,511972,833069810
002360,SH에너지화학,847,823,-24,-2.83,1043722,864422228
009160,SIMPAC,2395,2405,10,0.42,52704,126521095
123700,SJM,2520,2525,5,0.2,9509,23961605
025530,SJM홀딩스,2535,2540,5,0.2,7492,18941140
034730,SK,223500,227500,4000,1.79,347939,79453725500
011790,SKC,70400,69500,-900,-1.28,253257,17577560500
018670,SK가스,86400,87400,1000,1.16,36031,3163219000
001740,SK네트웍스,5150,5050,-100,-1.94,591561,3022509950
001745,SK네트웍스우,178500,177500,-1000,-0.56,6081,1073598000
006120,SK디스커버리,49850,49700,-150,-0.3,691540,34892860250
006125,SK디스커버리우,65900,60000,-5900,-8.95,400576,25094337100
210980,SK디앤디,34900,34800,-100,-0.29,116599,4029166550
068400,SK렌터카,9280,9340,60,0.65,60065,560110300
326030,SK바이오팜,186500,185000,-1500,-0.8,318789,58954088000
03473K,SK우,227000,232000,5000,2.2,29707,6867925500
096770,SK이노베이션,131000,127500,-3500,-2.67,667405,85616608000
096775,SK이노베이션우,89900,89500,-400,-0.44,12963,1159488800
001510,SK증권,838,835,-3,-0.36,5592693,4690697537
001515,SK증권우,6310,6290,-20,-0.32,429821,2739650820
285130,SK케미칼,268500,274000,5500,2.05,716412,196436938000
28513K,SK케미칼우,196500,188500,-8000,-4.07,397461,77209282000
017670,SK텔레콤,216500,220000,3500,1.62,733171,161744271200
000660,SK하이닉스,83200,85300,2100,2.52,6870841,581215886250
005610,SPC삼립,66300,64100,-2200,-3.32,35147,2254184000
011810,STX,5590,5570,-20,-0.36,38806,214172770
077970,STX엔진,5730,5760,30,0.52,13443,78082610
071970,STX중공업,2360,2360,0,0.0,55143,128976570
084870,TBH글로벌,1760,1770,10,0.57,106967,188892300
002710,TCC스틸,1835,1920,85,4.63,1570063,3211892110
024070,WISCOM,2275,2290,15,0.66,23772,54155295
037270,YGPLUS,3465,3530,65,1.88,7038903,25229082690
000500,가온전선,16600,16650,50,0.3,2348,39298350
000860,강남제비스코,15100,15150,50,0.33,6095,92021150
035250,강원랜드,23050,22950,-100,-0.43,611910,14094245800
011420,갤럭시아에스엠,1500,1450,-50,-3.33,681942,1006415350
002100,경농,13600,13750,150,1.1,312684,4248172600
009450,경동나비엔,53000,51700,-1300,-2.45,69429,3602494700
267290,경동도시가스,16750,16750,0,0.0,6473,108216000
012320,경동인베스트,27800,27600,-200,-0.72,3837,106155200
000050,경방,11750,11500,-250,-2.13,11364,131001950
214390,경보제약,10400,10200,-200,-1.92,202680,2073544050
012610,경인양행,8670,8790,120,1.38,940721,8110306270
009140,경인전자,18750,18750,0,0.0,1311,24205600
013580,계룡건설,24300,23500,-800,-3.29,241764,5721808650
012200,계양전기,2815,2835,20,0.71,104866,296058390
012205,계양전기우,7960,8000,40,0.5,17465,138525830
002140,고려산업,3740,3730,-10,-0.27,206390,772883070
010130,고려아연,433000,421500,-11500,-2.66,63530,27021284500
002240,고려제강,16300,15950,-350,-2.15,58013,933806150
009290,광동제약,9730,9270,-460,-4.73,1042437,9757441970
017040,광명전기,1905,1905,0,0.0,254873,481681000
017900,광전자,2470,2575,105,4.25,19034640,52021419850
037710,광주신세계,137000,139500,2500,1.82,898,124921500
030610,교보증권,6830,6750,-80,-1.17,134043,907597040
007690,국도화학,37550,38150,600,1.6,13802,518771250
005320,국동,3035,3020,-15,-0.49,952638,2877695350
001140,국보,2425,2345,-80,-3.3,1596740,3743827430
002720,국제약품,10400,10150,-250,-2.4,1606817,16104110810
083420,그린케미칼,3350,3360,10,0.3,61755,206394545
014530,극동유화,3100,3110,10,0.32,70191,218056530
014280,금강공업,3645,3620,-25,-0.69,45575,165991925
014285,금강공업우,12650,12300,-350,-2.77,34096,424876900
008870,금비,57600,57000,-600,-1.04,1346,77057500
001570,금양,4185,4285,100,2.39,707297,3063578345
002990,금호산업,6850,6810,-40,-0.58,247854,1690588230
002995,금호산업우,39650,39250,-400,-1.01,56263,2185190800
011780,금호석유,84100,82500,-1600,-1.9,158391,13088966600
011785,금호석유우,32600,32250,-350,-1.07,7754,250259950
214330,금호에이치티,2305,2265,-40,-1.74,1475533,3357667495
001210,금호전기,3525,3555,30,0.85,26017,91778620
073240,금호타이어,2950,3000,50,1.69,473341,1405218385
092440,기신정기,3100,3130,30,0.97,41401,129361425
000270,기아차,39650,40700,1050,2.65,2577431,104886519500
024110,기업은행,8260,8240,-20,-0.24,1445972,11952708210
013700,까뮤이앤씨,1285,1295,10,0.78,563078,730978370
004540,깨끗한나라,4000,4000,0,0.0,411269,1635476200
004545,깨끗한나라우,30150,28200,-1950,-6.47,145151,4034600850
001260,남광토건,10750,10650,-100,-0.93,57820,614950350
008350,남선알미늄,5710,5690,-20,-0.35,3514798,19988238380
008355,남선알미우,82000,80100,-1900,-2.32,21573,1737031300
004270,남성,2870,2830,-40,-1.39,240234,682689570
003920,남양유업,287500,313000,25500,8.87,77268,25523289000
003925,남양유업우,159500,207000,47500,29.78,51401,10107144000
002070,남영비비안,1030,1020,-10,-0.97,5294925,5431607995
025860,남해화학,7820,7780,-40,-0.51,148445,1156412220
005720,넥센,3975,3980,5,0.13,36476,144865540
005725,넥센우,3095,3095,0,0.0,24717,76079310
002350,넥센타이어,5190,5210,20,0.39,256275,1341864900
002355,넥센타이어1우B,2300,2300,0,0.0,23988,55451020
003580,넥스트사이언스,5090,5000,-90,-1.77,287112,1427286765
251270,넷마블,130500,125500,-5000,-3.83,869417,111314572500
090350,노루페인트,7400,7400,0,0.0,50094,370602030
090355,노루페인트우,13900,13850,-50,-0.36,6015,83399850
000320,노루홀딩스,9280,9320,40,0.43,4045,37633030
000325,노루홀딩스우,19050,18750,-300,-1.57,1889,35269850
006280,녹십자,230000,229500,-500,-0.22,228393,52396544000
005250,녹십자홀딩스,27100,26850,-250,-0.92,200190,5402537100
005257,녹십자홀딩스2우,117500,107000,-10500,-8.94,66747,7368368500
004370,농심,362000,360000,-2000,-0.55,22125,7968912000
072710,농심홀딩스,80300,79900,-400,-0.5,3385,270112600
058730,다스코,4975,4870,-105,-2.11,82942,405936355
023590,다우기술,21000,21000,0,0.0,246211,5166741250
019680,대교,4050,4020,-30,-0.74,88348,355029980
019685,대교우B,2625,2640,15,0.57,94640,252302175
006370,대구백화점,4900,5030,130,2.65,2949,14661495
008060,대덕,6650,6930,280,4.21,4048781,28512689390
00806K,대덕1우,6650,7010,360,5.41,711305,5324294210
353200,대덕전자,13350,13800,450,3.37,10997827,157046356750
35320K,대덕전자1우,7270,8170,900,12.38,2711416,23782493970
000490,대동공업,7800,7610,-190,-2.44,1752771,13311189940
008110,대동전자,4130,4135,5,0.12,18886,78790370
005750,대림BCo,5200,5200,0,0.0,35556,183753460
001880,대림건설,29100,28500,-600,-2.06,111868,3184393600
000210,대림산업,84100,83700,-400,-0.48,141058,11837212600
000215,대림산업우,38300,38700,400,1.04,8795,336377900
004440,대림씨엔에스,7050,7000,-50,-0.71,30998,217854710
006570,대림통상,4390,4270,-120,-2.73,6342,27355410
001680,대상,25450,25150,-300,-1.18,171215,4319088850
001685,대상우,14300,14300,0,0.0,3822,54603500
084690,대상홀딩스,8500,8400,-100,-1.18,138313,1159566030
084695,대상홀딩스우,6850,6840,-10,-0.15,4298,29639960
128820,대성산업,3290,3320,30,0.91,80755,266761020
117580,대성에너지,4915,4920,5,0.1,15769,77623640
016710,대성홀딩스,14400,14500,100,0.69,21084,304128300
003540,대신증권,10400,10300,-100,-0.96,98816,1023342650
003547,대신증권2우B,9190,9110,-80,-0.87,22825,209216180
003545,대신증권우,9350,9340,-10,-0.11,59391,554780100
009190,대양금속,4335,4150,-185,-4.27,2253201,9513359775
014160,대영포장,1085,1080,-5,-0.46,1671293,1826433135
047040,대우건설,3645,3545,-100,-2.74,1835649,6580190590
009320,대우부품,2390,2380,-10,-0.42,620423,1485700190
042660,대우조선해양,23350,23300,-50,-0.21,216135,5030760750
003090,대웅,27000,26700,-300,-1.11,1203946,33085989500
069620,대웅제약,111000,112000,1000,0.9,642655,75715013000
000430,대원강업,3095,3110,15,0.48,35860,111079465
006340,대원전선,1060,1060,0,0.0,606625,636812185
006345,대원전선우,3920,3870,-50,-1.28,89316,343777720
003220,대원제약,21500,21400,-100,-0.47,896302,19223005000
024890,대원화성,1760,1790,30,1.7,192597,338984530
002880,대유에이텍,678,671,-7,-1.03,137541,92614142
000300,대유플러스,638,640,2,0.31,192679,123290497
012800,대창,1230,1200,-30,-2.44,2156981,2589325285
015230,대창단조,26450,26500,50,0.19,9055,238192950
001070,대한방직,33800,33400,-400,-1.18,8205,273638200
006650,대한유화,120500,116000,-4500,-3.73,108926,12713803500
001440,대한전선,904,902,-2,-0.22,7062863,6424804165
084010,대한제강,6590,6490,-100,-1.52,71561,469204310
001790,대한제당,19850,20200,350,1.76,28716,576240250
001795,대한제당우,14700,14650,-50,-0.34,1815,26311550
001130,대한제분,160000,165000,5000,3.13,18208,3012754000
003490,대한항공,17500,17400,-100,-0.57,1859030,32382177550
003495,대한항공우,18800,19100,300,1.6,43121,814466150
005880,대한해운,15950,16000,50,0.31,54212,869838600
003830,대한화섬,88200,89700,1500,1.7,248,21957100
016090,대현,1765,1775,10,0.57,109181,193086780
069460,대호에이엘,2275,2280,5,0.22,134968,308153555
192080,더블유게임즈,75000,74700,-300,-0.4,152301,11347651400
012510,더존비즈온,105000,105000,0,0.0,71718,7486940000
004830,덕성,4640,4670,30,0.65,482507,2258783815
004835,덕성우,10650,10900,250,2.35,44806,480186400
024900,덕양산업,1550,1510,-40,-2.58,388652,591954035
145720,덴티움,44400,42450,-1950,-4.39,83083,3561177300
002150,도화엔지니어링,7940,7930,-10,-0.13,81545,646835430
001230,동국제강,6050,5920,-130,-2.15,507996,3037454650
023450,동남합성,32150,32100,-50,-0.16,813,26028650
004140,동방,1910,1905,-5,-0.26,302080,572047645
007590,동방아그로,6470,6470,0,0.0,16007,104109940
005960,동부건설,11750,11650,-100,-0.85,114278,1313051350
005965,동부건설우,33100,32850,-250,-0.76,1929,62890400
026960,동서,20750,21050,300,1.45,103270,2175119950
002210,동성제약,12850,12700,-150,-1.17,387138,4950740200
102260,동성코퍼레이션,3905,3910,5,0.13,21368,82912805
005190,동성화학,16150,15950,-200,-1.24,11201,179276000
000640,동아쏘시오홀딩스,100500,99800,-700,-0.7,11462,1145724500
170900,동아에스티,93700,91900,-1800,-1.92,29567,2741334900
028100,동아지질,15800,16350,550,3.48,279965,4529084800
282690,동아타이어,10900,10800,-100,-0.92,724,7832250
001520,동양,1205,1200,-5,-0.41,510887,614004670
001527,동양2우B,17500,16500,-1000,-5.71,20178,336016600
001529,동양3우B,27900,28950,1050,3.76,2737,76732300
084670,동양고속,26600,26700,100,0.38,6403,170276450
002900,동양물산,1090,1110,20,1.83,12600881,14224347220
082640,동양생명,3005,3030,25,0.83,115498,351195280
001525,동양우,7060,7000,-60,-0.85,11438,80138280
008970,동양철관,1040,1035,-5,-0.48,1090877,1126903060
092780,동양피스톤,5380,5220,-160,-2.97,448269,2354592520
049770,동원FB,181500,181000,-500,-0.28,6106,1106317000
018500,동원금속,680,678,-2,-0.29,88965,60430593
006040,동원산업,193000,189000,-4000,-2.07,7808,1485241000
030720,동원수산,9340,9360,20,0.21,146406,1384649830
014820,동원시스템즈,21050,21050,0,0.0,25048,526769350
014825,동원시스템즈우,29650,30400,750,2.53,865,25765650
163560,동일고무벨트,8120,8030,-90,-1.11,59535,478295500
004890,동일산업,69200,69200,0,0.0,2384,164673200
002690,동일제강,1915,1915,0,0.0,19766,37691740
000020,동화약품,24050,23300,-750,-3.12,1021338,23813006250
000150,두산,45600,48500,2900,6.36,333304,15667483500
000157,두산2우B,83800,82600,-1200,-1.43,8000,661824500
241560,두산밥캣,28050,28050,0,0.0,268806,7517125950
336370,두산솔루스,38100,38500,400,1.05,436920,16584043250
33637K,두산솔루스1우,18100,18300,200,1.1,39691,716677950
33637L,두산솔루스2우B,37200,37000,-200,-0.54,9255,344424050
000155,두산우,39250,39250,0,0.0,47150,1832698400
042670,두산인프라코어,7250,7200,-50,-0.69,4400882,31826064140
034020,두산중공업,10850,10850,0,0.0,9153255,97284215950
336260,두산퓨얼셀,46500,45450,-1050,-2.26,1011599,46164096950
33626K,두산퓨얼셀1우,14000,13600,-400,-2.86,199281,2708115750
33626L,두산퓨얼셀2우B,23000,22550,-450,-1.96,42890,963236500
016740,두올,3650,3630,-20,-0.55,472902,1732616685
192650,드림텍,12050,11950,-100,-0.83,4544466,55592730050
024090,디씨엠,11000,10900,-100,-0.91,3634,40034600
003160,디아이,4145,4310,165,3.98,299787,1286988805
092200,디아이씨,1625,1800,175,10.77,6526901,12351222805
013570,디와이,4100,4100,0,0.0,57818,236958370
210540,디와이파워,11500,11100,-400,-3.48,137792,1547064100
007340,디티알오토모티브,24000,24150,150,0.63,13550,325345850
026890,디피씨,18850,17150,-1700,-9.02,19170528,344934700550
115390,락앤락,10900,10750,-150,-1.38,72767,787067700
032350,롯데관광개발,16300,16500,200,1.23,341014,5612410850
330590,롯데리츠,5170,5170,0,0.0,167533,865113210
000400,롯데손해보험,1730,1720,-10,-0.58,370974,641205750
023530,롯데쇼핑,78100,78900,800,1.02,109821,8704262200
004000,롯데정밀화학,43650,43550,-100,-0.23,149391,6497259850
286940,롯데정보통신,34000,34300,300,0.88,22509,766066700
280360,롯데제과,106500,108500,2000,1.88,9055,975970000
004990,롯데지주,30950,30900,-50,-0.16,181555,5632459000
00499K,롯데지주우,69000,68500,-500,-0.72,14249,982849200
005300,롯데칠성,101000,100500,-500,-0.5,13259,1331417000
005305,롯데칠성우,64200,63400,-800,-1.25,3361,213106600
011170,롯데케미칼,171500,170000,-1500,-0.87,170392,29022640000
002270,롯데푸드,330500,331000,500,0.15,2198,726105500
071840,롯데하이마트,30650,30600,-50,-0.16,62835,1933571700
027740,마니커,762,781,19,2.49,3818260,2943389047
204320,만도,23900,27200,3300,13.81,4743705,124977820750
001080,만호제강,15250,15500,250,1.64,14712,226941950
088980,맥쿼리인프라,11300,11300,0,0.0,686142,7744541600
094800,맵스리얼티1,4000,4000,0,0.0,116626,467069230
138040,메리츠금융지주,8590,8570,-20,-0.23,169754,1459287200
008560,메리츠증권,3115,3125,10,0.32,1318862,4123188940
000060,메리츠화재,12700,12600,-100,-0.79,175756,2216760300
090370,메타랩스,1210,1260,50,4.13,1119552,1422783735
017180,명문제약,5970,5880,-90,-1.51,1560641,9259309520
012690,모나리자,5890,5880,-10,-0.17,566248,3338728810
005360,모나미,8990,9540,550,6.12,42083209,402196974700
204210,모두투어리츠,2805,2790,-15,-0.53,818,2300635
009680,모토닉,7370,7480,110,1.49,34464,254409740
009580,무림PP,2995,2985,-10,-0.33,67716,202142400
009200,무림페이퍼,2070,2090,20,0.97,68971,143064255
033920,무학,5600,5520,-80,-1.43,56090,310707150
008420,문배철강,2770,2790,20,0.72,4063083,11754683005
025560,미래산업,3280,3280,0,0.0,111953,367676695
007120,미래아이앤지,377,382,5,1.33,445369,168204054
006800,미래에셋대우,7560,7460,-100,-1.32,1945831,14646168150
00680K,미래에셋대우2우B,4190,4165,-25,-0.6,486246,2028184895
006805,미래에셋대우우,4770,4790,20,0.42,35977,172278190
085620,미래에셋생명,3215,3260,45,1.4,286655,941746445
002840,미원상사,81100,81100,0,0.0,1759,142493800
268280,미원에스씨,80200,80100,-100,-0.12,1171,94255300
107590,미원홀딩스,46950,47050,100,0.21,2922,137802600
134380,미원화학,52200,52000,-200,-0.38,511,26556700
003650,미창석유,57700,58000,300,0.52,143,8274000
155900,바다로19호,2620,2615,-5,-0.19,6162,16126360
003610,방림,1725,1740,15,0.87,83308,142582015
001340,백광산업,3845,3715,-130,-3.38,4551513,17021364800
035150,백산,5160,5080,-80,-1.55,106292,543584840
002410,범양건영,6300,6450,150,2.38,8066136,52889767030
096300,베트남개발1,287,286,-1,-0.35,111619,31964044
007210,벽산,1805,1785,-20,-1.11,258184,462056235
002760,보락,1880,1990,110,5.85,6232219,12209871220
003850,보령제약,16650,16300,-350,-2.1,451956,7399656150
000890,보해양조,903,891,-12,-1.33,1351159,1212694646
003000,부광약품,37700,37150,-550,-1.46,2418681,89958321450
001270,부국증권,19050,19150,100,0.52,4028,77373550
001275,부국증권우,18050,18150,100,0.55,768,13885250
026940,부국철강,6000,6320,320,5.33,2791218,17195552720
015350,부산가스,36250,36450,200,0.55,4139,150790300
011390,부산산업,130000,131500,1500,1.15,13785,1804471500
005030,부산주공,339,334,-5,-1.47,49425,16480313
100220,비상교육,7000,6990,-10,-0.14,18777,131334730
030790,비케이탑스,6300,5990,-310,-4.92,249676,1501992060
101140,비티원,3820,3960,140,3.66,679214,2694022485
005180,빙그레,61700,61300,-400,-0.65,26959,1666377300
003960,사조대림,14600,14500,-100,-0.68,18288,264431750
008040,사조동아원,880,876,-4,-0.45,265131,232137560
007160,사조산업,34250,34550,300,0.88,50828,1767634650
014710,사조씨푸드,3950,3930,-20,-0.51,96364,377945045
006090,사조오양,8400,8330,-70,-0.83,51506,428322010
005090,삼광글라스,28650,28650,0,0.0,4711,135018250
001470,삼부토건,711,716,5,0.7,572639,406404625
006400,삼성SDI,385500,383500,-2000,-0.52,305365,117034080000
006405,삼성SDI우,229000,229000,0,0.0,10547,2409701000
006660,삼성공조,6430,6570,140,2.18,13899,90910960
028260,삼성물산,110500,108000,-2500,-2.26,325177,35534521500
02826K,삼성물산우B,89700,89800,100,0.11,11127,994629400
207940,삼성바이오로직스,741000,736000,-5000,-0.67,143504,105018753000
032830,삼성생명,48850,48100,-750,-1.54,602830,29358540650
018260,삼성에스디에스,171500,169500,-2000,-1.17,147496,25179957500
028050,삼성엔지니어링,12000,12000,0,0.0,1197340,14373579300
009150,삼성전기,144500,144500,0,0.0,516911,75407865500
009155,삼성전기우,63400,63700,300,0.47,34966,2235372500
005930,삼성전자,59000,59000,0,0.0,19285354,1147803957700
005935,삼성전자우,50200,50600,400,0.8,1535279,77843824500
001360,삼성제약,4445,4290,-155,-3.49,3238139,14029061910
010140,삼성중공업,5680,5670,-10,-0.18,3138197,17882555700
010145,삼성중공우,501000,495000,-6000,-1.2,8582,4233588500
016360,삼성증권,29250,29300,50,0.17,324698,9523060250
068290,삼성출판사,21750,22500,750,3.45,349732,7780885650
029780,삼성카드,28700,28850,150,0.52,196129,5619409950
000810,삼성화재,178500,175500,-3000,-1.68,97472,17237193500
000815,삼성화재우,123500,124000,500,0.4,6137,759125000
006110,삼아알미늄,5190,5440,250,4.82,134504,713041300
145990,삼양사,69200,66300,-2900,-4.19,55039,3791198800
145995,삼양사우,60800,60900,100,0.16,72105,4410208300
003230,삼양식품,121000,120000,-1000,-0.83,44528,5331303500
002170,삼양통상,56600,57900,1300,2.3,8803,506686300
272550,삼양패키징,18150,18450,300,1.65,25136,458996900
000070,삼양홀딩스,72900,73000,100,0.14,25409,1868063300
000075,삼양홀딩스우,55200,54100,-1100,-1.99,10942,601218700
002810,삼영무역,12700,12800,100,0.79,18856,240137950
005680,삼영전자,7750,8050,300,3.87,203999,1657092970
003720,삼영화학,1635,1700,65,3.98,655186,1085540995
023000,삼원강재,2020,2035,15,0.74,25494,51703345
004380,삼익THK,10300,10700,400,3.88,96291,1021396050
002450,삼익악기,1440,1450,10,0.69,113980,165212405
000520,삼일제약,19750,19400,-350,-1.77,30214,589027500
009770,삼정펄프,25750,27800,2050,7.96,3061,82676450
005500,삼진제약,29950,29000,-950,-3.17,116408,3401858300
004690,삼천리,78300,76900,-1400,-1.79,6409,492318700
010960,삼호개발,4385,4365,-20,-0.46,86982,381672040
004450,삼화왕관,43750,41900,-1850,-4.23,1633,68995350
009470,삼화전기,19350,19050,-300,-1.55,83011,1594623950
011230,삼화전자,3100,3100,0,0.0,136228,423767170
001820,삼화콘덴서,61000,61400,400,0.66,416926,25584711700
000390,삼화페인트,4960,4960,0,0.0,27996,139125575
001290,상상인증권,1035,1040,5,0.48,63178,65292395
041650,상신브레이크,2400,2440,40,1.67,86602,209480620
075180,새론오토모티브,4020,4050,30,0.75,18639,75086655
007540,샘표,60200,58700,-1500,-2.49,57698,3383202000
248170,샘표식품,47100,47100,0,0.0,32023,1490028200
007860,서연,6680,6870,190,2.84,757519,5164619790
200880,서연이화,3625,3650,25,0.69,69664,253026730
017390,서울가스,67400,67200,-200,-0.3,691,46214600
004410,서울식품,157,157,0,0.0,1738174,272977169
004415,서울식품우,4785,4695,-90,-1.88,281533,1383123500
021050,서원,3830,3810,-20,-0.52,1457378,5529792440
008490,서흥,58700,58400,-300,-0.51,100790,5822240100
007610,선도전기,2590,2610,20,0.77,50544,131277305
136490,선진,10000,9980,-20,-0.2,45931,460245360
002820,선창산업,3560,3530,-30,-0.84,22973,80489765
014910,성문전자,1525,1570,45,2.95,115779,178669155
014915,성문전자우,10950,11100,150,1.37,10143,112130550
003080,성보화학,4430,4435,5,0.11,9082,40287160
004980,성신양회,7830,7770,-60,-0.77,459304,3565419470
004985,성신양회우,22000,20700,-1300,-5.91,200281,4113854000
011300,성안,406,406,0,0.0,91960,37331862
000180,성창기업지주,1830,1795,-35,-1.91,463165,831402460
002420,세기상사,64100,62200,-1900,-2.96,2433,152928000
004360,세방,10300,10100,-200,-1.94,43773,444790850
004365,세방우,6180,6160,-20,-0.32,427,2614040
004490,세방전지,29250,29650,400,1.37,35445,1056657950
001430,세아베스틸,11100,10900,-200,-1.8,117134,1284950750
306200,세아제강,56800,56000,-800,-1.41,7998,449161500
003030,세아제강지주,38950,39000,50,0.13,3719,142856050
019440,세아특수강,10550,10450,-100,-0.95,4815,50395300
058650,세아홀딩스,73300,73500,200,0.27,175,12964300
013000,세우글로벌,1900,1910,10,0.53,278730,531451700
091090,세원셀론텍,2795,2760,-35,-1.25,234032,647163750
021820,세원정공,8090,8090,0,0.0,0,0
067830,세이브존IC,2195,2205,10,0.46,21599,47496885
033530,세종공업,6600,5910,-690,-10.45,2899599,17342042720
075580,세진중공업,5810,6260,450,7.75,1700426,10479720300
027970,세하,1580,1580,0,0.0,171283,266898285
145210,세화아이엠씨,1325,1190,-135,-10.19,2760813,3424776065
308170,센트랄모텍,28300,28300,0,0.0,84049,2371871900
068270,셀트리온,301500,300000,-1500,-0.5,2723830,812500073000
004430,송원산업,13250,13150,-100,-0.75,89768,1184217750
017550,수산중공업,1725,1705,-20,-1.16,637597,1090068590
053210,스카이라이프,8310,8310,0,0.0,253479,2126319930
134790,시디즈,49550,49650,100,0.2,2953,145858700
016590,신대양제지,56300,56000,-300,-0.53,15114,847699700
029530,신도리코,23250,23100,-150,-0.65,16175,375871350
004970,신라교역,9960,10000,40,0.4,2067,20636390
011930,신성이엔지,1430,1390,-40,-2.8,3777646,5273182855
005390,신성통상,2275,2200,-75,-3.3,39296914,89620573480
004170,신세계,208500,213500,5000,2.4,144066,30966803500
035510,신세계IC,121500,124000,2500,2.06,9186,1132400000
034300,신세계건설,21200,23350,2150,10.14,251035,5905772600
031430,신세계인터내셔날,149500,149500,0,0.0,37423,5641307500
031440,신세계푸드,54000,54200,200,0.37,4900,264832800
006880,신송홀딩스,3840,3870,30,0.78,14126,54165330
005800,신영와코루,93500,93000,-500,-0.53,449,41783300
001720,신영증권,44750,45450,700,1.56,4045,181563150
001725,신영증권우,43600,43850,250,0.57,1392,60942250
009270,신원,1640,1670,30,1.83,1330504,2218842825
009275,신원우,54000,53300,-700,-1.3,5743,309209300
002700,신일전자,1935,2015,80,4.13,8136492,16225974150
019170,신풍제약,75000,86000,11000,14.67,16135343,1337836816700
019175,신풍제약우,147000,191000,44000,29.93,1196445,206822905000
002870,신풍제지,1685,1815,130,7.72,4605019,8594280475
293940,신한알파리츠,6510,6500,-10,-0.15,60421,393464400
055550,신한지주,31050,30950,-100,-0.32,1905955,59464629100
001770,신화실업,20100,20100,0,0.0,2187,43936450
004080,신흥,9140,9100,-40,-0.44,3533,31965620
102280,쌍방울,774,774,0,0.0,2467501,1897427912
003410,쌍용양회,4965,4970,5,0.1,718529,3568087575
003415,쌍용양회우,14100,14400,300,2.13,3484,49684600
003620,쌍용차,3850,3740,-110,-2.86,1477458,5557745430
004770,써니전자,3725,3635,-90,-2.42,1289008,4718449115
015540,쎌마테라퓨틱스,9800,9470,-330,-3.37,792969,7573610210
004920,씨아이테크,1125,1130,5,0.44,196848,220243295
112610,씨에스윈드,69900,81000,11100,15.88,1459297,111282276700
008700,아남전자,1735,1735,0,0.0,364215,633065320
002790,아모레G,53900,54200,300,0.56,130708,7127335900
00279K,아모레G3우전환,34150,34200,50,0.15,6366,218394750
002795,아모레G우,23300,24000,700,3.0,102630,2467967550
090430,아모레퍼시픽,163500,166000,2500,1.53,314375,52593640500
090435,아모레퍼시픽우,60000,60300,300,0.5,47105,2846576400
002030,아세아,75100,75000,-100,-0.13,3497,259752600
183190,아세아시멘트,60200,59500,-700,-1.16,4949,295929900
002310,아세아제지,28450,28650,200,0.7,109021,3155922400
267850,아시아나IDT,20550,21400,850,4.14,3365975,70351671700
020560,아시아나항공,4300,4085,-215,-5.0,13719192,57360145395
122900,아이마켓코리아,8470,8490,20,0.24,50771,429646000
010780,아이에스동서,48400,46200,-2200,-4.55,198376,9206691550
033660,아주캐피탈,11500,11550,50,0.43,24929,285887950
001780,알루코,2015,2020,5,0.25,289157,583450720
018250,애경산업,22500,22600,100,0.44,63446,1436880350
161000,애경유화,6760,6690,-70,-1.04,62887,422755000
011090,에넥스,1130,1160,30,2.65,964787,1119516385
005850,에스엘,11450,11350,-100,-0.87,348655,3984247550
012750,에스원,92400,91000,-1400,-1.52,42766,3903294100
023960,에쓰씨엔지니어링,1225,1225,0,0.0,21504,26386545
298690,에어부산,3895,3800,-95,-2.44,557004,2131942390
140910,에이리츠,6410,6470,60,0.94,18520,119460820
078520,에이블씨엔씨,8150,8220,70,0.86,117938,976350150
015260,에이엔피,188,184,-4,-2.13,900729,166587508
007460,에이프로젠KIC,2745,2725,-20,-0.73,3683870,10157210750
003060,에이프로젠제약,1515,1515,0,0.0,8172911,12486938150
036570,엔씨소프트,812000,825000,13000,1.6,137745,113307528000
138250,엔에스쇼핑,12550,12550,0,0.0,57869,728748900
085310,엔케이,1095,1065,-30,-2.74,596128,638611540
009810,엔케이물산,527,522,-5,-0.95,328370,171872805
900140,엘브이엠씨홀딩스,3590,3590,0,0.0,171701,620535345
014440,영보화학,4800,4830,30,0.63,895798,4281137370
111770,영원무역,24400,24450,50,0.2,99143,2422986250
009970,영원무역홀딩스,34200,34000,-200,-0.58,11559,394055800
003520,영진약품,6580,6500,-80,-1.22,5894872,38568380230
000670,영풍,547000,545000,-2000,-0.37,2928,1599087000
006740,영풍제지,3410,3370,-40,-1.17,44737,151194280
012280,영화금속,2080,2115,35,1.68,22598629,50401957425
012160,영흥,1225,1205,-20,-1.63,1343369,1665576840
015360,예스코홀딩스,34050,34100,50,0.15,656,22558700
007310,오뚜기,557000,556000,-1000,-0.18,2293,1275786000
002630,오리엔트바이오,756,744,-12,-1.59,1812479,1335563676
271560,오리온,134000,133500,-500,-0.37,60713,8118501500
001800,오리온홀딩스,12700,12450,-250,-1.97,248511,3104469700
070960,용평리조트,4480,4515,35,0.78,91728,414771315
316140,우리금융지주,8670,8680,10,0.12,1842447,16056327740
004720,우리들제약,7430,7450,20,0.27,406442,3028710090
118000,우리들휴브레인,3300,3340,40,1.21,1333208,4354431315
010050,우리종금,586,594,8,1.37,1927141,1143960697
006980,우성사료,3290,3265,-25,-0.76,569498,1889288250
017370,우신시스템,2870,2935,65,2.26,129932,371541705
105840,우진,3695,3800,105,2.84,178713,678099780
010400,우진아이엔에스,6990,6940,-50,-0.72,10503,73488430
049800,우진플라임,3645,3495,-150,-4.12,29885,106087630
016880,웅진,1120,1105,-15,-1.34,205838,228019835
095720,웅진씽크빅,2585,2570,-15,-0.58,534850,1376552655
005820,원림,17100,17200,100,0.58,527,9058450
010600,웰바이오텍,3335,3335,0,0.0,593825,1939808975
008600,윌비스,1295,1290,-5,-0.39,1311382,1704079655
033270,유나이티드제약,24750,25150,400,1.62,263053,6475364000
014830,유니드,44000,44350,350,0.8,69439,3061503600
000910,유니온,9560,8980,-580,-6.07,6143677,54980787420
047400,유니온머티리얼,5190,4945,-245,-4.72,7907369,39646284685
011330,유니켐,1405,1410,5,0.36,216128,304231145
077500,유니퀘스트,10200,10800,600,5.88,593550,6309345550
002920,유성기업,2475,2480,5,0.2,13902,34373305
000700,유수홀딩스,5740,5740,0,0.0,19649,113086970
003470,유안타증권,2825,2860,35,1.24,304567,867538550
003475,유안타증권우,2235,2230,-5,-0.22,71662,160012340
011690,유양디앤유,1220,1220,0,0.0,0,0
072130,유엔젤,3160,3195,35,1.11,90878,289638845
000220,유유제약,16400,15950,-450,-2.74,376418,6066265750
000225,유유제약1우,17550,16700,-850,-4.84,270926,4414106400
000227,유유제약2우B,52000,47300,-4700,-9.04,51773,2385598250
001200,유진투자증권,3615,3655,40,1.11,735171,2702140320
000100,유한양행,56400,55700,-700,-1.24,618688,34486237700
000105,유한양행우,68100,65400,-2700,-3.96,50083,3310353500
003460,유화증권,2165,2150,-15,-0.69,3159,6828270
003465,유화증권우,2485,2455,-30,-1.21,4929,12067495
008730,율촌화학,16650,16750,100,0.6,103151,1727271700
008250,이건산업,7780,7670,-110,-1.41,123163,944069530
025820,이구산업,1590,1570,-20,-1.26,166203,262008625
214320,이노션,49000,50900,1900,3.88,155930,7857605450
088260,이리츠코크렙,5270,5300,30,0.57,50346,266428340
139480,이마트,115500,115000,-500,-0.43,164752,19090029500
007660,이수페타시스,4400,4430,30,0.68,1892042,8406387455
005950,이수화학,8680,8660,-20,-0.23,59243,513521960
015020,이스타코,769,769,0,0.0,93110,71343683
093230,이아이디,265,259,-6,-2.26,14966253,3915140355
074610,이엔플러스,5340,5210,-130,-2.43,952934,4955492810
102460,이연제약,15800,15750,-50,-0.32,84356,1312205850
084680,이월드,3885,3985,100,2.57,1065552,4199975925
334890,이지스밸류리츠,4445,4460,15,0.34,174592,777923440
000760,이화산업,14000,14200,200,1.43,724,10215250
014990,인디에프,1995,2000,5,0.25,602958,1213128715
006490,인스코비,2010,1980,-30,-1.49,716629,1419471005
023800,인지컨트롤스,5160,5100,-60,-1.16,131622,673125455
034590,인천도시가스,24500,24200,-300,-1.22,1292,31276250
129260,인터지스,2820,2750,-70,-2.48,530106,1477413790
023810,인팩,4620,4655,35,0.76,7203,33219405
249420,일동제약,16050,15600,-450,-2.8,68801,1082073300
000230,일동홀딩스,9090,9090,0,0.0,11129,100595500
013360,일성건설,951,970,19,2.0,151835,144385634
003120,일성신약,85700,83500,-2200,-2.57,16664,1401309200
003200,일신방직,68300,68100,-200,-0.29,6999,477964100
007110,일신석재,2390,2425,35,1.46,1749119,4232996620
007570,일양약품,87800,86900,-900,-1.03,898498,77671052100
007575,일양약품우,107000,105500,-1500,-1.4,23790,2475703500
008500,일정실업,13200,13150,-50,-0.38,9496,123511450
081000,일진다이아,56600,55000,-1600,-2.83,333785,18459612100
020760,일진디스플,3005,3070,65,2.16,127697,388201350
020150,일진머티리얼즈,49450,51000,1550,3.13,584780,29605581700
103590,일진전기,2845,2840,-5,-0.18,92719,264727540
015860,일진홀딩스,4850,4910,60,1.24,1396032,7076072435
226320,잇츠한불,22050,22700,650,2.95,1796209,43517328150
317400,자이에스앤디,6350,6460,110,1.73,1094580,7097047030
033240,자화전자,13150,13550,400,3.04,903744,12294236800
000950,전방,25800,25800,0,0.0,46916,1237223250
194370,제이에스코퍼레이션,6850,6900,50,0.73,14584,99823230
025620,제이준코스메틱,2840,2850,10,0.35,709264,2053476490
036420,제이콘텐트리,29700,29500,-200,-0.67,107264,3177318700
030000,제일기획,20000,20200,200,1.0,753308,15157508550
271980,제일약품,63100,57300,-5800,-9.19,2100491,124652357500
001560,제일연마,6630,6630,0,0.0,6158,40681610
002620,제일파마홀딩스,26400,24000,-2400,-9.09,514166,12527862900
006220,제주은행,3085,3100,15,0.49,13206,40856535
089590,제주항공,16000,15850,-150,-0.94,71191,1126509050
004910,조광페인트,5450,5510,60,1.1,19024,103701880
004700,조광피혁,51000,51300,300,0.59,3712,188135000
001550,조비,24550,23850,-700,-2.85,361878,8701477250
000480,조선내화,72500,72800,300,0.41,403,29392600
120030,조선선재,112500,109000,-3500,-3.11,9140,1006911500
018470,조일알미늄,600,592,-8,-1.33,171577,101730676
002600,조흥,153000,153500,500,0.33,257,39313500
185750,종근당,135500,134000,-1500,-1.11,90339,12101650000
063160,종근당바이오,40700,39400,-1300,-3.19,69697,2757503150
001630,종근당홀딩스,124000,123000,-1000,-0.81,14727,1812531000
044380,주연테크,1225,1220,-5,-0.41,394050,478243160
013890,지누스,80600,79000,-1600,-1.99,101188,8092391700
013870,지엠비코리아,4960,4905,-55,-1.11,101856,501046530
071320,지역난방공사,34300,34400,100,0.29,11176,385576050
010580,지코,306,306,0,0.0,0,0
035000,지투알,4965,5000,35,0.7,33728,167685350
088790,진도,2550,2615,65,2.55,50652,131135170
003780,진양산업,3720,3635,-85,-2.28,307632,1126586345
010640,진양폴리,2975,2950,-25,-0.84,48470,142925595
100250,진양홀딩스,2400,2405,5,0.21,48895,117382320
051630,진양화학,3690,3665,-25,-0.68,112831,411534140
272450,진에어,10150,10050,-100,-0.99,102553,1030109800
011000,진원생명과학,9010,9000,-10,-0.11,1904739,17208090030
002780,진흥기업,2500,2540,40,1.6,232779,578039305
002787,진흥기업2우B,16400,16050,-350,-2.13,32531,520382400
002785,진흥기업우B,6030,5970,-60,-1.0,31780,188538820
009310,참엔지니어링,1330,1385,55,4.14,321779,437563745
000650,천일고속,62200,62300,100,0.16,583,36090800
012600,청호컴넷,4285,3985,-300,-7.0,295786,1169630185
033250,체시스,2825,2875,50,1.77,1459511,4188759295
035720,카카오,331500,332000,500,0.15,615872,205509206500
006380,카프로,2595,2595,0,0.0,129620,336577845
109070,컨버즈,4100,4100,0,0.0,0,0
001620,케이비아이동국실업,550,558,8,1.45,27545,15342999
029460,케이씨,23100,23300,200,0.87,154376,3600860100
344820,케이씨씨글라스,32500,32800,300,0.92,37738,1230344550
281820,케이씨텍,23050,23600,550,2.39,206364,4825333700
145270,케이탑리츠,754,755,1,0.13,138820,104406752
007815,코리아써우,5720,7100,1380,24.13,148857,1029477690
007810,코리아써키트,15200,17050,1850,12.17,2731710,45455205400
00781K,코리아써키트2우B,6570,8540,1970,29.98,114226,960001030
152330,코리아오토글라스,14250,14300,50,0.35,47729,679200350
003690,코리안리,7020,7010,-10,-0.14,255989,1794112830
192820,코스맥스,92400,94000,1600,1.73,110751,10398371800
044820,코스맥스비티아이,21650,22350,700,3.23,28007,615445000
005070,코스모신소재,14600,14400,-200,-1.37,736868,10654403350
005420,코스모화학,8780,8750,-30,-0.34,313886,2758156990
071950,코아스,1140,1140,0,0.0,131239,150308265
002020,코오롱,19150,19200,50,0.26,47119,902174750
003070,코오롱글로벌,10850,10900,50,0.46,154119,1656121200
003075,코오롱글로벌우,27500,27100,-400,-1.45,17848,473118700
144620,코오롱머티리얼,3050,3030,-20,-0.66,757422,2276698665
002025,코오롱우,12550,12350,-200,-1.59,12574,153363200
120110,코오롱인더,34150,34250,100,0.29,118940,4073156600
120115,코오롱인더우,18950,19050,100,0.53,12983,246440150
138490,코오롱플라스틱,4510,4615,105,2.33,1445430,6631867570
021240,코웨이,77800,77700,-100,-0.13,240073,18845493200
031820,콤텍시스템,1255,1245,-10,-0.8,377937,473554525
192400,쿠쿠홀딩스,80100,79900,-200,-0.25,10141,810378200
284740,쿠쿠홈시스,36650,36550,-100,-0.27,36491,1349588650
015590,큐로,683,673,-10,-1.46,1679981,1131959581
264900,크라운제과,8730,8530,-200,-2.29,70016,600712150
26490K,크라운제과우,10000,9550,-450,-4.5,55708,540369620
005740,크라운해태홀딩스,8420,8420,0,0.0,16746,140343420
005745,크라운해태홀딩스우,13000,12900,-100,-0.77,12245,156926500
020120,키다리스튜디오,8910,8750,-160,-1.8,166777,1468650170
039490,키움증권,96900,97200,300,0.31,54047,5259200100
012170,키위미디어그룹,150,150,0,0.0,0,0
014580,태경비케이,3750,3780,30,0.8,380782,1435796025
015890,태경산업,4920,4905,-15,-0.3,93153,457187755
006890,태경케미컬,8320,8400,80,0.96,5202763,44866795920
003240,태광산업,686000,687000,1000,0.15,1076,740766000
011280,태림포장,3510,3640,130,3.7,844895,3070891810
004100,태양금속,1070,1065,-5,-0.47,71790,76770100
004105,태양금속우,3445,3435,-10,-0.29,40652,139343800
009410,태영건설,16150,16050,-100,-0.62,216146,3498345700
009415,태영건설우,13550,14200,650,4.8,207189,2903564750
001420,태원물산,3600,3660,60,1.67,59756,219399525
007980,태평양물산,1765,1800,35,1.98,272967,490639985
055490,테이팩스,25800,25700,-100,-0.39,35403,902970600
078000,텔코웨어,12550,12700,150,1.2,17762,223377500
214420,토니모리,10100,10450,350,3.47,452365,4834806550
019180,티에이치엔,2680,2645,-35,-1.31,164580,437001995
091810,티웨이항공,2430,2385,-45,-1.85,395411,940765535
004870,티웨이홀딩스,1050,1025,-25,-2.38,407826,413085000
005690,파미셀,22650,22750,100,0.44,3317834,75238016700
036580,팜스코,6260,6260,0,0.0,60134,376727960
028670,팬오션,3540,3540,0,0.0,1700336,6109979370
010820,퍼스텍,2365,2340,-25,-1.06,640858,1504564270
016800,퍼시스,28450,28500,50,0.18,2604,74665100
001020,페이퍼코리아,1495,1535,40,2.68,194481,294934765
090080,평화산업,1190,1190,0,0.0,170742,201619210
010770,평화홀딩스,3005,3040,35,1.16,25637,76732300
058430,포스코강판,13000,13000,0,0.0,39301,506087900
047050,포스코인터내셔널,14100,13950,-150,-1.06,216577,3024124250
003670,포스코케미칼,72000,72600,600,0.83,221954,16037969800
007630,폴루스바이오팜,1225,1225,0,0.0,0,0
017810,풀무원,18450,18200,-250,-1.36,208042,3766479100
103140,풍산,23600,24300,700,2.97,498271,11986208500
005810,풍산홀딩스,26300,26350,50,0.19,9952,261731900
033180,필룩스,4390,4365,-25,-0.57,1205383,5318168630
086790,하나금융지주,29700,30100,400,1.35,1990458,60031136750
293480,하나제약,22300,22300,0,0.0,54109,1206855900
039130,하나투어,37800,38100,300,0.79,92682,3544707200
172580,하이골드12호,2180,2175,-5,-0.23,10412,22736430
153360,하이골드3호,1350,1345,-5,-0.37,5092,6855805
071090,하이스틸,16900,17050,150,0.89,7795,132299900
019490,하이트론,3000,2960,-40,-1.33,73927,219365305
000080,하이트진로,42550,41550,-1000,-2.35,539444,22449270300
000087,하이트진로2우B,22550,22500,-50,-0.22,6475,145403050
000140,하이트진로홀딩스,21650,21450,-200,-0.92,41124,870467800
000145,하이트진로홀딩스우,19700,19650,-50,-0.25,10211,199448950
152550,한국ANKOR유전,1710,1705,-5,-0.29,15136,25781610
036460,한국가스공사,25400,25300,-100,-0.39,162452,4121475150
005430,한국공항,33600,33500,-100,-0.3,7752,260027950
071050,한국금융지주,49850,49350,-500,-1.0,325919,16223210250
071055,한국금융지주우,36850,36400,-450,-1.22,14690,538357050
010040,한국내화,3490,3440,-50,-1.43,116883,402509675
025540,한국단자,39000,39000,0,0.0,62816,2460490700
004090,한국석유,96700,97000,300,0.31,2356,227558100
002200,한국수출포장,18500,18750,250,1.35,11860,222659300
002960,한국쉘석유,235000,235500,500,0.21,1469,346680000
123890,한국자산신탁,2810,2825,15,0.53,234898,661896720
015760,한국전력,19350,19200,-150,-0.78,1857004,35841152500
006200,한국전자홀딩스,530,533,3,0.57,41425,21996865
009540,한국조선해양,90800,91000,200,0.22,306548,27912468100
023350,한국종합기술,3980,3940,-40,-1.01,17829,70391330
025890,한국주강,1390,1380,-10,-0.72,18712,25827320
000970,한국주철관,9380,9210,-170,-1.81,294522,2720052570
104700,한국철강,4500,4505,5,0.11,63008,283730100
017960,한국카본,8410,8350,-60,-0.71,519631,4333820460
161890,한국콜마,45650,47550,1900,4.16,696707,32906369150
024720,한국콜마홀딩스,30050,30000,-50,-0.17,228080,6873740250
161390,한국타이어앤테크놀로지,25650,27900,2250,8.77,3301642,91784759500
000240,한국테크놀로지그룹,11350,14750,3400,29.96,8100058,109269956100
034830,한국토지신탁,1720,1720,0,0.0,479132,821824500
007280,한국특수형강,1695,1665,-30,-1.77,1965509,3238135240
168490,한국패러랠,1975,1960,-15,-0.76,40552,79489395
010100,한국프랜지,2425,2405,-20,-0.82,532758,1298275520
047810,한국항공우주,24900,24350,-550,-2.21,745200,18222290800
123690,한국화장품,13600,13850,250,1.84,632935,8885196450
003350,한국화장품제조,41050,41050,0,0.0,240708,10146265150
011500,한농화성,4820,4880,60,1.24,25992,125937205
002390,한독,34900,34700,-200,-0.57,204352,7129864350
014790,한라,3495,3500,5,0.14,323412,1119116005
060980,한라홀딩스,28050,29250,1200,4.28,112858,3272768700
053690,한미글로벌,9120,9350,230,2.52,405999,3691555290
042700,한미반도체,12350,12300,-50,-0.4,828663,10195711200
008930,한미사이언스,41850,41900,50,0.12,1190132,49633401900
128940,한미약품,263500,258000,-5500,-2.09,110774,28590811500
009240,한샘,102000,102500,500,0.49,57840,5937558000
020000,한섬,31150,30700,-450,-1.44,100541,3103617100
003680,한성기업,17050,16750,-300,-1.76,240633,4062574300
105630,한세실업,10600,10800,200,1.89,67578,726737500
069640,한세엠케이,2550,2555,5,0.2,13548,34779690
016450,한세예스24홀딩스,3925,3935,10,0.25,15989,63007555
010420,한솔PNS,1415,1405,-10,-0.71,80643,113270250
009180,한솔로지스틱스,2045,1960,-85,-4.16,3523588,7088003690
213500,한솔제지,14200,14000,-200,-1.41,176548,2480943450
014680,한솔케미칼,151500,152000,500,0.33,44769,6741137500
004710,한솔테크닉스,9150,9280,130,1.42,1149127,10679880650
004150,한솔홀딩스,3280,3285,5,0.15,89693,294980970
025750,한솔홈데코,1090,1110,20,1.83,934573,1029525935
004960,한신공영,14300,14600,300,2.1,56059,814457400
011700,한신기계,1325,1335,10,0.75,134499,179708775
001750,한양증권,8060,8140,80,0.99,24147,196128910
001755,한양증권우,14550,14250,-300,-2.06,4949,70175850
018880,한온시스템,9510,10050,540,5.68,2627301,25973501316
009420,한올바이오파마,29300,28850,-450,-1.54,495981,14533851500
014130,한익스프레스,5190,5030,-160,-3.08,181440,915755260
300720,한일시멘트,84500,84700,200,0.24,4350,368108700
002220,한일철강,1760,1805,45,2.56,58549,104435290
006390,한일현대시멘트,28050,28000,-50,-0.18,21145,592607150
003300,한일홀딩스,43600,44150,550,1.26,1044,45606900
051600,한전KPS,29550,29350,-200,-0.68,144116,4237736650
052690,한전기술,16500,16400,-100,-0.61,55714,909229600
130660,한전산업,3240,3235,-5,-0.15,21143,68248940
002320,한진,53200,51800,-1400,-2.63,162669,8375501700
097230,한진중공업,6540,6740,200,3.06,411252,2751020040
003480,한진중공업홀딩스,3610,3670,60,1.66,63715,232364045
180640,한진칼,85700,84900,-800,-0.93,200691,17119440300
18064K,한진칼우,52100,52100,0,0.0,18069,942304400
005110,한창,1885,1910,25,1.33,835012,1588362255
009460,한창제지,2010,1995,-15,-0.75,539032,1077701960
000880,한화,25750,26200,450,1.75,2382653,61494391950
00088K,한화3우B,12150,12100,-50,-0.41,179843,2166331000
088350,한화생명,1500,1495,-5,-0.33,4080281,6166769660
000370,한화손해보험,2815,2850,35,1.24,224192,633592180
009830,한화솔루션,25700,26100,400,1.56,1857994,48314054750
009835,한화솔루션우,28700,27300,-1400,-4.88,465332,12796179150
272210,한화시스템,10050,10050,0,0.0,861678,8661338800
012450,한화에어로스페이스,25900,24950,-950,-3.67,734928,18538577500
000885,한화우,68700,72700,4000,5.82,1195747,87397679900
003530,한화투자증권,1765,1770,5,0.28,443375,785169220
003535,한화투자증권우,3150,3020,-130,-4.13,440496,1348697490
195870,해성디에스,18900,20400,1500,7.94,2591429,52609941050
101530,해태제과식품,8640,8600,-40,-0.46,45532,390799210
143210,핸즈코퍼레이션,6250,6280,30,0.48,20021,125112880
000720,현대건설,33900,34000,100,0.29,468200,15960141400
267270,현대건설기계,22800,23300,500,2.19,323287,7481622300
000725,현대건설우,230500,227000,-3500,-1.52,8000,1820791000
005440,현대그린푸드,7950,7970,20,0.25,127684,1018978020
086280,현대글로비스,112500,114500,2000,1.78,179336,20609982500
064350,현대로템,17550,18350,800,4.56,4489560,80979462500
079430,현대리바트,19250,18900,-350,-1.82,153321,2917702050
012330,현대모비스,212000,213000,1000,0.47,399720,85831247500
010620,현대미포조선,32400,32100,-300,-0.93,191431,6196757850
069960,현대백화점,59300,60900,1600,2.7,131148,7977847800
004560,현대비앤지스틸,7560,7590,30,0.4,41593,315412720
004565,현대비앤지스틸우,79000,79700,700,0.89,3821,303261300
011760,현대상사,15100,15050,-50,-0.33,48422,724739950
004310,현대약품,6300,5900,-400,-6.35,2072364,12367033370
322000,현대에너지솔루션,30500,31450,950,3.11,348652,10693828000
126560,현대에이치씨엔,4155,4005,-150,-3.61,994415,4011024070
017800,현대엘리베이,46500,46850,350,0.75,244344,11379679650
307950,현대오토에버,39350,40350,1000,2.54,39382,1579397550
011210,현대위아,37850,39050,1200,3.17,262063,10218791700
267260,현대일렉트릭,11600,12400,800,6.9,3648370,44706397950
004020,현대제철,25650,25400,-250,-0.97,1089535,27721884900
267250,현대중공업지주,235500,236000,500,0.21,27539,6528292500
005380,현대차,125000,127500,2500,2.0,2728427,351119705500
005387,현대차2우B,68100,70000,1900,2.79,314825,21980071700
005389,현대차3우B,63000,64300,1300,2.06,34861,2241240300
005385,현대차우,67300,69500,2200,3.27,164839,11385974200
001500,현대차증권,9310,9350,40,0.43,82850,771461080
227840,현대코퍼레이션홀딩스,10000,10050,50,0.5,30429,304939300
001450,현대해상,23650,23800,150,0.63,226875,5418313200
057050,현대홈쇼핑,60800,60800,0,0.0,30679,1873628900
093240,형지엘리트,1570,1600,30,1.91,2330476,3738213330
003010,혜인,5010,5120,110,2.2,265309,1336430675
111110,호전실업,9080,8950,-130,-1.43,77722,698962460
008770,호텔신라,70100,71500,1400,2.0,606650,43230192100
008775,호텔신라우,62200,63700,1500,2.41,19597,1242122400
002460,화성산업,10550,11100,550,5.21,263929,2917022600
013520,화승알앤에이,1850,1830,-20,-1.08,399013,728138515
241590,화승엔터프라이즈,11550,11700,150,1.3,300616,3498877200
006060,화승인더,6950,7020,70,1.01,426836,3011283170
010690,화신,2195,2280,85,3.87,350861,795788955
133820,화인베스틸,2675,2665,-10,-0.37,547421,1462083670
010660,화천기계,3480,3480,0,0.0,548917,1910021370
000850,화천기공,32550,32500,-50,-0.15,7095,235061300
016580,환인제약,15300,15150,-150,-0.98,81040,1224004000
032560,황금에스티,6290,6170,-120,-1.91,65012,402553950
004800,효성,69200,69400,200,0.29,55013,3817370000
094280,효성ITX,25600,25600,0,0.0,64413,1633262500
298040,효성중공업,46150,42600,-3550,-7.69,984784,42198243550
298050,효성첨단소재,126500,125500,-1000,-0.79,85638,10664846500
298020,효성티앤씨,114500,114000,-500,-0.44,20739,2371392000
298000,효성화학,108500,109000,500,0.46,15416,1659606500
093370,후성,8460,8410,-50,-0.59,1957529,16418913340
081660,휠라홀딩스,34350,34050,-300,-0.87,238942,8164608250
005870,휴니드,7000,7000,0,0.0,123070,860266940
079980,휴비스,6430,6510,80,1.24,138720,895085130
005010,휴스틸,7120,7080,-40,-0.56,35367,248230270
069260,휴켐스,16700,16800,100,0.6,105498,1765969250
000540,흥국화재,2230,2230,0,0.0,22834,50901115
000547,흥국화재2우B,25850,25050,-800,-3.09,9356,239986350
000545,흥국화재우,6130,5960,-170,-2.77,19752,119597520
003280,흥아해운,258,258,0,0.0,0,0
