티커,종목명,시가,종가,변동폭,등락률,거래량,거래대금
095570,AJ네트웍스,3425,3440,15,0.44,68818,234126650
006840,AK홀딩스,20900,21000,100,0.48,29994,621719550
027410,BGF,4370,4340,-30,-0.69,415052,1773300565
282330,BGF리테일,146500,147000,500,0.34,57266,8346959940
138930,BNK금융지주,4875,4685,-190,-3.9,1765275,8325531720
001460,BYC,190500,191500,1000,0.52,417,79349000
001465,BYC우,104000,104500,500,0.48,129,13533000
001040,CJ,72000,70800,-1200,-1.67,100560,7119538700
079160,CJCGV,22700,22850,150,0.66,184633,4135172500
00104K,CJ4우전환,49900,49650,-250,-0.5,16071,787466650
000120,CJ대한통운,133500,143000,9500,7.12,168418,23873300000
011150,CJ씨푸드,3975,4065,90,2.26,5035823,19843304750
011155,CJ씨푸드1우,32600,32850,250,0.77,5448,176221850
001045,CJ우,36800,36850,50,0.14,2636,96116700
097950,CJ제일제당,236000,237000,1000,0.42,66956,15817379500
097955,CJ제일제당우,102500,101500,-1000,-0.98,3081,311848000
000590,CS홀딩스,46400,45300,-1100,-2.37,1159,52558200
012030,DB,684,683,-1,-0.15,1161901,784177624
016610,DB금융투자,3290,3190,-100,-3.04,169841,541659145
005830,DB손해보험,39000,37800,-1200,-3.08,346717,13232277400
000990,DB하이텍,22850,23800,950,4.16,1107354,25719971550
000995,DB하이텍1우,40500,40700,200,0.49,1003,40605850
139130,DGB금융지주,4910,4770,-140,-2.85,973528,4652375000
001530,DI동일,60100,60400,300,0.5,6614,395513700
004840,DRB동일,3900,3945,45,1.15,18541,72063320
155660,DSR,3585,3565,-20,-0.56,33937,119543805
069730,DSR제강,3540,3550,10,0.28,49055,170586935
017940,E1,34850,34600,-250,-0.72,17663,603265850
007700,FF,101000,105000,4000,3.96,100648,10488422400
114090,GKL,15150,15400,250,1.65,400823,6044829350
078930,GS,38950,38950,0,0.0,366290,14105892850
006360,GS건설,23650,23500,-150,-0.63,600166,14064039100
001250,GS글로벌,1535,1545,10,0.65,250367,384306065
007070,GS리테일,31250,30950,-300,-0.96,189123,5839092500
078935,GS우,29900,29750,-150,-0.5,5063,149359950
012630,HDC,8900,8840,-60,-0.67,355192,3108922560
039570,HDC아이콘트롤스,7670,7920,250,3.26,37891,292985380
089470,HDC현대EP,3100,3145,45,1.45,32900,101352250
294870,HDC현대산업개발,18800,18250,-550,-2.93,678851,12456112650
011200,HMM,3585,3705,120,3.35,3209617,11779374360
082740,HSD엔진,3000,3100,100,3.33,901660,2817249300
003560,IHQ,1485,1510,25,1.68,1852156,2786873300
175330,JB금융지주,4430,4345,-85,-1.92,380434,1649744495
234080,JW생명과학,16100,16000,-100,-0.62,75418,1197562200
001060,JW중외제약,28850,29200,350,1.21,190571,5547832050
001067,JW중외제약2우B,39000,39900,900,2.31,455,17947100
001065,JW중외제약우,25300,26200,900,3.56,13558,358742100
096760,JW홀딩스,5050,5000,-50,-0.99,133195,663692190
105560,KB금융,33200,31900,-1300,-3.92,4032094,128700857700
002380,KCC,146500,142500,-4000,-2.73,53838,7652524500
009070,KCTC,2215,2320,105,4.74,231821,521528490
009440,KC그린홀딩스,3535,3495,-40,-1.13,65584,228080830
119650,KC코트렐,4360,4380,20,0.46,167389,725962925
092220,KEC,739,740,1,0.14,367090,270338368
016380,KG동부제철,11100,12050,950,8.56,674462,8190478550
016385,KG동부제철우,72600,73700,1100,1.52,1181,88338100
001390,KG케미칼,12300,12900,600,4.88,364039,4697529650
001940,KISCO홀딩스,9890,9850,-40,-0.4,8202,80190980
025000,KPX케미칼,49300,49250,-50,-0.1,757,36765850
092230,KPX홀딩스,44000,43700,-300,-0.68,1246,53940800
000040,KR모터스,804,800,-4,-0.5,357820,285409822
044450,KSS해운,7140,7130,-10,-0.14,7852,55922720
030200,KT,21700,21500,-200,-0.92,903512,19397039400
033780,KTG,77800,77200,-600,-0.77,727390,55806899800
030210,KTB투자증권,2225,2190,-35,-1.57,193521,420315080
058850,KTcs,1750,1705,-45,-2.57,572029,971030485
058860,KTis,1715,1740,25,1.46,161284,275818945
093050,LF,12550,12350,-200,-1.59,100197,1234423450
003550,LG,60200,62700,2500,4.15,594662,36165121300
034220,LG디스플레이,11200,11150,-50,-0.45,1526549,16970040550
001120,LG상사,13050,12700,-350,-2.68,313457,3974751800
051900,LG생활건강,1200000,1191000,-9000,-0.75,52827,62791740000
051905,LG생활건강우,653000,645000,-8000,-1.23,6269,4061538000
003555,LG우,41800,41800,0,0.0,6409,264915050
032640,LG유플러스,12300,12150,-150,-1.22,1958525,23633104000
011070,LG이노텍,123000,126000,3000,2.44,248233,30875891000
066570,LG전자,53600,53500,-100,-0.19,788724,41864417500
066575,LG전자우,20400,20400,0,0.0,36383,736498250
108670,LG하우시스,40000,38800,-1200,-3.0,64774,2500432800
108675,LG하우시스우,19300,19200,-100,-0.52,787,14741200
037560,LG헬로비전,3895,4110,215,5.52,784606,3227234960
051910,LG화학,326500,343000,16500,5.05,621763,210922684000
051915,LG화학우,154000,160500,6500,4.22,38151,6125764500
079550,LIG넥스원,22900,22800,-100,-0.44,67350,1514983400
006260,LS,34250,33650,-600,-1.75,112852,3770231800
010120,LSELECTRIC,38050,37950,-100,-0.26,77233,2901792250
000680,LS네트웍스,1835,1795,-40,-2.18,132247,235503925
229640,LS전선아시아,6810,6840,30,0.44,84373,567013070
023150,MH에탄올,9230,9340,110,1.19,431404,4016625560
035420,NAVER,168500,170500,2000,1.19,841066,143678838500
181710,NHN,69700,74000,4300,6.17,173208,12555881700
005940,NH투자증권,8790,8620,-170,-1.93,1078409,9290032350
005945,NH투자증권우,7050,7000,-50,-0.71,63426,443104080
338100,NH프라임리츠,4715,4725,10,0.21,28733,135280610
034310,NICE,18900,18650,-250,-1.32,36595,684175950
008260,NI스틸,1710,1735,25,1.46,130616,220588330
004250,NPC,3205,3270,65,2.03,57032,183363210
004255,NPC우,2195,2235,40,1.82,3368,7448780
010060,OCI,38700,38550,-150,-0.39,147161,5633128250
005490,POSCO,183000,176000,-7000,-3.83,653004,115236166000
100840,STC,14800,14700,-100,-0.68,31034,447698450
064960,ST모티브,33700,32400,-1300,-3.86,87027,2841355100
003570,ST중공업,5390,5390,0,0.0,4727,25287870
036530,ST홀딩스,13250,13200,-50,-0.38,6023,79349900
010950,S-Oil,67400,66100,-1300,-1.93,686072,45154654200
010955,S-Oil우,38300,38150,-150,-0.39,12038,454802950
034120,SBS,18400,19050,650,3.53,151865,2856045400
101060,SBS미디어홀딩스,1825,1850,25,1.37,57511,104955680
004060,SG세계물산,685,670,-15,-2.19,1514823,1010067627
001380,SG충방,1125,1135,10,0.89,131650,147137620
002360,SH에너지화학,884,884,0,0.0,1894964,1660073393
009160,SIMPAC,2390,2390,0,0.0,26288,62128990
123700,SJM,2410,2410,0,0.0,9017,21353725
025530,SJM홀딩스,2530,2520,-10,-0.4,7322,18142805
034730,SK,177500,180500,3000,1.69,222040,39382220000
011790,SKC,43750,46550,2800,6.4,530645,24350194000
018670,SK가스,74200,73500,-700,-0.94,13086,958591400
001740,SK네트웍스,4915,4900,-15,-0.31,875368,4259226805
001745,SK네트웍스우,72000,72500,500,0.69,361,26046800
006120,SK디스커버리,26250,26000,-250,-0.95,261015,6694733400
006125,SK디스커버리우,16200,16450,250,1.54,19995,323546850
210980,SK디앤디,27550,24600,-2950,-10.71,208141,5157336350
068400,SK렌터카,7830,7890,60,0.77,60518,473524860
03473K,SK우,137000,137000,0,0.0,10024,1366001000
096770,SK이노베이션,97200,96700,-500,-0.51,733830,70825168200
096775,SK이노베이션우,70700,69900,-800,-1.13,15565,1085671400
001510,SK증권,590,593,3,0.51,2541495,1489898946
001515,SK증권우,2405,2390,-15,-0.62,12149,28968375
285130,SK케미칼,82400,80200,-2200,-2.67,320686,25751596300
28513K,SK케미칼우,29550,28400,-1150,-3.89,61166,1740375750
017670,SK텔레콤,196000,196500,500,0.26,400946,77473818000
000660,SK하이닉스,82300,81300,-1000,-1.22,4470072,363739453100
005610,SPC삼립,73000,72700,-300,-0.41,15551,1113015100
011810,STX,5850,5800,-50,-0.85,34748,200899350
077970,STX엔진,5130,5130,0,0.0,12495,64273910
071970,STX중공업,2120,2140,20,0.94,49272,104057195
084870,TBH글로벌,1550,1490,-60,-3.87,108548,161424525
002710,TCC스틸,1645,1650,5,0.3,22459,36996870
024070,WISCOM,2030,2020,-10,-0.49,72133,145200750
037270,YGPLUS,1400,1540,140,10.0,7456255,11560367290
000500,가온전선,14550,14400,-150,-1.03,1133,16212250
000860,강남제비스코,15800,15700,-100,-0.63,6417,100182700
035250,강원랜드,23700,24700,1000,4.22,1636066,39473896400
011420,갤럭시아에스엠,1265,1240,-25,-1.98,126697,154373110
002100,경농,11950,13000,1050,8.79,2217974,28386672250
009450,경동나비엔,32800,33650,850,2.59,59736,1977418700
267290,경동도시가스,16550,16550,0,0.0,9843,161708750
012320,경동인베스트,24950,25850,900,3.61,6316,160294800
000050,경방,9790,9520,-270,-2.76,99918,950995360
214390,경보제약,7690,7590,-100,-1.3,24445,184328610
012610,경인양행,6420,6480,60,0.93,371324,2385376180
009140,경인전자,17200,17300,100,0.58,1546,26701500
013580,계룡건설,15200,15200,0,0.0,33762,505016650
012200,계양전기,2395,2515,120,5.01,615137,1530800210
012205,계양전기우,6120,6500,380,6.21,114637,748194420
004200,고려개발,7760,7870,110,1.42,19570,156386310
002140,고려산업,2800,2600,-200,-7.14,1122493,2981818970
010130,고려아연,390000,412000,22000,5.64,78432,31236215500
002240,고려제강,15450,15250,-200,-1.29,23658,357296250
009290,광동제약,6020,6030,10,0.17,243407,1461678190
017040,광명전기,1920,2050,130,6.77,1961205,3882027865
017900,광전자,1710,1715,5,0.29,104227,176109845
037710,광주신세계,141000,142500,1500,1.06,328,46508500
030610,교보증권,6410,6430,20,0.31,108435,688988230
007690,국도화학,40950,42850,1900,4.64,14999,628619050
005320,국동,1730,1670,-60,-3.47,1686860,2788238050
001140,국보,1580,1580,0,0.0,274246,419731245
002720,국제약품,7470,7090,-380,-5.09,1877828,13354845820
083420,그린케미칼,3165,3175,10,0.32,15153,47982795
014530,극동유화,3055,3050,-5,-0.16,393492,1188994490
014280,금강공업,2855,2875,20,0.7,61503,174096325
014285,금강공업우,7800,8100,300,3.85,20090,159243650
008870,금비,48400,48650,250,0.52,521,25217400
001570,금양,2165,2150,-15,-0.69,351129,727749905
002990,금호산업,7440,7450,10,0.13,107948,806033240
002995,금호산업우,26050,27000,950,3.65,3097,82265550
011780,금호석유,67400,66000,-1400,-2.08,153745,10178114900
011785,금호석유우,25450,25000,-450,-1.77,7927,198264250
214330,금호에이치티,3355,3350,-5,-0.15,30709,100994265
001210,금호전기,3370,3470,100,2.97,164038,566003565
073240,금호타이어,3160,3180,20,0.63,578086,1800794470
092440,기신정기,2975,2970,-5,-0.17,28142,83117035
000270,기아차,29850,29000,-850,-2.85,2289317,66594961750
024110,기업은행,7900,7720,-180,-2.28,2611738,20190589470
013700,까뮤이앤씨,1140,1130,-10,-0.88,983055,1070838415
004540,깨끗한나라,3695,3605,-90,-2.44,924589,3296816890
004545,깨끗한나라우,18700,18900,200,1.07,4419,82480850
074610,나노메딕스,5080,5180,100,1.97,1076772,5475515140
001260,남광토건,9360,9840,480,5.13,145515,1405681170
008350,남선알미늄,4995,4475,-520,-10.41,56745267,276972646090
008355,남선알미우,33000,31450,-1550,-4.7,78769,2589781800
004270,남성,2070,2115,45,2.17,564419,1173308075
003920,남양유업,327500,328500,1000,0.31,1143,369116000
003925,남양유업우,103000,102500,-500,-0.49,194,19709000
002070,남영비비안,1010,1090,80,7.92,4337620,4534677233
025860,남해화학,7540,7950,410,5.44,756395,5877366150
005720,넥센,4620,4590,-30,-0.65,48635,218925960
005725,넥센우,2660,2700,40,1.5,46,124955
002350,넥센타이어,5930,5980,50,0.84,471943,2812014360
002355,넥센타이어1우B,2230,2265,35,1.57,12548,27990690
003580,넥스트사이언스,7050,7220,170,2.41,950925,6752662720
251270,넷마블,95200,96200,1000,1.05,385133,36750125200
090350,노루페인트,6610,6830,220,3.33,92616,621722700
090355,노루페인트우,10650,10650,0,0.0,8482,89321950
000320,노루홀딩스,8850,9050,200,2.26,15109,133770680
000325,노루홀딩스우,17750,17900,150,0.85,1714,30221350
006280,녹십자,154000,153000,-1000,-0.65,100500,15404920500
005250,녹십자홀딩스,21900,21250,-650,-2.97,135813,2888242100
005257,녹십자홀딩스2우,16500,16450,-50,-0.3,2533,41564100
004370,농심,290500,291500,1000,0.34,31427,9082191000
072710,농심홀딩스,74300,73600,-700,-0.94,1753,128710100
058730,다스코,5080,5260,180,3.54,143496,745071090
023590,다우기술,15450,15450,0,0.0,102823,1583776050
019680,대교,4825,4795,-30,-0.62,340731,1638160920
019685,대교우B,2600,2560,-40,-1.54,242285,618470370
006370,대구백화점,5200,5120,-80,-1.54,10253,51545355
008060,대덕전자,7960,8000,40,0.5,368983,2912792520
00806K,대덕전자1우,5770,5770,0,0.0,21475,123243780
000490,대동공업,4265,4415,150,3.52,202714,876194760
008110,대동전자,3655,3690,35,0.96,10161,37311810
005750,대림BCo,3380,3400,20,0.59,32564,108787405
000210,대림산업,76700,75100,-1600,-2.09,328360,24668318800
000215,대림산업우,31350,31050,-300,-0.96,5477,169100300
004440,대림씨엔에스,5760,6070,310,5.38,57346,340153150
006570,대림통상,3870,4070,200,5.17,9987,40407615
001680,대상,19550,19550,0,0.0,229681,4420735350
001685,대상우,11850,11850,0,0.0,2160,25377100
084690,대상홀딩스,6330,6270,-60,-0.95,252303,1560271490
084695,대상홀딩스우,5260,5250,-10,-0.19,10355,53233810
128820,대성산업,3145,3175,30,0.95,80596,252410160
117580,대성에너지,4545,4555,10,0.22,27548,124765080
016710,대성홀딩스,9960,9690,-270,-2.71,84420,816180490
003540,대신증권,9300,9120,-180,-1.94,239037,2175031630
003547,대신증권2우B,7690,7690,0,0.0,23425,178012390
003545,대신증권우,8030,7990,-40,-0.5,85183,679407610
009190,대양금속,2395,2435,40,1.67,934163,2279457670
014160,대영포장,1120,1190,70,6.25,50801866,62349137010
047040,대우건설,3315,3295,-20,-0.6,1957133,6400595015
009320,대우부품,2025,2060,35,1.73,1530816,3130763500
042660,대우조선해양,16850,16550,-300,-1.78,282003,4689477800
003090,대웅,12200,13600,1400,11.48,1203831,15801174800
069620,대웅제약,106000,108500,2500,2.36,384546,42219619000
000430,대원강업,2910,2945,35,1.2,19930,57664380
006340,대원전선,911,964,53,5.82,1484120,1399841076
006345,대원전선우,2590,2660,70,2.7,115994,299564475
003220,대원제약,15000,15250,250,1.67,115525,1756637150
024890,대원화성,1130,1135,5,0.44,77706,86931930
002880,대유에이텍,722,726,4,0.55,204260,145695610
000300,대유플러스,633,638,5,0.79,162527,102763226
012800,대창,1045,1055,10,0.96,855122,892000760
015230,대창단조,20850,20850,0,0.0,5444,112242650
001070,대한방직,19400,19500,100,0.52,2007,38819900
006650,대한유화,105500,110000,4500,4.27,94558,10105334000
001440,대한전선,664,661,-3,-0.45,2328663,1517808828
084010,대한제강,5870,5900,30,0.51,28201,164750710
001790,대한제당,16900,17000,100,0.59,12078,201852900
001795,대한제당우,11550,11400,-150,-1.3,384,4382150
001130,대한제분,127000,125500,-1500,-1.18,4688,583876500
003490,대한항공,19600,19600,0,0.0,1268180,24766275950
003495,대한항공우,16700,16750,50,0.3,35638,597708750
005880,대한해운,19250,18650,-600,-3.12,165514,3031328650
003830,대한화섬,74100,79300,5200,7.02,1683,127623800
016090,대현,1730,1725,-5,-0.29,63754,109924060
069460,대호에이엘,2110,2355,245,11.61,3939108,9056733755
192080,더블유게임즈,50800,52500,1700,3.35,330542,17063126750
012510,더존비즈온,78300,90000,11700,14.94,660682,56975618600
004830,덕성,2865,2725,-140,-4.89,564069,1523212535
004835,덕성우,8000,6810,-1190,-14.88,426519,2972035750
024900,덕양산업,885,880,-5,-0.56,100893,87478905
145720,덴티움,35750,36700,950,2.66,116488,4233450050
002150,도화엔지니어링,7700,8760,1060,13.77,1053796,8846330750
001230,동국제강,3965,3980,15,0.38,347830,1360001020
023450,동남합성,27100,27350,250,0.92,7355,200219700
004140,동방,2030,2325,295,14.53,25360418,55718539360
007590,동방아그로,5790,5820,30,0.52,10861,63022430
005960,동부건설,7650,7680,30,0.39,42896,325786220
005965,동부건설우,19650,19300,-350,-1.78,1977,38554150
083370,동북아12호,4975,4975,0,0.0,0,0
083380,동북아13호,5030,5030,0,0.0,6510,32745300
026960,동서,16300,16500,200,1.23,100963,1636439700
002210,동성제약,11250,11050,-200,-1.78,161671,1786791850
102260,동성코퍼레이션,3485,3490,5,0.14,75438,260888805
005190,동성화학,15550,15450,-100,-0.64,20853,323583000
000640,동아쏘시오홀딩스,88300,88900,600,0.68,17980,1580693400
170900,동아에스티,84700,84900,200,0.24,25756,2174236300
028100,동아지질,14700,15600,900,6.12,666811,10168257900
282690,동아타이어,10700,10750,50,0.47,354,3762650
001520,동양,1230,1210,-20,-1.63,1200809,1443079865
001527,동양2우B,8350,8300,-50,-0.6,1950,16169650
001529,동양3우B,27800,27000,-800,-2.88,865,23427650
084670,동양고속,26850,26700,-150,-0.56,3278,87244850
002900,동양물산,972,993,21,2.16,1992484,1949233576
082640,동양생명,2930,2830,-100,-3.41,196813,553951515
001525,동양우,4935,4900,-35,-0.71,1582,7675055
008970,동양철관,924,1000,76,8.23,3949263,3856210143
092780,동양피스톤,3580,3590,10,0.28,37354,132422555
049770,동원FB,176000,175500,-500,-0.28,6722,1174456000
018500,동원금속,573,557,-16,-2.79,504859,278515856
006040,동원산업,195000,191500,-3500,-1.79,1878,360257500
030720,동원수산,8400,8540,140,1.67,152268,1277194360
014820,동원시스템즈,22100,21900,-200,-0.9,18832,406558850
014825,동원시스템즈우,23400,23500,100,0.43,45,1057500
163560,동일고무벨트,4430,4490,60,1.35,7799,34504620
004890,동일산업,49350,49700,350,0.71,765,37897900
002690,동일제강,1685,1835,150,8.9,189564,337100395
000020,동화약품,7500,7630,130,1.73,119442,892130700
000150,두산,39150,37500,-1650,-4.21,171479,6424811100
000157,두산2우B,33950,33050,-900,-2.65,1345,44418600
241560,두산밥캣,22250,21600,-650,-2.92,1066343,23374181000
336370,두산솔루스,32050,32050,0,0.0,10441109,361165231650
33637K,두산솔루스1우,14550,14200,-350,-2.41,1866463,28426427350
33637L,두산솔루스2우B,24700,28950,4250,17.21,883917,26077379250
000155,두산우,33900,32450,-1450,-4.28,35547,1143529150
042670,두산인프라코어,4560,4345,-215,-4.71,4476501,19659623685
034020,두산중공업,4080,3735,-345,-8.46,4869416,18113539145
336260,두산퓨얼셀,8130,7910,-220,-2.71,7941726,65423159370
33626K,두산퓨얼셀1우,3495,3550,55,1.57,573077,2068323120
33626L,두산퓨얼셀2우B,8750,9250,500,5.71,513614,4911316230
016740,두올,2640,2640,0,0.0,304744,803116300
192650,드림텍,5100,5110,10,0.2,225139,1144105330
024090,디씨엠,10350,10400,50,0.48,29122,297763800
003160,디아이,2920,2925,5,0.17,260225,763290965
092200,디아이씨,1320,1325,5,0.38,62433,81851120
013570,디와이,3785,3780,-5,-0.13,94143,356004250
210540,디와이파워,7250,7290,40,0.55,54684,391283010
007340,디티알오토모티브,24100,23650,-450,-1.87,13169,311065300
026890,디피씨,7850,8380,530,6.75,8840716,72139343530
115390,락앤락,11350,11400,50,0.44,307592,3547459700
032350,롯데관광개발,10900,10750,-150,-1.38,236355,2535604200
330590,롯데리츠,4995,5000,5,0.1,373052,1876040350
000400,롯데손해보험,1455,1460,5,0.34,343996,499647885
023530,롯데쇼핑,85900,84400,-1500,-1.75,132094,11156023600
004000,롯데정밀화학,33300,32900,-400,-1.2,87752,2854120900
286940,롯데정보통신,31150,31500,350,1.12,33432,1049085200
280360,롯데제과,125500,121500,-4000,-3.19,4183,508515500
004990,롯데지주,26800,26550,-250,-0.93,208764,5531043950
00499K,롯데지주우,45750,45400,-350,-0.77,3705,167551800
005300,롯데칠성,99000,98900,-100,-0.1,39155,3814906700
005305,롯데칠성우,49500,49900,400,0.81,2795,136703100
011170,롯데케미칼,192500,191500,-1000,-0.52,171169,32892125000
002270,롯데푸드,364000,356000,-8000,-2.2,2947,1040330500
071840,롯데하이마트,21850,21850,0,0.0,123311,2639694200
027740,마니커,819,825,6,0.73,3573001,2920579940
204320,만도,24550,24300,-250,-1.02,395888,9501035400
001080,만호제강,12600,12350,-250,-1.98,4053,49768200
088980,맥쿼리인프라,11200,11100,-100,-0.89,479069,5335231950
094800,맵스리얼티1,4100,4085,-15,-0.37,58070,236885845
138040,메리츠금융지주,9990,9830,-160,-1.6,29433,290253970
008560,메리츠종금증권,2925,2860,-65,-2.22,2786181,7985495450
000060,메리츠화재,13850,13700,-150,-1.08,118756,1639440650
090370,메타랩스,939,961,22,2.34,223459,209063580
017180,명문제약,5600,5610,10,0.18,7852858,45906306020
012690,모나리자,7240,7170,-70,-0.97,3769259,27354744200
005360,모나미,2895,3025,130,4.49,3150136,9515675080
204210,모두투어리츠,2705,2700,-5,-0.18,2761,7465645
009680,모토닉,7040,7060,20,0.28,10751,75139450
009580,무림PP,3215,3210,-5,-0.16,201656,639563080
009200,무림페이퍼,2025,2050,25,1.23,153681,310139465
033920,무학,5810,5890,80,1.38,84845,490340720
008420,문배철강,2020,2110,90,4.46,158485,328272210
025560,미래산업,109,110,1,0.92,12926400,1408176164
007120,미래아이앤지,391,394,3,0.77,907679,351323703
006800,미래에셋대우,5190,5060,-130,-2.5,3603016,18267030350
00680K,미래에셋대우2우B,2860,2855,-5,-0.17,332199,939040205
006805,미래에셋대우우,3230,3210,-20,-0.62,11535,36967010
085620,미래에셋생명,3850,3575,-275,-7.14,295025,1073060870
002840,미원상사,60500,60100,-400,-0.66,3344,200678900
268280,미원에스씨,75600,76600,1000,1.32,17607,1343900200
107590,미원홀딩스,41000,41200,200,0.49,2974,122241700
134380,미원화학,43100,43150,50,0.12,1366,58631100
003650,미창석유,53800,53800,0,0.0,4280,230033700
155900,바다로19호,2580,2560,-20,-0.78,2712,6974015
003610,방림,1700,1710,10,0.59,15259,25592220
001340,백광산업,2670,2695,25,0.94,1198428,3213168510
014580,백광소재,3570,3630,60,1.68,1092801,3878041900
035150,백산,5000,4890,-110,-2.2,492574,2387204690
002410,범양건영,2840,2770,-70,-2.46,1100956,3057181330
096300,베트남개발1,299,295,-4,-1.34,103202,30496021
007210,벽산,1390,1410,20,1.44,374468,514066095
002760,보락,1770,1770,0,0.0,630887,1103907605
003850,보령제약,12900,12850,-50,-0.39,318394,4044748750
000890,보해양조,831,842,11,1.32,3556387,2979265572
003000,부광약품,27700,29700,2000,7.22,31799978,979228354900
001270,부국증권,17000,16700,-300,-1.76,3675,61360450
001275,부국증권우,15850,15700,-150,-0.95,993,15657000
026940,부국철강,3595,3595,0,0.0,880090,3179285030
015350,부산가스,31750,31850,100,0.31,1777,56368250
011390,부산산업,121500,152000,30500,25.1,599079,84676055000
005030,부산주공,347,354,7,2.02,109318,37980459
100220,비상교육,7210,7250,40,0.55,101227,729234120
101140,비티원,3150,3565,415,13.17,1923604,6501509345
005180,빙그레,53400,53200,-200,-0.37,52003,2749245200
003960,사조대림,13450,13500,50,0.37,16219,215376350
008040,사조동아원,918,951,33,3.59,1966477,1825816945
007160,사조산업,27400,27550,150,0.55,15767,429254900
014710,사조씨푸드,3915,3940,25,0.64,140599,548109180
006090,사조오양,7560,7580,20,0.26,90186,675267810
005090,삼광글라스,26450,26550,100,0.38,5614,148189400
001470,삼부토건,640,651,11,1.72,1298273,839402776
006400,삼성SDI,251500,271000,19500,7.75,1230799,325076774500
006405,삼성SDI우,139000,151500,12500,8.99,46035,6774074000
006660,삼성공조,6120,6100,-20,-0.33,4088,24737740
028260,삼성물산,94000,94000,0,0.0,538849,50276734900
02826K,삼성물산우B,71700,71600,-100,-0.14,8965,636655300
207940,삼성바이오로직스,542000,540000,-2000,-0.37,297720,162001005000
032830,삼성생명,49350,47450,-1900,-3.85,908997,43264539050
018260,삼성에스디에스,157000,158000,1000,0.64,235171,37139155500
028050,삼성엔지니어링,11400,11000,-400,-3.51,2727513,29963125500
009150,삼성전기,101500,105000,3500,3.45,1030649,106725128000
009155,삼성전기우,46900,48750,1850,3.94,35020,1671420200
005930,삼성전자,49000,49000,0,0.0,23349760,1143759563262
005935,삼성전자우,42100,42300,200,0.48,2341232,99050670403
001360,삼성제약,4320,4345,25,0.58,2554676,11021997520
010140,삼성중공업,4400,4270,-130,-2.95,6757360,28943208280
010145,삼성중공우,48250,50600,2350,4.87,1096,53934450
016360,삼성증권,28300,27450,-850,-3.0,517748,14238342000
068290,삼성출판사,22300,22750,450,2.02,245801,5518566100
029780,삼성카드,29100,28750,-350,-1.2,193604,5536071350
000810,삼성화재,193000,191500,-1500,-0.78,135375,25817230500
000815,삼성화재우,134500,132000,-2500,-1.86,7475,985892500
006110,삼아알미늄,3525,3560,35,0.99,34414,120238275
145990,삼양사,35950,35850,-100,-0.28,16978,602985400
145995,삼양사우,24900,25000,100,0.4,2353,58785200
003230,삼양식품,98500,102500,4000,4.06,67702,6831010200
002170,삼양통상,49800,49900,100,0.2,1591,78930150
272550,삼양패키징,15500,15500,0,0.0,12333,190175450
000070,삼양홀딩스,48300,48850,550,1.14,12472,599335050
000075,삼양홀딩스우,33950,34100,150,0.44,233,7859850
002810,삼영무역,12650,13100,450,3.56,73698,936911400
005680,삼영전자,7150,7080,-70,-0.98,37972,267836120
003720,삼영화학,1015,1000,-15,-1.48,107627,108064908
023000,삼원강재,2050,2020,-30,-1.46,10838,21843765
004380,삼익THK,10150,10000,-150,-1.48,19742,198214320
002450,삼익악기,1455,1465,10,0.69,252964,367930115
000520,삼일제약,17450,17400,-50,-0.29,29048,499604000
009770,삼정펄프,23150,22750,-400,-1.73,2463,56229850
005500,삼진제약,23900,23950,50,0.21,59802,1420951650
004690,삼천리,72300,71200,-1100,-1.52,2280,161462900
001880,삼호,19250,19450,200,1.04,12749,246595500
010960,삼호개발,4135,4270,135,3.26,341483,1426763540
004450,삼화왕관,39350,39450,100,0.25,204,8026300
009470,삼화전기,12950,13450,500,3.86,62557,834466750
011230,삼화전자,2300,2410,110,4.78,71476,171150695
001820,삼화콘덴서,46050,47600,1550,3.37,244807,11530519100
000390,삼화페인트,4930,5040,110,2.23,17758,88781000
001290,상상인증권,1130,1145,15,1.33,101307,115771250
041650,상신브레이크,2650,2630,-20,-0.75,21469,55957715
075180,새론오토모티브,3515,3410,-105,-2.99,12216,41581795
007540,샘표,33450,33350,-100,-0.3,8464,278315400
248170,샘표식품,27900,28200,300,1.08,19246,543482350
007860,서연,3750,3200,-550,-14.67,1045464,3472966120
200880,서연이화,3270,3200,-70,-2.14,145191,459037835
017390,서울가스,72000,70500,-1500,-2.08,123,8751100
004410,서울식품,174,176,2,1.15,13400922,2319422900
004415,서울식품우,3185,3160,-25,-0.78,76408,239690145
021050,서원,2615,2425,-190,-7.27,6461044,16087513480
008490,서흥,39900,40850,950,2.38,80277,3254743250
007610,선도전기,2450,2730,280,11.43,641471,1677548615
136490,선진,7290,7250,-40,-0.55,23196,167224550
002820,선창산업,3060,3095,35,1.14,10795,32790710
014910,성문전자,1555,1535,-20,-1.29,500294,732304245
014915,성문전자우,10000,9670,-330,-3.3,50614,462502540
003080,성보화학,3925,3965,40,1.02,20207,78739895
004980,성신양회,6240,6850,610,9.78,849563,5632474720
004985,성신양회우,7470,8100,630,8.43,50124,394535980
011300,성안,414,416,2,0.48,207167,87002176
000180,성창기업지주,1365,1390,25,1.83,99609,135941355
002420,세기상사,49200,50100,900,1.83,148,7334850
004360,세방,8560,8550,-10,-0.12,9413,80283140
004365,세방우,5150,5140,-10,-0.19,501,2567440
004490,세방전지,28400,27600,-800,-2.82,51860,1429901900
001430,세아베스틸,9070,8930,-140,-1.54,103172,909929860
306200,세아제강,41050,39550,-1500,-3.65,10278,408022100
003030,세아제강지주,27900,27250,-650,-2.33,9963,269159050
019440,세아특수강,10500,10650,150,1.43,6602,69434150
058650,세아홀딩스,63600,63600,0,0.0,462,28984400
013000,세우글로벌,1860,1945,85,4.57,23620549,49560100990
091090,세원셀론텍,2550,2590,40,1.57,587907,1498355815
021820,세원정공,8090,8090,0,0.0,0,0
067830,세이브존IC,2255,2230,-25,-1.11,57885,128324655
033530,세종공업,3885,3900,15,0.39,75524,293334300
075580,세진중공업,3005,2930,-75,-2.5,62183,181914215
027970,세하,1935,1960,25,1.29,22259,43144880
145210,세화아이엠씨,2990,2990,0,0.0,0,0
308170,센트랄모텍,29450,30500,1050,3.57,851031,25968449800
068270,셀트리온,216000,215000,-1000,-0.46,775217,166249759000
004430,송원산업,11100,11100,0,0.0,136398,1500306000
017550,수산중공업,1375,1455,80,5.82,3154975,4486406805
002200,수출포장,17550,17700,150,0.85,6048,105113600
053210,스카이라이프,7190,7250,60,0.83,78953,566981280
134790,시디즈,34150,33900,-250,-0.73,3432,116966700
016590,신대양제지,55300,56400,1100,1.99,24458,1337252200
029530,신도리코,26300,25250,-1050,-3.99,10449,265491150
004970,신라교역,9310,9320,10,0.11,11034,101972650
011930,신성이엔지,907,898,-9,-0.99,768428,693303291
005390,신성통상,1055,1075,20,1.9,4882758,5223986730
004170,신세계,233000,233500,500,0.21,61101,14251556500
035510,신세계IC,107000,111000,4000,3.74,8231,912481000
034300,신세계건설,24700,25950,1250,5.06,423270,11879647400
031430,신세계인터내셔날,197000,196000,-1000,-0.51,42687,8297653000
031440,신세계푸드,52500,52600,100,0.19,19815,1031569200
006880,신송홀딩스,3610,3540,-70,-1.94,31777,112727635
005800,신영와코루,79400,78200,-1200,-1.51,79,6151100
001720,신영증권,46200,46000,-200,-0.43,5970,274426050
001725,신영증권우,45850,45600,-250,-0.55,3083,140467750
009270,신원,1535,1715,180,11.73,12388110,20432218385
009275,신원우,33300,36300,3000,9.01,6821,241877750
002700,신일산업,1795,1825,30,1.67,2126761,3854244865
019170,신풍제약,19200,15800,-3400,-17.71,11720117,193369357700
019175,신풍제약우,30550,25050,-5500,-18.0,423779,11143483950
002870,신풍제지,1210,1220,10,0.83,155856,186978640
005450,신한,4945,4945,0,0.0,0,0
293940,신한알파리츠,6590,6590,0,0.0,42448,278450540
055550,신한지주,29050,28050,-1000,-3.44,2608005,73180098423
001770,신화실업,20900,20550,-350,-1.67,1506,30828400
004080,신흥,9400,9470,70,0.74,4022,37900620
102280,쌍방울,968,973,5,0.52,2955081,2866213612
003410,쌍용양회,4810,5080,270,5.61,2018492,9987824945
003415,쌍용양회우,9200,9380,180,1.96,10548,97466360
003620,쌍용차,1400,1400,0,0.0,1376573,1896316845
004770,써니전자,3395,3080,-315,-9.28,4609086,13967023355
015540,쎌마테라퓨틱스,6250,6600,350,5.6,538325,3470695490
004920,씨아이테크,812,820,8,0.99,110415,90237810
112610,씨에스윈드,28600,29100,500,1.75,25044,724571850
008700,아남전자,1535,1600,65,4.23,642138,999884230
002790,아모레G,60700,60300,-400,-0.66,163962,9899633500
00279K,아모레G3우전환,38500,38300,-200,-0.52,3229,123079350
002795,아모레G우,20600,20250,-350,-1.7,16718,340908150
090430,아모레퍼시픽,172000,172500,500,0.29,198097,33947674500
090435,아모레퍼시픽우,61700,61100,-600,-0.97,25797,1594583500
002030,아세아,80800,84000,3200,3.96,3967,323091300
183190,아세아시멘트,60600,63200,2600,4.29,11642,719411500
002310,아세아제지,30000,29450,-550,-1.83,66678,1949041100
267850,아시아나IDT,14000,14200,200,1.43,117667,1660391450
020560,아시아나항공,3810,3790,-20,-0.52,2225960,8397551660
122900,아이마켓코리아,9640,9690,50,0.52,40690,392620190
010780,아이에스동서,24100,23900,-200,-0.83,87549,2061180200
033660,아주캐피탈,12150,12100,-50,-0.41,24445,294722500
001780,알루코,1735,1800,65,3.75,279773,490777585
018250,애경산업,26000,26350,350,1.35,103949,2702516700
161000,애경유화,6600,6890,290,4.39,752169,5195137460
011090,에넥스,838,856,18,2.15,272046,229266877
005850,에스엘,13700,13600,-100,-0.73,79675,1056939600
012750,에스원,82500,83400,900,1.09,95787,7947138800
023960,에쓰씨엔지니어링,1185,1195,10,0.84,48867,58736035
298690,에어부산,3600,3565,-35,-0.97,394571,1387552580
140910,에이리츠,5410,5420,10,0.18,3919,21262520
078520,에이블씨엔씨,9800,10050,250,2.55,100238,999802510
015260,에이엔피,240,244,4,1.67,251998,60227961
007460,에이프로젠KIC,2340,2360,20,0.85,3834951,8937200655
003060,에이프로젠제약,1610,1605,-5,-0.31,5161893,8292589090
036570,엔씨소프트,656000,655000,-1000,-0.15,112493,73485519955
138250,엔에스쇼핑,7400,7540,140,1.89,184698,1373318213
085310,엔케이,844,843,-1,-0.12,422143,355297218
009810,엔케이물산,725,702,-23,-3.17,1380476,971153905
900140,엘브이엠씨홀딩스,4905,4870,-35,-0.71,233489,1138525825
014440,영보화학,2485,2440,-45,-1.81,68985,170622005
111770,영원무역,24300,23100,-1200,-4.94,328044,7556975200
009970,영원무역홀딩스,37250,35450,-1800,-4.83,5922,211385250
003520,영진약품,4930,4915,-15,-0.3,675275,3312212720
000670,영풍,504000,504000,0,0.0,1811,901916000
006740,영풍제지,3150,3135,-15,-0.48,48919,152257200
012280,영화금속,1425,1395,-30,-2.11,1973692,2830375590
012160,영흥,1000,973,-27,-2.7,1462163,1423764885
015360,예스코홀딩스,32550,32750,200,0.61,704,22741600
007310,오뚜기,532000,537000,5000,0.94,6489,3451191000
002630,오리엔트바이오,797,765,-32,-4.02,2945410,2262137254
271560,오리온,119500,119000,-500,-0.42,206127,24519503500
001800,오리온홀딩스,14250,14350,100,0.7,148077,2107269650
070960,용평리조트,4225,4945,720,17.04,2038295,9728657805
316140,우리금융지주,8160,8100,-60,-0.74,2905308,23335175580
004720,우리들제약,6600,6510,-90,-1.36,377592,2450390180
118000,우리들휴브레인,2510,2505,-5,-0.2,1264871,3105272175
010050,우리종금,519,519,0,0.0,1102179,569193435
006980,우성사료,2985,3110,125,4.19,3036250,9423720700
017370,우신시스템,3410,3465,55,1.61,68604,234595525
105840,우진,3595,3480,-115,-3.2,125202,430520475
010400,우진아이엔에스,6210,6310,100,1.61,31393,195193240
049800,우진플라임,2780,2730,-50,-1.8,31492,83290585
016880,웅진,1060,1050,-10,-0.94,546466,574696650
095720,웅진씽크빅,2530,2600,70,2.77,1092693,2821075080
103130,웅진에너지,914,914,0,0.0,0,0
005820,원림,15750,16250,500,3.17,1657,26429050
010600,웰바이오텍,2010,1985,-25,-1.24,346645,689051160
008600,윌비스,1240,1310,70,5.65,9906520,12833250700
033270,유나이티드제약,17700,17650,-50,-0.28,151918,2645032650
014830,유니드,39250,39250,0,0.0,24657,943961400
000910,유니온,2620,2785,165,6.3,323240,887621110
047400,유니온머티리얼,1660,1740,80,4.82,384008,647244485
011330,유니켐,1390,1400,10,0.72,216519,302357605
077500,유니퀘스트,5210,5540,330,6.33,150354,798921900
002920,유성기업,2450,2475,25,1.02,40689,97868505
000700,유수홀딩스,5840,5890,50,0.86,9547,55947710
003470,유안타증권,2365,2335,-30,-1.27,254406,591406420
003475,유안타증권우,1840,1770,-70,-3.8,29678,52566945
011690,유양디앤유,1220,1220,0,0.0,0,0
072130,유엔젤,3410,3400,-10,-0.29,209803,696465710
000220,유유제약,11700,11650,-50,-0.43,113643,1320626450
000225,유유제약1우,7900,7870,-30,-0.38,5050,39447080
000227,유유제약2우B,17700,17500,-200,-1.13,485,8527650
001200,유진투자증권,1895,1900,5,0.26,281354,526310620
000100,유한양행,47200,46200,-1000,-2.12,574409,26520591400
000105,유한양행우,47000,46000,-1000,-2.13,5924,270555300
003460,유화증권,2270,2275,5,0.22,56025,128220010
003465,유화증권우,2520,2570,50,1.98,16169,41799790
008730,율촌화학,13450,13550,100,0.74,48736,651658400
008250,이건산업,4985,5220,235,4.71,79401,405109960
025820,이구산업,1160,1175,15,1.29,165974,192029570
214320,이노션,55000,57500,2500,4.55,48041,2625117400
088260,이리츠코크렙,5000,4990,-10,-0.2,49528,246708300
139480,이마트,113500,114500,1000,0.88,254685,29421825500
007660,이수페타시스,3000,2990,-10,-0.33,350279,1046086560
005950,이수화학,9680,10250,570,5.89,6827288,72561352310
015020,이스타코,659,651,-8,-1.21,103496,66957991
093230,이아이디,206,210,4,1.94,5334469,1098938690
102460,이연제약,12400,12150,-250,-2.02,56669,685181750
084680,이월드,4455,4135,-320,-7.18,8454605,36167937100
000760,이화산업,11950,12650,700,5.86,2796,33457250
014990,인디에프,1820,2120,300,16.48,12197713,24805230370
006490,인스코비,2595,2665,70,2.7,756214,1986415745
023800,인지컨트롤스,3465,3710,245,7.07,200205,730025130
034590,인천도시가스,24250,23650,-600,-2.47,3528,83887300
129260,인터지스,1585,1595,10,0.63,30011,46824645
023810,인팩,3000,2985,-15,-0.5,10220,30385940
249420,일동제약,12900,12650,-250,-1.94,60137,763053050
000230,일동홀딩스,8200,8100,-100,-1.22,6678,53938490
013360,일성건설,913,1030,117,12.81,3190193,3155008588
003120,일성신약,98300,92500,-5800,-5.9,8661,829385100
003200,일신방직,54300,54300,0,0.0,1047,56721000
007110,일신석재,1965,2510,545,27.74,47571786,109072890905
007570,일양약품,35150,35700,550,1.56,1139875,41142013350
007575,일양약품우,20100,20000,-100,-0.5,5596,112742850
008500,일정실업,9650,9510,-140,-1.45,1356,12988310
081000,일진다이아,20800,22500,1700,8.17,320924,7000211850
020760,일진디스플,2825,2885,60,2.12,153806,436159890
020150,일진머티리얼즈,35600,38300,2700,7.58,1314387,49149423900
103590,일진전기,2100,2210,110,5.24,177921,382188510
015860,일진홀딩스,3590,3900,310,8.64,933776,3562673550
226320,잇츠한불,14550,14750,200,1.37,27888,408276500
317400,자이에스앤디,4180,4220,40,0.96,69304,290471185
033240,자화전자,6840,7300,460,6.73,178958,1260731930
000950,전방,11950,12000,50,0.42,747,8977700
194370,제이에스코퍼레이션,7180,7110,-70,-0.97,68469,482336230
025620,제이준코스메틱,3000,3035,35,1.17,330050,981938365
036420,제이콘텐트리,34500,35450,950,2.75,201291,7058506450
030000,제일기획,16700,16400,-300,-1.8,741761,12106532050
271980,제일약품,26150,25650,-500,-1.91,26515,689427700
001560,제일연마,5650,5650,0,0.0,5430,30454660
002620,제일파마홀딩스,15500,14200,-1300,-8.39,810079,12445917700
006220,제주은행,2915,2915,0,0.0,35422,101407960
089590,제주항공,18650,18850,200,1.07,192256,3590164350
004910,조광페인트,5150,5230,80,1.55,36877,192782850
004700,조광피혁,41550,40900,-650,-1.56,4049,164783900
001550,조비,17350,18000,650,3.75,721322,12917544400
000480,조선내화,72800,72800,0,0.0,1849,134159700
120030,조선선재,79100,79300,200,0.25,449,35259900
018470,조일알미늄,547,543,-4,-0.73,49957,27260905
002600,조흥,130500,129500,-1000,-0.77,93,12140500
185750,종근당,90800,92100,1300,1.43,48224,4386491700
063160,종근당바이오,31350,31250,-100,-0.32,70575,2205563000
001630,종근당홀딩스,116500,118500,2000,1.72,29029,3398566000
044380,주연테크,537,537,0,0.0,0,0
013890,지누스,62600,69500,6900,11.02,262669,17527605800
013870,지엠비코리아,4130,4150,20,0.48,82172,339056195
071320,지역난방공사,34000,34050,50,0.15,12063,407154400
010580,지코,306,306,0,0.0,0,0
035000,지투알,4950,4960,10,0.2,13776,67396715
088790,진도,2300,2270,-30,-1.3,23932,54245835
003780,진양산업,3345,3000,-345,-10.31,1260843,3665154905
010640,진양폴리,2850,2560,-290,-10.18,903309,2271796810
100250,진양홀딩스,2295,2255,-40,-1.74,79338,175680940
051630,진양화학,3695,2800,-895,-24.22,2825206,7997675175
272450,진에어,10400,10600,200,1.92,173112,1802198500
011000,진원생명과학,14000,14100,100,0.71,20594944,293327579800
002780,진흥기업,1995,2000,5,0.25,213303,421732480
002787,진흥기업2우B,14000,13800,-200,-1.43,7720,103227300
002785,진흥기업우B,5080,4930,-150,-2.95,25266,121780200
009310,참엔지니어링,1220,1255,35,2.87,83035,102257825
000650,천일고속,56200,55200,-1000,-1.78,558,31083700
012600,청호컴넷,2030,2170,140,6.9,215099,443419155
033250,체시스,2155,2155,0,0.0,446872,938934130
035720,카카오,159500,165500,6000,3.76,1005533,165508449500
006380,카프로,2845,3030,185,6.5,940623,2801775325
109070,컨버즈,4100,4100,0,0.0,0,0
001620,케이비아이동국실업,598,600,2,0.33,17898,10691481
029460,케이씨,13500,13600,100,0.74,25768,346015100
344820,케이씨씨글라스,25600,24450,-1150,-4.49,190558,4633982050
281820,케이씨텍,17100,17250,150,0.88,112080,1902704450
145270,케이탑리츠,810,792,-18,-2.22,476823,373088712
007815,코리아써우,2950,2955,5,0.17,3659,10654795
007810,코리아써키트,7320,7630,310,4.23,246586,1842618510
00781K,코리아써키트2우B,4440,4500,60,1.35,56,254175
152330,코리아오토글라스,13050,12950,-100,-0.77,22662,291647700
003690,코리안리,7500,7700,200,2.67,319550,2408306050
192820,코스맥스,82000,85200,3200,3.9,143279,12068082800
044820,코스맥스비티아이,14800,14800,0,0.0,23489,348130500
005070,코스모신소재,8460,8960,500,5.91,870889,7690846280
005420,코스모화학,7790,8220,430,5.52,1066760,8662449440
071950,코아스,1035,1090,55,5.31,1379111,1457749504
002020,코오롱,23500,25500,2000,8.51,5456254,145062941600
003070,코오롱글로벌,8260,7630,-630,-7.63,1085122,8577829960
003075,코오롱글로벌우,18150,17100,-1050,-5.79,82527,1425780900
144620,코오롱머티리얼,1730,1595,-135,-7.8,2769034,4568421385
002025,코오롱우,13500,12300,-1200,-8.89,432688,5846948450
120110,코오롱인더,31150,30300,-850,-2.73,707111,21441323800
120115,코오롱인더우,16600,15400,-1200,-7.23,234517,3730033700
138490,코오롱플라스틱,3620,3300,-320,-8.84,995440,3400284890
021240,코웨이,62000,60400,-1600,-2.58,363810,21984256575
031820,콤텍시스템,1265,1290,25,1.98,1723154,2223977450
192400,쿠쿠홀딩스,87500,88200,700,0.8,8193,709202200
284740,쿠쿠홈시스,35300,35300,0,0.0,51566,1806163600
015590,큐로,799,805,6,0.75,1492052,1199407068
264900,크라운제과,7470,7500,30,0.4,48829,359542990
26490K,크라운제과우,6140,6090,-50,-0.81,7557,46040950
005740,크라운해태홀딩스,8060,8380,320,3.97,79673,656486830
005745,크라운해태홀딩스우,10050,10350,300,2.99,15132,152516640
020120,키다리스튜디오,5330,5200,-130,-2.44,54629,284847230
039490,키움증권,73700,73200,-500,-0.68,57157,4162342900
012170,키위미디어그룹,150,150,0,0.0,0,0
015890,태경산업,4220,4290,70,1.66,63891,272331965
006890,태경화학,4850,4820,-30,-0.62,25528,123724205
003240,태광산업,760000,747000,-13000,-1.71,1619,1213434000
011280,태림포장,3635,3795,160,4.4,972714,3624994590
004100,태양금속,1035,1020,-15,-1.45,336968,340504459
004105,태양금속우,2630,2570,-60,-2.28,69933,178138595
009410,태영건설,13250,13550,300,2.26,349145,4727761700
009415,태영건설우,7090,7370,280,3.95,38099,278221900
001420,태원물산,3215,3185,-30,-0.93,26735,83456660
007980,태평양물산,1745,1730,-15,-0.86,438184,754672010
055490,테이팩스,14950,17850,2900,19.4,245959,4118654150
078000,텔코웨어,13900,14600,700,5.04,68689,990979600
214420,토니모리,11100,11150,50,0.45,240748,2669095700
019180,티에이치엔,2495,2470,-25,-1.0,299318,716764280
091810,티웨이항공,3455,3520,65,1.88,282926,978993745
004870,티웨이홀딩스,1105,1140,35,3.17,477897,529280895
030790,티탑스,5440,5950,510,9.38,268966,1559731190
005690,파미셀,17550,16650,-900,-5.13,4162207,68782813900
036580,팜스코,4035,4070,35,0.87,87768,351289705
028670,팬오션,3185,3130,-55,-1.73,1355065,4275097150
010820,퍼스텍,1660,1670,10,0.6,231121,377972825
016800,퍼시스,28300,27800,-500,-1.77,13638,380539150
001020,페이퍼코리아,1360,1280,-80,-5.88,441005,565925775
090080,평화산업,1080,1075,-5,-0.46,165759,176195570
010770,평화홀딩스,2900,2940,40,1.38,27790,80779275
058430,포스코강판,11500,11450,-50,-0.43,30533,343774250
047050,포스코인터내셔널,13250,12850,-400,-3.02,873240,11027780400
003670,포스코케미칼,46750,50700,3950,8.45,737256,36184533500
007630,폴루스바이오팜,1225,1225,0,0.0,0,0
017810,풀무원,10150,10550,400,3.94,158213,1614930840
103140,풍산,18250,18650,400,2.19,233676,4266902250
005810,풍산홀딩스,28000,27950,-50,-0.18,3131,85990650
033180,필룩스,5700,5730,30,0.53,3306395,18892631890
086790,하나금융지주,25000,24250,-750,-3.0,2790850,67183152350
099340,하나니켈1호,272,257,-15,-5.51,2343518,603037761
099350,하나니켈2호,1315,1265,-50,-3.8,180654,228747075
293480,하나제약,22400,22250,-150,-0.67,64868,1434516500
039130,하나투어,40300,39950,-350,-0.87,98660,3932842000
172580,하이골드12호,2335,2260,-75,-3.21,53477,121999370
153360,하이골드3호,1265,1250,-15,-1.19,13441,16565150
159650,하이골드8호,2015,1865,-150,-7.44,916068,1682706050
071090,하이스틸,15500,16500,1000,6.45,16517,266130450
019490,하이트론,2305,2360,55,2.39,16008,37767735
000080,하이트진로,29000,29200,200,0.69,231729,6724658700
000087,하이트진로2우B,14800,14900,100,0.68,1868,27439450
000140,하이트진로홀딩스,12200,12050,-150,-1.23,22496,268828400
000145,하이트진로홀딩스우,12350,12400,50,0.4,891,10944050
152550,한국ANKOR유전,1725,1730,5,0.29,10514,18029180
036460,한국가스공사,26950,26600,-350,-1.3,437257,11557852750
005430,한국공항,30900,30850,-50,-0.16,8509,258397400
071050,한국금융지주,46750,45450,-1300,-2.78,448814,20298125450
071055,한국금융지주우,30000,29750,-250,-0.83,24851,728923300
010040,한국내화,3205,3440,235,7.33,1963460,6766022180
025540,한국단자,29000,29200,200,0.69,34343,979266250
004090,한국석유,93200,95500,2300,2.47,10056,940217100
002960,한국쉘석유,259500,256000,-3500,-1.35,2330,594176000
123890,한국자산신탁,2295,2265,-30,-1.31,338628,763360085
015760,한국전력,21200,20250,-950,-4.48,4168986,85171982900
006200,한국전자홀딩스,516,517,1,0.19,72703,37082252
002300,한국제지,13400,13350,-50,-0.37,14518,192411850
009540,한국조선해양,82400,80000,-2400,-2.91,322393,25832182700
023350,한국종합기술,4020,4155,135,3.36,107942,442682765
025890,한국주강,1290,1290,0,0.0,21323,27277270
000970,한국주철관,8930,8920,-10,-0.11,32516,289732370
104700,한국철강,3690,3700,10,0.27,58674,215105085
017960,한국카본,5830,5910,80,1.37,471818,2738714590
161890,한국콜마,41300,42000,700,1.69,157503,6581548750
024720,한국콜마홀딩스,20800,21050,250,1.2,68020,1429463550
161390,한국타이어앤테크놀로지,21600,20650,-950,-4.4,733615,15099884457
000240,한국테크놀로지그룹,9960,9580,-380,-3.82,140376,1338986950
034830,한국토지신탁,1750,1720,-30,-1.71,479791,824775400
007280,한국특수형강,1305,1310,5,0.38,299962,402127920
168490,한국패러랠,1940,1935,-5,-0.26,804,1549340
010100,한국프랜지,1650,1600,-50,-3.03,5950135,10548254640
047810,한국항공우주,22550,22100,-450,-2.0,728349,15911184850
123690,한국화장품,15000,15200,200,1.33,1019934,15500566600
003350,한국화장품제조,35650,36150,500,1.4,183664,6635146050
011500,한농화성,4090,4195,105,2.57,72224,299099365
002390,한독,22600,22500,-100,-0.44,52888,1172889150
014790,한라,2430,2570,140,5.76,154529,389599030
060980,한라홀딩스,29750,29150,-600,-2.02,25902,751792450
053690,한미글로벌,7230,7370,140,1.94,92425,674342860
042700,한미반도체,7250,7340,90,1.24,223293,1615966760
008930,한미사이언스,27550,27700,150,0.54,96649,2625625550
128940,한미약품,260500,259000,-1500,-0.58,36353,9439391000
009240,한샘,61200,62100,900,1.47,60484,3740557900
020000,한섬,22450,21750,-700,-3.12,101968,2218865800
003680,한성기업,4205,4285,80,1.9,58482,249311420
105630,한세실업,10600,10600,0,0.0,210296,2185716350
069640,한세엠케이,2900,2920,20,0.69,5069,14568530
016450,한세예스24홀딩스,4825,4720,-105,-2.18,15557,73254185
010420,한솔PNS,1330,1380,50,3.76,125288,168543585
009180,한솔로지스틱스,1285,1350,65,5.06,476764,621780235
213500,한솔제지,12650,13350,700,5.53,246016,3185732700
014680,한솔케미칼,79900,81300,1400,1.75,65215,5185951500
004710,한솔테크닉스,5230,5390,160,3.06,382183,2027277960
004150,한솔홀딩스,2945,2950,5,0.17,64081,187354515
025750,한솔홈데코,850,865,15,1.76,517650,441196395
004960,한신공영,12300,12150,-150,-1.22,14642,176079500
011700,한신기계,1380,1390,10,0.72,258748,354578265
001750,한양증권,5860,5850,-10,-0.17,21141,121879280
001755,한양증권우,7060,7220,160,2.27,1415,10065990
018880,한온시스템,8830,9010,180,2.04,1301750,11525292500
009420,한올바이오파마,24900,25050,150,0.6,1451808,36932521300
014130,한익스프레스,4510,4625,115,2.55,305710,1397613015
300720,한일시멘트,76800,80400,3600,4.69,13739,1084888000
002220,한일철강,1485,1490,5,0.34,24273,35916125
006390,한일현대시멘트,25550,31350,5800,22.7,314567,9185869400
003300,한일홀딩스,38400,38650,250,0.65,3095,118604500
051600,한전KPS,32700,31200,-1500,-4.59,248249,7739610050
052690,한전기술,17750,16750,-1000,-5.63,262008,4373536100
130660,한전산업,3115,3065,-50,-1.61,75958,231932885
002320,한진,43200,44500,1300,3.01,306126,13460277350
097230,한진중공업,4400,4345,-55,-1.25,70482,304896320
003480,한진중공업홀딩스,3190,3095,-95,-2.98,37675,116752040
180640,한진칼,84300,85000,700,0.83,892682,76203773600
18064K,한진칼우,45100,44450,-650,-1.44,18087,805175300
005110,한창,2230,2635,405,18.16,31772826,80167034495
009460,한창제지,2345,2080,-265,-11.3,17665696,35377705910
000880,한화,18200,18000,-200,-1.1,254556,4564535900
00088K,한화3우B,10550,10500,-50,-0.47,62399,651775550
088350,한화생명,1735,1650,-85,-4.9,10398894,17354831020
000370,한화손해보험,2150,2045,-105,-4.88,418502,862287780
009830,한화솔루션,13950,13700,-250,-1.79,802025,11038067650
009835,한화솔루션우,8400,8310,-90,-1.07,4906,40615870
272210,한화시스템,7380,7550,170,2.3,442062,3303696890
012450,한화에어로스페이스,22950,22550,-400,-1.74,268872,5982477000
000885,한화우,20200,19750,-450,-2.23,20992,409796750
003530,한화투자증권,1565,1535,-30,-1.92,692252,1048108500
003535,한화투자증권우,1530,1525,-5,-0.33,17927,27140380
195870,해성디에스,14400,14550,150,1.04,178348,2579097500
101530,해태제과식품,6620,6680,60,0.91,29173,191821500
143210,핸즈코퍼레이션,5960,5870,-90,-1.51,6063,35584750
000720,현대건설,32250,32900,650,2.02,1419590,46398768950
267270,현대건설기계,17100,17000,-100,-0.58,140450,2347363800
000725,현대건설우,98800,118500,19700,19.94,4706,522303200
005440,현대그린푸드,7380,7270,-110,-1.49,395062,2851655320
086280,현대글로비스,102500,100500,-2000,-1.95,151827,15212861600
064350,현대로템,12500,14200,1700,13.6,5625847,76754507500
079430,현대리바트,9150,9240,90,0.98,149912,1360733150
012330,현대모비스,176500,174500,-2000,-1.13,402536,69796664500
010620,현대미포조선,30650,30050,-600,-1.96,187361,5572951400
069960,현대백화점,63700,63500,-200,-0.31,94510,5980228500
004560,현대비앤지스틸,6820,6820,0,0.0,32363,221143970
004565,현대비앤지스틸우,46900,50700,3800,8.1,1769,88594700
011760,현대상사,12500,13950,1450,11.6,261067,3497462850
004310,현대약품,4230,4245,15,0.35,235600,991890190
322000,현대에너지솔루션,19700,20250,550,2.79,98911,1971567500
126560,현대에이치씨엔,3925,4070,145,3.69,3212911,13341021185
017800,현대엘리베이,60600,64800,4200,6.93,1149875,72719057900
307950,현대오토에버,38000,38200,200,0.53,21878,822155000
011210,현대위아,34150,34850,700,2.05,187172,6384375800
267260,현대일렉트릭,6980,7220,240,3.44,378862,2658285930
004020,현대제철,19750,19100,-650,-3.29,1010086,19243326400
267250,현대중공업지주,231500,228500,-3000,-1.3,46027,10535769500
005380,현대차,100000,99100,-900,-0.9,1341452,133088067900
005387,현대차2우B,64300,62700,-1600,-2.49,76518,4832928500
005389,현대차3우B,59500,59000,-500,-0.84,8741,513832500
005385,현대차우,60200,59000,-1200,-1.99,120212,7105128400
001500,현대차증권,7430,7350,-80,-1.08,72134,526401600
227840,현대코퍼레이션홀딩스,8550,9100,550,6.43,78723,698663900
001450,현대해상,24000,24400,400,1.67,280315,6791976900
057050,현대홈쇼핑,61200,60700,-500,-0.82,38022,2284622000
093240,형지엘리트,1115,1125,10,0.9,208366,230457840
003010,혜인,4050,4315,265,6.54,605192,2538863540
111110,호전실업,11550,11500,-50,-0.43,4079,46383500
008770,호텔신라,73500,74100,600,0.82,516018,37952797800
008775,호텔신라우,48200,48400,200,0.41,2590,124781400
002460,화성산업,8410,8490,80,0.95,19934,167274020
013520,화승알앤에이,1590,1590,0,0.0,33917,53239855
241590,화승엔터프라이즈,11900,11300,-600,-5.04,744623,8406002750
006060,화승인더,7750,7460,-290,-3.74,1428828,10650999900
010690,화신,2155,2095,-60,-2.78,93819,196767410
133820,화인베스틸,1820,1810,-10,-0.55,422805,756676655
010660,화천기계,3065,2855,-210,-6.85,6124942,18193514400
000850,화천기공,30200,30000,-200,-0.66,7123,212474550
016580,환인제약,14150,14300,150,1.06,43686,621839950
032560,황금에스티,5230,5510,280,5.35,110658,596603140
004800,효성,66800,66700,-100,-0.15,45248,2994559100
094280,효성ITX,15900,16250,350,2.2,85409,1374140350
298040,효성중공업,16100,16200,100,0.62,62467,989677600
298050,효성첨단소재,69700,69600,-100,-0.14,20263,1393769200
298020,효성티앤씨,119000,118000,-1000,-0.84,8876,1046682000
298000,효성화학,93800,94000,200,0.21,31912,2999228000
093370,후성,6560,6650,90,1.37,995214,6575527790
081660,휠라홀딩스,32050,32000,-50,-0.16,737972,23414863400
005870,휴니드,5150,5160,10,0.19,31948,163233090
079980,휴비스,5100,5120,20,0.39,187637,948756795
005010,휴스틸,6690,6660,-30,-0.45,10205,67916740
069260,휴켐스,15900,15850,-50,-0.31,106237,1658547900
000540,흥국화재,2415,2365,-50,-2.07,87825,205718100
000547,흥국화재2우B,20000,19250,-750,-3.75,19850,383059300
000545,흥국화재우,4960,4815,-145,-2.92,31329,149279745
003280,흥아해운,258,258,0,0.0,0,0
