티커,종목명,시가,종가,변동폭,등락률,거래량,거래대금
095570,AJ네트웍스,3330,3240,-90,-2.7,202134,659547830
006840,AK홀딩스,17850,17950,100,0.56,34547,615156650
027410,BGF,4150,4125,-25,-0.6,128714,532304540
282330,BGF리테일,120500,120000,-500,-0.41,29857,3589014000
138930,BNK금융지주,5140,5140,0,0.0,1019320,5226373880
001460,BYC,233000,230000,-3000,-1.29,349,80165500
001465,BYC우,132000,131000,-1000,-0.76,414,53766500
001040,CJ,84900,85800,900,1.06,112070,9569133100
079160,CJCGV,22600,22700,100,0.44,286422,6491809400
00104K,CJ4우전환,59700,60000,300,0.5,12129,720729900
000120,CJ대한통운,179500,182000,2500,1.39,138109,24874172000
011150,CJ씨푸드,4870,4895,25,0.51,912379,4440417015
011155,CJ씨푸드1우,52500,50400,-2100,-4.0,7305,374090200
001045,CJ우,48400,48500,100,0.21,7454,359274050
097950,CJ제일제당,387000,387000,0,0.0,42724,16540773500
097955,CJ제일제당우,162000,164500,2500,1.54,6878,1118478500
000590,CS홀딩스,56200,56300,100,0.18,2262,127523500
012030,DB,704,700,-4,-0.57,283787,198689823
016610,DB금융투자,3855,3830,-25,-0.65,79974,307588825
005830,DB손해보험,45750,45700,-50,-0.11,181665,8293714300
000990,DB하이텍,36750,37050,300,0.82,510264,18851302050
000995,DB하이텍1우,187500,166000,-21500,-11.47,63941,10996328500
139130,DGB금융지주,5430,5430,0,0.0,764816,4155600760
001530,DI동일,87300,87800,500,0.57,7292,634576000
004840,DRB동일,7060,7020,-40,-0.57,70467,494881660
155660,DSR,5350,5450,100,1.87,111219,594087670
069730,DSR제강,4515,4595,80,1.77,116369,521633150
017940,E1,47350,46700,-650,-1.37,31036,1454158700
007700,FF,87500,87100,-400,-0.46,45787,3968471400
114090,GKL,12700,12700,0,0.0,186368,2363223800
078930,GS,33000,32800,-200,-0.61,269846,8871567400
006360,GS건설,25050,25100,50,0.2,374122,9393218000
001250,GS글로벌,1735,1735,0,0.0,122875,212288455
007070,GS리테일,33250,33000,-250,-0.75,223242,7390375400
078935,GS우,29250,29350,100,0.34,7968,233522050
012630,HDC,11200,11150,-50,-0.45,471946,5237728250
039570,HDC아이콘트롤스,9650,9590,-60,-0.62,114098,1088510610
089470,HDC현대EP,5890,5690,-200,-3.4,832247,4743784290
294870,HDC현대산업개발,22850,23150,300,1.31,625092,14390154200
011200,HMM,7300,7260,-40,-0.55,3408752,24823921370
082740,HSD엔진,5350,5370,20,0.37,427225,2259121180
003560,IHQ,1540,1530,-10,-0.65,514015,779391425
175330,JB금융지주,4630,4685,55,1.19,282701,1316622670
234080,JW생명과학,19800,20000,200,1.01,57851,1158616700
001060,JW중외제약,37950,40800,2850,7.51,642149,27043272450
001067,JW중외제약2우B,102500,113500,11000,10.73,21908,2476064000
001065,JW중외제약우,75000,80500,5500,7.33,18618,1530158800
096760,JW홀딩스,6420,6330,-90,-1.4,1141444,7379626370
105560,KB금융,37950,37750,-200,-0.53,1158360,43758975650
002380,KCC,158000,155500,-2500,-1.58,91351,14226457500
009070,KCTC,2395,2385,-10,-0.42,159403,378738220
009440,KC그린홀딩스,3960,4000,40,1.01,73019,289601520
119650,KC코트렐,6470,6660,190,2.94,397108,2625316460
092220,KEC,1410,1370,-40,-2.84,20286741,28868534230
016380,KG동부제철,13000,13400,400,3.08,47982,630775400
016385,KG동부제철우,145000,151500,6500,4.48,6679,1020265000
001390,KG케미칼,21750,21900,150,0.69,203625,4418380250
001940,KISCO홀딩스,12000,12100,100,0.83,60152,719514450
025000,KPX케미칼,47900,47300,-600,-1.25,4595,216997700
092230,KPX홀딩스,44850,44400,-450,-1.0,2418,107306650
000040,KR모터스,812,796,-16,-1.97,1239438,984390610
044450,KSS해운,8690,9250,560,6.44,291532,2656573840
030200,KT,23300,23400,100,0.43,860155,20107592900
033780,KTG,83900,83100,-800,-0.95,365764,30494684100
030210,KTB투자증권,2625,2605,-20,-0.76,141124,368115500
058850,KTcs,2025,2045,20,0.99,302404,616934355
058860,KTis,2435,2465,30,1.23,96129,234556590
093050,LF,13450,13500,50,0.37,69066,932229300
003550,LG,80800,78900,-1900,-2.35,440945,35128183791
034220,LG디스플레이,16100,16150,50,0.31,1413514,22754377650
001120,LG상사,16500,16700,200,1.21,365083,6148216700
051900,LG생활건강,1508000,1516000,8000,0.53,29963,45405074000
051905,LG생활건강우,724000,721000,-3000,-0.41,5523,3979608000
003555,LG우,52700,52600,-100,-0.19,15092,796189800
032640,LG유플러스,11850,11700,-150,-1.27,2365898,27751510000
011070,LG이노텍,162000,161500,-500,-0.31,287773,46493476000
066570,LG전자,90600,89900,-700,-0.77,931059,83472596700
066575,LG전자우,34400,33800,-600,-1.74,134949,4563986600
108670,LG하우시스,58400,59500,1100,1.88,70741,4202668100
108675,LG하우시스우,26850,27600,750,2.79,29233,810080400
037560,LG헬로비전,3955,4045,90,2.28,422059,1696495850
051910,LG화학,645000,666000,21000,3.26,1775061,1170551205812
051915,LG화학우,313500,316500,3000,0.96,220877,70422771500
079550,LIG넥스원,34250,34500,250,0.73,220736,7530873400
006260,LS,58300,59200,900,1.54,220151,12843202900
010120,LSELECTRIC,58800,59500,700,1.19,107095,6339003100
000680,LS네트웍스,2230,2205,-25,-1.12,87607,194118675
229640,LS전선아시아,7420,7560,140,1.89,241830,1799208930
023150,MH에탄올,8240,8230,-10,-0.12,61635,504526830
035420,NAVER,300500,298000,-2500,-0.83,750488,224009191452
181710,NHN,76400,78500,2100,2.75,75821,5804642800
005940,NH투자증권,9320,9320,0,0.0,614557,5728955620
005945,NH투자증권우,8010,8070,60,0.75,153893,1239143840
338100,NH프라임리츠,4210,4245,35,0.83,42119,178283060
034310,NICE,18650,18850,200,1.07,55098,1041066300
008260,NI스틸,2180,2225,45,2.06,213186,474842310
004250,NPC,3245,3250,5,0.15,43187,139074145
004255,NPC우,2205,2230,25,1.13,8574,18998235
010060,OCI,61900,62800,900,1.45,254850,15919592500
005490,POSCO,190000,192000,2000,1.05,522946,100602343980
100840,STC,15650,15650,0,0.0,7436,115893050
064960,ST모티브,53000,53200,200,0.38,41621,2182363100
003570,ST중공업,5250,5230,-20,-0.38,93857,491132700
036530,ST홀딩스,14950,15100,150,1.0,9999,149655150
010950,S-Oil,55000,54600,-400,-0.73,331249,18110725300
010955,S-Oil우,33150,32850,-300,-0.9,15423,506540450
034120,SBS,15100,15050,-50,-0.33,37622,567691450
101060,SBS미디어홀딩스,1900,1880,-20,-1.05,91348,171905820
004060,SG세계물산,600,603,3,0.5,666283,399883955
001380,SG충방,1960,1920,-40,-2.04,496638,955896785
002360,SH에너지화학,795,837,42,5.28,17229640,14603415932
009160,SIMPAC,2385,2400,15,0.63,15285,36494900
123700,SJM,2645,2600,-45,-1.7,53760,140627105
025530,SJM홀딩스,2595,2640,45,1.73,7111,18664820
034730,SK,211500,210500,-1000,-0.47,161318,33970515000
011790,SKC,86000,88700,2700,3.14,507791,45124416600
018670,SK가스,106000,103500,-2500,-2.36,27578,2907283500
001740,SK네트웍스,5000,5040,40,0.8,782336,3928645880
001745,SK네트웍스우,167500,170000,2500,1.49,3835,660999000
006120,SK디스커버리,73000,71700,-1300,-1.78,144271,10401602200
006125,SK디스커버리우,58600,58500,-100,-0.17,22639,1311562000
210980,SK디앤디,48000,46950,-1050,-2.19,148588,6965913750
068400,SK렌터카,9350,9120,-230,-2.46,804566,7519846240
326030,SK바이오팜,170500,171500,1000,0.59,139378,23726101500
03473K,SK우,208500,210500,2000,0.96,6991,1466345000
096770,SK이노베이션,156000,153000,-3000,-1.92,662530,102369220500
096775,SK이노베이션우,132000,130500,-1500,-1.14,25309,3326500000
001510,SK증권,738,733,-5,-0.68,4166631,3059820352
001515,SK증권우,5670,5870,200,3.53,2318591,14344149760
285130,SK케미칼,338000,337000,-1000,-0.3,210527,71216745500
28513K,SK케미칼우,175500,174000,-1500,-0.85,35295,6102708500
017670,SK텔레콤,244000,244000,0,0.0,220441,53544707000
000660,SK하이닉스,82200,83700,1500,1.82,5199334,432538562400
005610,SPC삼립,62300,62300,0,0.0,10667,667347300
011810,STX,5960,5930,-30,-0.5,35633,210919920
077970,STX엔진,6730,6640,-90,-1.34,26008,172442810
071970,STX중공업,4485,4410,-75,-1.67,660197,2889345885
084870,TBH글로벌,1780,1695,-85,-4.78,110570,190163470
002710,TCC스틸,3440,3345,-95,-2.76,1754870,5892016230
024070,WISCOM,2280,2290,10,0.44,23097,52368950
037270,YGPLUS,6700,7010,310,4.63,4934387,33807252310
000500,가온전선,24250,23650,-600,-2.47,33373,784553050
000860,강남제비스코,16300,16200,-100,-0.61,6059,98007350
035250,강원랜드,21650,21300,-350,-1.62,466607,9990408850
011420,갤럭시아에스엠,1440,1425,-15,-1.04,59723,85711930
002100,경농,14350,14500,150,1.05,93445,1342243750
009450,경동나비엔,56400,56500,100,0.18,59973,3374546800
267290,경동도시가스,20750,20650,-100,-0.48,73766,1526107350
012320,경동인베스트,29500,30000,500,1.69,8542,251768850
000050,경방,10900,10750,-150,-1.38,41647,447676850
214390,경보제약,11750,11650,-100,-0.85,200592,2348311500
012610,경인양행,7900,7940,40,0.51,376969,2972326440
009140,경인전자,21800,22300,500,2.29,2244,49387500
013580,계룡건설,22050,22150,100,0.45,48299,1064599450
012200,계양전기,3380,3375,-5,-0.15,294947,992812735
012205,계양전기우,8990,9300,310,3.45,745533,7259856650
002140,고려산업,3685,3675,-10,-0.27,321321,1175044400
010130,고려아연,394500,392000,-2500,-0.63,38737,15193436000
002240,고려제강,14000,14000,0,0.0,14388,201058100
009290,광동제약,10000,10050,50,0.5,588594,5889538190
017040,광명전기,1890,1905,15,0.79,4059187,7888030795
017900,광전자,2195,2215,20,0.91,318542,705191850
037710,광주신세계,153000,153500,500,0.33,329,50039500
030610,교보증권,6620,6640,20,0.3,64380,427499530
007690,국도화학,47000,46850,-150,-0.32,11721,540145500
005320,국동,4600,4445,-155,-3.37,3298312,14766369720
001140,국보,2560,2535,-25,-0.98,2234128,5701878475
002720,국제약품,12050,12200,150,1.24,403665,4875770850
083420,그린케미칼,3990,3990,0,0.0,76515,302598440
014530,극동유화,3175,3195,20,0.63,310108,985898260
014280,금강공업,3890,4000,110,2.83,177112,698617190
014285,금강공업우,19750,19850,100,0.51,365469,7215704750
008870,금비,56700,56600,-100,-0.18,575,32594000
001570,금양,5150,5160,10,0.19,290045,1486052150
002990,금호산업,6830,6920,90,1.32,113976,784687620
002995,금호산업우,37650,37900,250,0.66,11354,425555550
011780,금호석유,98100,102000,3900,3.98,183847,18757541400
011785,금호석유우,39500,40550,1050,2.66,27622,1119015000
214330,금호에이치티,3865,3915,50,1.29,5056005,19562379285
001210,금호전기,4335,4475,140,3.23,370869,1611215615
073240,금호타이어,4180,4030,-150,-3.59,1074152,4347167890
092440,기신정기,3620,3645,25,0.69,2091951,8113113035
000270,기아차,48500,47800,-700,-1.44,2291761,109922389088
024110,기업은행,8120,8000,-120,-1.48,3530713,28372307990
013700,까뮤이앤씨,1220,1230,10,0.82,353732,432272290
004540,깨끗한나라,4675,4745,70,1.5,149780,701875095
004545,깨끗한나라우,29500,29600,100,0.34,11724,346953200
001260,남광토건,10450,10500,50,0.48,27588,288908450
008350,남선알미늄,5260,5390,130,2.47,12361371,66936605070
008355,남선알미우,72500,75000,2500,3.45,45148,3352994000
004270,남성,2750,2700,-50,-1.82,300984,819160510
003920,남양유업,270000,269500,-500,-0.19,1363,367403000
003925,남양유업우,168500,170000,1500,0.89,790,133559500
025860,남해화학,8360,8370,10,0.12,157370,1315449520
005720,넥센,3995,4085,90,2.25,146708,592311085
005725,넥센우,2985,3030,45,1.51,49769,151174115
002350,넥센타이어,5650,5600,-50,-0.88,600912,3394623490
002355,넥센타이어1우B,2335,2335,0,0.0,27755,64758680
003580,넥스트사이언스,6520,6570,50,0.77,672436,4359318150
251270,넷마블,180500,186000,5500,3.05,689778,127652685000
090350,노루페인트,7160,7240,80,1.12,58421,421931460
090355,노루페인트우,14950,15500,550,3.68,311012,5147254350
000320,노루홀딩스,9300,9260,-40,-0.43,3223,29744880
000325,노루홀딩스우,18000,19100,1100,6.11,9060,168602950
006280,녹십자,253000,253500,500,0.2,130247,32795221000
005250,녹십자홀딩스,25900,25500,-400,-1.54,145828,3740972700
005257,녹십자홀딩스2우,161000,164000,3000,1.86,12326,1998062500
004370,농심,337000,333500,-3500,-1.04,39721,13255505000
072710,농심홀딩스,77900,77500,-400,-0.51,1426,110673400
058730,다스코,6310,6010,-300,-4.75,372704,2235908360
023590,다우기술,24100,23500,-600,-2.49,439271,10313596600
019680,대교,3965,3955,-10,-0.25,54170,214616790
019685,대교우B,2575,2630,55,2.14,307603,798375850
006370,대구백화점,6990,7650,660,9.44,71509,538872340
008060,대덕,6440,6420,-20,-0.31,167534,1075718780
00806K,대덕1우,7300,7620,320,4.38,321916,2522833190
353200,대덕전자,11600,11550,-50,-0.43,626485,7157050350
35320K,대덕전자1우,7630,7670,40,0.52,191408,1502343250
000490,대동공업,6710,6980,270,4.02,1166156,8213161950
008110,대동전자,4215,4240,25,0.59,20781,87653955
005750,대림BCo,4895,4895,0,0.0,5325,26042810
001880,대림건설,25600,25650,50,0.2,43427,1109748400
000210,대림산업,81200,83500,2300,2.83,408152,33931529100
000215,대림산업우,42750,43750,1000,2.34,48425,2095129700
006570,대림통상,4070,4050,-20,-0.49,14335,57361115
001680,대상,26750,26900,150,0.56,101025,2723820300
001685,대상우,17600,17800,200,1.14,7267,129343450
084690,대상홀딩스,10250,10050,-200,-1.95,264623,2644060930
084695,대상홀딩스우,8650,8600,-50,-0.58,12699,110399640
128820,대성산업,3525,3605,80,2.27,265357,942218025
117580,대성에너지,5340,5410,70,1.31,114801,616096060
016710,대성홀딩스,17500,18050,550,3.14,56784,1011211850
003540,대신증권,10500,10500,0,0.0,123942,1304339950
003547,대신증권2우B,9230,9270,40,0.43,10323,95291230
003545,대신증권우,9520,9510,-10,-0.11,58943,560229740
009190,대양금속,3840,3830,-10,-0.26,369970,1414140525
014160,대영포장,1130,1185,55,4.87,14176088,16693639210
047040,대우건설,2915,2925,10,0.34,1406002,4102272475
009320,대우부품,3030,3120,90,2.97,3045191,9351205365
042660,대우조선해양,24400,24050,-350,-1.43,260780,6266909500
003090,대웅,30900,30900,0,0.0,549449,17279677150
069620,대웅제약,113500,115500,2000,1.76,72145,8277607000
000430,대원강업,3595,3800,205,5.7,1271144,4993024325
006340,대원전선,1010,1030,20,1.98,3268204,3408734380
006345,대원전선우,3745,3970,225,6.01,1922296,8239577050
003220,대원제약,21550,22250,700,3.25,359273,7899341200
024890,대원화성,1685,1690,5,0.3,34648,58441430
002880,대유에이텍,847,841,-6,-0.71,661888,556904378
000300,대유플러스,897,875,-22,-2.45,6882647,6140872973
012800,대창,1115,1105,-10,-0.9,635104,706076880
015230,대창단조,32850,32400,-450,-1.37,21896,708249700
001070,대한방직,34200,34050,-150,-0.44,3526,120395950
006650,대한유화,158500,160500,2000,1.26,75159,12178535000
001440,대한전선,832,828,-4,-0.48,4851123,4044954635
084010,대한제강,6990,7000,10,0.14,62651,431945150
001790,대한제당,18700,18700,0,0.0,22162,412038200
001795,대한제당우,13600,14100,500,3.68,18436,259666550
001130,대한제분,160500,161000,500,0.31,2850,456630500
003490,대한항공,18900,18800,-100,-0.53,1085793,20400179200
003495,대한항공우,25050,25000,-50,-0.2,30253,748884250
005880,대한해운,17150,17100,-50,-0.29,86795,1489581600
003830,대한화섬,84700,84000,-700,-0.83,416,34937200
016090,대현,1780,1765,-15,-0.84,98020,173098115
069460,대호에이엘,2250,2195,-55,-2.44,1195304,2708109380
192080,더블유게임즈,77300,79500,2200,2.85,165215,12989882900
012510,더존비즈온,111500,109000,-2500,-2.24,142103,15613365500
004830,덕성,4775,4630,-145,-3.04,348857,1616218065
004835,덕성우,9840,10000,160,1.63,200878,2057525400
024900,덕양산업,2015,2000,-15,-0.74,522185,1040111365
145720,덴티움,37100,37250,150,0.4,49650,1833776200
002150,도화엔지니어링,7590,7590,0,0.0,93898,751696910
001230,동국제강,6200,6210,10,0.16,593768,3708501710
023450,동남합성,37650,37750,100,0.27,190,7179000
004140,동방,2295,2220,-75,-3.27,9313936,21327998210
007590,동방아그로,6370,6340,-30,-0.47,15363,97299110
005960,동부건설,11000,10850,-150,-1.36,76726,837715300
005965,동부건설우,33900,34200,300,0.88,47234,1651546050
026960,동서,27500,28650,1150,4.18,161745,4530701000
002210,동성제약,12800,12950,150,1.17,161024,2066261450
102260,동성코퍼레이션,4280,4335,55,1.29,56276,242465775
005190,동성화학,15900,15850,-50,-0.31,16726,263327700
000640,동아쏘시오홀딩스,111500,114500,3000,2.69,45272,5208035500
170900,동아에스티,93800,94200,400,0.43,29071,2736657400
028100,동아지질,14950,15400,450,3.01,156217,2391567900
282690,동아타이어,9740,9840,100,1.03,17506,170412030
001520,동양,1165,1160,-5,-0.43,566579,659799480
001527,동양2우B,15500,14850,-650,-4.19,29543,471901200
001529,동양3우B,31000,30300,-700,-2.26,8626,274316800
084670,동양고속,26800,26900,100,0.37,3287,87752500
002900,동양물산,1350,1370,20,1.48,23327607,31771247770
082640,동양생명,3145,3115,-30,-0.95,69034,215756400
001525,동양우,7140,7220,80,1.12,194938,1522239980
008970,동양철관,1075,1070,-5,-0.47,959873,1029988685
092780,동양피스톤,6830,6400,-430,-6.3,1015274,6566708590
049770,동원FB,175500,178500,3000,1.71,9525,1705890000
018500,동원금속,708,706,-2,-0.28,139853,98278840
006040,동원산업,218000,212500,-5500,-2.52,4997,1072264500
030720,동원수산,9010,8970,-40,-0.44,42701,381567270
014820,동원시스템즈,23650,23500,-150,-0.63,25559,605930550
014825,동원시스템즈우,31450,32500,1050,3.34,5759,186157450
163560,동일고무벨트,10000,10100,100,1.0,118166,1190245500
004890,동일산업,69700,69800,100,0.14,533,37055700
002690,동일제강,2330,2265,-65,-2.79,50094,114222660
000020,동화약품,25300,25050,-250,-0.99,624243,15650316800
000150,두산,48700,48800,100,0.21,82754,4044921900
000157,두산2우B,89400,87000,-2400,-2.68,4407,379717600
241560,두산밥캣,27450,27250,-200,-0.73,259410,7053532300
336370,두산솔루스,40050,40100,50,0.12,184530,7380832350
33637K,두산솔루스1우,18250,18000,-250,-1.37,42105,760224600
33637L,두산솔루스2우B,35300,35600,300,0.85,8079,287313350
000155,두산우,40100,39950,-150,-0.37,17594,700678100
042670,두산인프라코어,7880,8080,200,2.54,7377105,59558995600
034020,두산중공업,15450,15000,-450,-2.91,7741797,117821326150
336260,두산퓨얼셀,53500,51200,-2300,-4.3,897528,46554246900
33626K,두산퓨얼셀1우,21000,20050,-950,-4.52,182116,3671883800
33626L,두산퓨얼셀2우B,29800,28250,-1550,-5.2,119318,3396133300
016740,두올,3790,3705,-85,-2.24,654423,2414895170
192650,드림텍,18000,17850,-150,-0.83,2925495,52071774400
024090,디씨엠,10900,11000,100,0.92,3442,37517050
003160,디아이,4115,4035,-80,-1.94,114346,462392025
092200,디아이씨,1560,1550,-10,-0.64,269792,412847675
013570,디와이,4475,4340,-135,-3.02,121757,533158010
210540,디와이파워,11100,10800,-300,-2.7,198758,2151224100
007340,디티알오토모티브,23350,23700,350,1.5,36622,857327550
026890,디피씨,18900,19700,800,4.23,3151674,61219232800
115390,락앤락,11450,11400,-50,-0.44,97584,1122283600
032350,롯데관광개발,15550,15450,-100,-0.64,198101,3059409000
330590,롯데리츠,5210,5200,-10,-0.19,205189,1063851700
000400,롯데손해보험,1620,1620,0,0.0,150869,243695710
023530,롯데쇼핑,80100,80000,-100,-0.12,72564,5802981900
004000,롯데정밀화학,51000,52300,1300,2.55,218363,11196128500
286940,롯데정보통신,37250,36450,-800,-2.15,62206,2270273850
280360,롯데제과,103000,101500,-1500,-1.46,14588,1479140000
004990,롯데지주,30200,30250,50,0.17,106054,3205887350
00499K,롯데지주우,65200,65400,200,0.31,3128,203556100
005300,롯데칠성,93500,93300,-200,-0.21,15295,1428585300
005305,롯데칠성우,60000,59800,-200,-0.33,2591,154917500
011170,롯데케미칼,204500,209500,5000,2.44,262852,54824265500
002270,롯데푸드,307500,304000,-3500,-1.14,4346,1327206000
071840,롯데하이마트,30750,30000,-750,-2.44,114845,3467023935
027740,마니커,699,702,3,0.43,879142,614962478
204320,만도,35550,35900,350,0.98,1170868,41193021000
001080,만호제강,15400,15450,50,0.32,4586,70509700
088980,맥쿼리인프라,11100,11000,-100,-0.9,496869,5490507350
094800,맵스리얼티1,4020,3980,-40,-1.0,45050,179967670
138040,메리츠금융지주,9160,9180,20,0.22,82549,754487350
008560,메리츠증권,3280,3275,-5,-0.15,2115450,6878900210
000060,메리츠화재,13150,13200,50,0.38,97859,1284734100
090370,메타랩스,1180,1175,-5,-0.42,377949,435762795
017180,명문제약,6300,6270,-30,-0.48,563602,3548885500
012690,모나리자,5740,5680,-60,-1.05,361523,2059740960
005360,모나미,7080,6960,-120,-1.69,687823,4811144810
204210,모두투어리츠,2970,2965,-5,-0.17,31333,94307470
009680,모토닉,13500,13300,-200,-1.48,292528,3843586750
009580,무림PP,3215,3340,125,3.89,2207669,7533660040
009200,무림페이퍼,2415,2380,-35,-1.45,101663,243601025
033920,무학,7300,6760,-540,-7.4,239984,1670223870
008420,문배철강,2715,2705,-10,-0.37,193299,521609705
025560,미래산업,3405,3380,-25,-0.73,240944,813865000
007120,미래아이앤지,374,373,-1,-0.27,462686,171260572
006800,미래에셋대우,9120,9200,80,0.88,2373072,21830918750
00680K,미래에셋대우2우B,4495,4580,85,1.89,465885,2110602335
006805,미래에셋대우우,5140,5160,20,0.39,41031,210481480
357250,미래에셋맵스리츠,4785,4785,0,0.0,30133,144273130
085620,미래에셋생명,4110,4245,135,3.28,429833,1862579665
002840,미원상사,97900,97500,-400,-0.41,477,46287600
268280,미원에스씨,95600,95600,0,0.0,339,32261400
107590,미원홀딩스,57000,57500,500,0.88,1926,110185400
134380,미원화학,57300,57900,600,1.05,1369,79317800
003650,미창석유,59600,60100,500,0.84,306,18343600
155900,바다로19호,2565,2565,0,0.0,1649,4228655
003610,방림,2025,2010,-15,-0.74,90979,182291035
001340,백광산업,3730,3610,-120,-3.22,2146946,7874857360
035150,백산,4655,4560,-95,-2.04,122230,557150770
002410,범양건영,5960,6050,90,1.51,788818,4736002390
096300,베트남개발1,281,283,2,0.71,54418,15328503
007210,벽산,2055,2020,-35,-1.7,444351,896956195
002760,보락,2615,2635,20,0.76,3187123,8426081645
003850,보령제약,16700,16650,-50,-0.3,225703,3747616450
000890,보해양조,857,849,-8,-0.93,1060028,896133818
003000,부광약품,32850,31500,-1350,-4.11,3624054,117966779400
001270,부국증권,20450,20450,0,0.0,400,8148450
001275,부국증권우,19350,19300,-50,-0.26,1854,35726350
026940,부국철강,4815,5040,225,4.67,5950673,31989968785
015350,부산가스,54800,53800,-1000,-1.82,7089,381882800
011390,부산산업,122000,123500,1500,1.23,8676,1070835000
005030,부산주공,508,458,-50,-9.84,4901903,2390325055
002070,비비안,4660,4615,-45,-0.97,685023,3155774050
100220,비상교육,6980,6950,-30,-0.43,25244,175692290
030790,비케이탑스,4745,5200,455,9.59,674703,3491589450
101140,비티원,3460,3450,-10,-0.29,155887,543842640
005180,빙그레,56600,57100,500,0.88,16952,962435700
003960,사조대림,14600,14500,-100,-0.68,21806,316533800
008040,사조동아원,924,922,-2,-0.22,287465,263603141
007160,사조산업,30900,30900,0,0.0,7255,223828950
014710,사조씨푸드,4430,4350,-80,-1.81,203653,883438370
006090,사조오양,9040,9050,10,0.11,74776,675962320
005090,삼광글라스,49700,49600,-100,-0.2,49868,2474689700
001470,삼부토건,1775,1590,-185,-10.42,7269234,11676867960
006400,삼성SDI,445500,453000,7500,1.68,394156,178640941500
006405,삼성SDI우,268000,268500,500,0.19,18136,4889547500
006660,삼성공조,6710,6580,-130,-1.94,30137,198877930
028260,삼성물산,109000,109500,500,0.46,312258,34234653000
02826K,삼성물산우B,98100,98800,700,0.71,7842,772424100
207940,삼성바이오로직스,757000,758000,1000,0.13,64797,48909003000
032830,삼성생명,63200,62900,-300,-0.47,403035,25342738900
018260,삼성에스디에스,179000,181500,2500,1.4,209618,37763156000
028050,삼성엔지니어링,11250,11150,-100,-0.89,821857,9160318700
009150,삼성전기,138500,141500,3000,2.17,443316,62018715000
009155,삼성전기우,62600,63400,800,1.28,22367,1397243000
005930,삼성전자,59500,59300,-200,-0.34,18884571,1121249648513
005935,삼성전자우,51000,50900,-100,-0.2,2188690,111330520400
001360,삼성제약,3950,3915,-35,-0.89,961277,3755827880
010140,삼성중공업,5420,5440,20,0.37,2083741,11278642950
010145,삼성중공우,434000,429500,-4500,-1.04,3547,1519537000
016360,삼성증권,31400,31200,-200,-0.64,312036,9756701700
068290,삼성출판사,19700,19600,-100,-0.51,23097,452566100
029780,삼성카드,28750,28900,150,0.52,112577,3240589250
000810,삼성화재,187500,186500,-1000,-0.53,78831,14725545000
000815,삼성화재우,136500,135000,-1500,-1.1,6286,852650500
006110,삼아알미늄,6030,6250,220,3.65,179055,1107978350
145990,삼양사,61600,60800,-800,-1.3,25285,1537497800
145995,삼양사우,48500,49000,500,1.03,2316,112533650
003230,삼양식품,108000,108500,500,0.46,21069,2268629000
002170,삼양통상,61100,62100,1000,1.64,7434,459271500
272550,삼양패키징,22250,22800,550,2.47,35478,804895450
000070,삼양홀딩스,64500,64400,-100,-0.16,7614,491363800
000075,삼양홀딩스우,49200,49250,50,0.1,1296,64006050
002810,삼영무역,13700,13800,100,0.73,82673,1148793750
005680,삼영전자,8200,8140,-60,-0.73,31784,260329850
003720,삼영화학,2130,2330,200,9.39,1863333,4133200145
023000,삼원강재,2285,2320,35,1.53,31331,72031600
004380,삼익THK,11600,11550,-50,-0.43,48888,562267050
002450,삼익악기,1400,1400,0,0.0,260488,361313170
004440,삼일씨엔에스,11400,10900,-500,-4.39,105219,1162180050
000520,삼일제약,23050,23300,250,1.08,105546,2423950600
009770,삼정펄프,29150,28950,-200,-0.69,828,24003100
005500,삼진제약,29900,29800,-100,-0.33,64222,1916385200
004690,삼천리,80600,80000,-600,-0.74,5760,461630500
010960,삼호개발,4115,4100,-15,-0.36,68637,280311210
004450,삼화왕관,39250,39200,-50,-0.13,1016,39768900
009470,삼화전기,19250,19400,150,0.78,53860,1046650400
011230,삼화전자,3055,3050,-5,-0.16,105252,320478615
001820,삼화콘덴서,57300,57800,500,0.87,106169,6115626000
000390,삼화페인트,5100,5090,-10,-0.2,15525,78805980
001290,상상인증권,1010,1015,5,0.5,181587,183486510
041650,상신브레이크,2595,2585,-10,-0.39,143792,367178970
075180,새론오토모티브,3980,3965,-15,-0.38,3331,13130400
007540,샘표,51100,50700,-400,-0.78,8612,436688200
248170,샘표식품,46600,46900,300,0.64,6970,325793650
007860,서연,9370,9070,-300,-3.2,706979,6424153860
200880,서연이화,4495,4495,0,0.0,283209,1239997265
017390,서울가스,79000,77500,-1500,-1.9,2841,220589600
004410,서울식품,162,160,-2,-1.23,4726936,753916163
004415,서울식품우,5850,5970,120,2.05,273911,1650156540
021050,서원,3510,3625,115,3.28,1355777,4853505890
008490,서흥,56900,57400,500,0.88,26178,1490368100
007610,선도전기,2685,2700,15,0.56,74450,201198825
136490,선진,9590,9770,180,1.88,54552,523214850
002820,선창산업,4200,4120,-80,-1.9,19950,82417295
014910,성문전자,2085,2070,-15,-0.72,346153,715048395
014915,성문전자우,14050,13800,-250,-1.78,330721,4897273550
003080,성보화학,4355,4310,-45,-1.03,10864,46809415
004980,성신양회,7160,7220,60,0.84,79328,569594820
004985,성신양회우,18950,19050,100,0.53,186601,3662118350
011300,성안,389,386,-3,-0.77,216531,82671619
000180,성창기업지주,1755,1740,-15,-0.85,71780,123743515
002420,세기상사,61600,61600,0,0.0,0,0
004360,세방,9870,9840,-30,-0.3,30001,293156110
004365,세방우,5980,5980,0,0.0,216,1287110
004490,세방전지,28700,28300,-400,-1.39,25033,711936000
001430,세아베스틸,10050,10100,50,0.5,88623,894809400
306200,세아제강,92500,88000,-4500,-4.86,49088,4354118700
003030,세아제강지주,47500,45150,-2350,-4.95,40530,1843403550
019440,세아특수강,10700,10650,-50,-0.47,5902,62837500
058650,세아홀딩스,70900,71300,400,0.56,89,6330700
013000,세우글로벌,2250,2925,675,30.0,65873544,172926363985
091090,세원셀론텍,2920,2920,0,0.0,256244,745374115
021820,세원정공,8090,8090,0,0.0,0,0
067830,세이브존IC,2550,2650,100,3.92,726778,1942826650
033530,세종공업,10450,10100,-350,-3.35,1228563,12454813380
075580,세진중공업,10400,10650,250,2.4,1997851,21487986350
027970,세하,1705,1760,55,3.23,1848346,3179550925
145210,세화아이엠씨,1180,1165,-15,-1.27,646146,764514575
308170,센트랄모텍,24850,25100,250,1.01,70684,1744267350
068270,셀트리온,291500,291500,0,0.0,754705,222552322000
004430,송원산업,13400,13500,100,0.75,374049,5015837550
017550,수산중공업,1685,1700,15,0.89,317852,537239875
053210,스카이라이프,9590,9520,-70,-0.73,51230,487001180
134790,시디즈,63900,63900,0,0.0,2774,175614200
016590,신대양제지,54900,55400,500,0.91,5362,294580100
029530,신도리코,23150,22900,-250,-1.08,4451,102353500
004970,신라교역,9820,9810,-10,-0.1,5602,54833210
011930,신성이엔지,2255,2265,10,0.44,17999783,41671352395
005390,신성통상,1810,1770,-40,-2.21,2562264,4547040600
004170,신세계,218500,215500,-3000,-1.37,101048,21954301000
035510,신세계IC,146000,144000,-2000,-1.37,34289,4790832500
034300,신세계건설,22500,22200,-300,-1.33,16530,365506950
031430,신세계인터내셔날,154000,152500,-1500,-0.97,32993,5038716000
031440,신세계푸드,54500,54700,200,0.37,5019,272519300
006880,신송홀딩스,3670,3630,-40,-1.09,9180,33404405
005800,신영와코루,95600,95000,-600,-0.63,345,32513000
001720,신영증권,47300,47200,-100,-0.21,10197,482280850
001725,신영증권우,47650,47850,200,0.42,2251,107530350
009270,신원,1485,1480,-5,-0.34,332005,492007950
009275,신원우,59000,55000,-4000,-6.78,17304,968997900
002700,신일전자,1720,1710,-10,-0.58,948145,1615738350
019170,신풍제약,152500,198000,45500,29.84,11151883,2053656328500
019175,신풍제약우,201000,242500,41500,20.65,1237617,290751401500
002870,신풍제지,1520,1575,55,3.62,546861,854063255
293940,신한알파리츠,6820,6810,-10,-0.15,70749,482757400
055550,신한지주,28550,28350,-200,-0.7,2219918,62883984350
001770,신화실업,19300,19200,-100,-0.52,5442,104235400
004080,신흥,9100,9160,60,0.66,1172,10680130
102280,쌍방울,681,678,-3,-0.44,2455231,1665617434
003410,쌍용양회,5700,5970,270,4.74,2184869,12813064740
003415,쌍용양회우,24550,24500,-50,-0.2,33135,820749800
003620,쌍용차,4700,4595,-105,-2.23,2290561,10459439105
004770,써니전자,4015,4145,130,3.24,1972216,8056748945
015540,쎌마테라퓨틱스,7920,8000,80,1.01,145851,1146387070
004920,씨아이테크,955,950,-5,-0.52,37542,35514437
112610,씨에스윈드,108000,110000,2000,1.85,253441,27599212500
008700,아남전자,1750,1820,70,4.0,1090737,1924105525
002790,아모레G,50900,50500,-400,-0.79,71422,3617622800
00279K,아모레G3우전환,33350,33400,50,0.15,2685,89637500
002795,아모레G우,21400,21100,-300,-1.4,51564,1086056750
090430,아모레퍼시픽,167000,168500,1500,0.9,123183,20635449000
090435,아모레퍼시픽우,60600,60500,-100,-0.17,59689,3597948700
002030,아세아,81000,80700,-300,-0.37,3298,264397500
183190,아세아시멘트,58900,58900,0,0.0,4003,234411200
002310,아세아제지,25250,25300,50,0.2,28832,727840100
267850,아시아나IDT,19950,20000,50,0.25,121073,2418357250
020560,아시아나항공,3905,3945,40,1.02,1208983,4718269165
122900,아이마켓코리아,8040,7980,-60,-0.75,108918,872052560
010780,아이에스동서,41700,41900,200,0.48,50738,2132897750
033660,아주캐피탈,12000,12050,50,0.42,33723,405166850
001780,알루코,4280,4220,-60,-1.4,2311862,9879285805
018250,애경산업,21850,21700,-150,-0.69,44021,956410650
161000,애경유화,7230,7250,20,0.28,60983,443168320
011090,에넥스,1030,1030,0,0.0,310953,320795000
005850,에스엘,13300,13200,-100,-0.75,527056,6951487350
012750,에스원,87300,88000,700,0.8,52621,4613921600
023960,에쓰씨엔지니어링,1400,1410,10,0.71,185939,260591970
298690,에어부산,3785,3740,-45,-1.19,375562,1398921835
140910,에이리츠,6630,6700,70,1.06,16935,113272100
078520,에이블씨엔씨,7730,7670,-60,-0.78,45447,348774820
015260,에이엔피,184,184,0,0.0,583527,108519920
007460,에이프로젠KIC,1965,1945,-20,-1.02,4460887,8692889560
003060,에이프로젠제약,1390,1390,0,0.0,3807522,5278531720
036570,엔씨소프트,805000,821000,16000,1.99,83953,68463988000
138250,엔에스쇼핑,14700,14850,150,1.02,76177,1113842700
085310,엔케이,1095,1060,-35,-3.2,968539,1032947360
009810,엔케이물산,381,392,11,2.89,7000323,2789737796
900140,엘브이엠씨홀딩스,3845,3795,-50,-1.3,260653,983292460
014440,영보화학,3810,3800,-10,-0.26,85470,325211275
111770,영원무역,30100,29400,-700,-2.33,130026,3848386700
009970,영원무역홀딩스,39200,39000,-200,-0.51,3470,135264850
003520,영진약품,9060,9300,240,2.65,8676152,80276239620
000670,영풍,487500,479000,-8500,-1.74,2494,1201267000
006740,영풍제지,3560,3470,-90,-2.53,71609,250071875
012280,영화금속,1930,1890,-40,-2.07,1207943,2276197055
012160,영흥,1170,1155,-15,-1.28,166353,192134220
015360,예스코홀딩스,35500,36050,550,1.55,999,36093700
007310,오뚜기,578000,589000,11000,1.9,4725,2772975000
002630,오리엔트바이오,1710,1650,-60,-3.51,3025384,4957731505
271560,오리온,147000,150000,3000,2.04,171937,25682892000
001800,오리온홀딩스,13000,13000,0,0.0,169613,2201882400
070960,용평리조트,4090,4100,10,0.24,31590,129656835
316140,우리금융지주,8440,8410,-30,-0.36,1274163,10739863970
004720,우리들제약,17200,17400,200,1.16,783107,13346175850
118000,우리들휴브레인,4840,4910,70,1.45,4556461,22206821540
010050,우리종금,528,520,-8,-1.52,1263154,656395769
006980,우성사료,3210,3160,-50,-1.56,450610,1411778255
017370,우신시스템,3280,3275,-5,-0.15,252507,822248155
105840,우진,3630,3595,-35,-0.96,236739,849995385
010400,우진아이엔에스,7960,7910,-50,-0.63,21282,167287690
049800,우진플라임,3955,3840,-115,-2.91,27637,106367965
016880,웅진,1140,1135,-5,-0.44,99194,112128285
095720,웅진씽크빅,2755,2705,-50,-1.81,631220,1708939145
005820,원림,17700,18000,300,1.69,971,17240600
010600,웰바이오텍,2440,2440,0,0.0,323740,790593295
008600,윌비스,1210,1240,30,2.48,1158973,1439310670
033270,유나이티드제약,99000,87500,-11500,-11.62,2340193,215651709300
014830,유니드,47350,47450,100,0.21,33067,1568605300
000910,유니온,8800,8610,-190,-2.16,767796,6671143050
047400,유니온머티리얼,4045,3980,-65,-1.61,839812,3352504090
011330,유니켐,1425,1460,35,2.46,731360,1059713450
077500,유니퀘스트,9960,9900,-60,-0.6,259526,2576026860
002920,유성기업,2500,2500,0,0.0,115966,286897635
000700,유수홀딩스,5310,5570,260,4.9,57352,311321950
003470,유안타증권,2990,2975,-15,-0.5,216285,643829980
003475,유안타증권우,2240,2365,125,5.58,680222,1607921150
011690,유양디앤유,1220,1220,0,0.0,0,0
072130,유엔젤,4230,4375,145,3.43,707388,3067235820
000220,유유제약,17800,17650,-150,-0.84,118413,2099598750
000225,유유제약1우,16050,16250,200,1.25,93050,1569794900
000227,유유제약2우B,43150,40900,-2250,-5.21,14989,626661100
001200,유진투자증권,3825,3890,65,1.7,412961,1588655025
000100,유한양행,66400,66600,200,0.3,536508,35750744300
000105,유한양행우,68500,69600,1100,1.61,30097,2088132800
003460,유화증권,2235,2225,-10,-0.45,23369,51912280
003465,유화증권우,2560,2465,-95,-3.71,97597,244778090
008730,율촌화학,16350,16450,100,0.61,58357,947230100
008250,이건산업,8530,8410,-120,-1.41,146855,1240437650
025820,이구산업,1585,1580,-5,-0.32,137488,216090610
214320,이노션,53500,53000,-500,-0.93,66455,3531176100
088260,이리츠코크렙,5210,5250,40,0.77,17275,90624090
139480,이마트,145500,146500,1000,0.69,225636,32851745000
007660,이수페타시스,5420,5440,20,0.37,778713,4165580640
005950,이수화학,8880,9070,190,2.14,242018,2188602550
015020,이스타코,707,703,-4,-0.57,58960,41328130
093230,이아이디,216,215,-1,-0.46,3732239,802303338
074610,이엔플러스,4355,4215,-140,-3.21,1624210,6781943240
102460,이연제약,23000,22350,-650,-2.83,130788,2939471700
084680,이월드,3465,3500,35,1.01,429657,1498443760
350520,이지스레지던스리츠,4650,4660,10,0.22,51881,241755285
334890,이지스밸류리츠,4470,4480,10,0.22,27146,121494420
000760,이화산업,15600,15150,-450,-2.88,870,13316800
014990,인디에프,1850,1820,-30,-1.62,287675,524741480
006490,인스코비,2285,2415,130,5.69,6432027,15458259980
023800,인지컨트롤스,8910,9100,190,2.13,499081,4505631840
034590,인천도시가스,25300,25350,50,0.2,5548,140448050
129260,인터지스,2690,2745,55,2.04,243748,653537585
023810,인팩,4660,4655,-5,-0.11,94173,434329615
249420,일동제약,17250,17650,400,2.32,73024,1272376000
000230,일동홀딩스,9760,9740,-20,-0.2,8862,86154930
013360,일성건설,950,958,8,0.84,159965,151086804
003120,일성신약,84900,85500,600,0.71,3638,308110500
003200,일신방직,72900,73000,100,0.14,4723,343740100
007110,일신석재,2170,2140,-30,-1.38,698062,1500358870
007570,일양약품,70800,87400,16600,23.45,8156484,680809063100
007575,일양약품우,96100,124500,28400,29.55,331389,39136923800
008500,일정실업,14050,13350,-700,-4.98,10920,152783500
081000,일진다이아,63200,65300,2100,3.32,665844,43152443600
020760,일진디스플,3965,3850,-115,-2.9,402490,1546951225
020150,일진머티리얼즈,48300,48750,450,0.93,240807,11768153950
103590,일진전기,3220,3195,-25,-0.78,189025,607856645
015860,일진홀딩스,5620,5560,-60,-1.07,284576,1573856340
226320,잇츠한불,28800,27500,-1300,-4.51,324552,9075140350
317400,자이에스앤디,8170,8200,30,0.37,113403,924909650
033240,자화전자,12150,12350,200,1.65,105077,1287790700
000950,전방,27450,27400,-50,-0.18,2606,71190450
348950,제이알글로벌리츠,4880,4870,-10,-0.2,121360,590969130
194370,제이에스코퍼레이션,7290,7360,70,0.96,19577,142778720
025620,제이준코스메틱,2805,2770,-35,-1.25,231121,642861465
036420,제이콘텐트리,27150,26850,-300,-1.1,139702,3745276600
030000,제일기획,20200,20900,700,3.47,759323,15618963800
271980,제일약품,49450,49350,-100,-0.2,111101,5488447100
001560,제일연마,6620,6730,110,1.66,9452,62811120
002620,제일파마홀딩스,23400,23450,50,0.21,30574,709499700
006220,제주은행,3010,3010,0,0.0,11938,35810125
089590,제주항공,13800,14000,200,1.45,215261,2951133800
004910,조광페인트,5360,5300,-60,-1.12,10747,57135810
004700,조광피혁,52100,52600,500,0.96,5248,275917100
001550,조비,22450,22400,-50,-0.22,53109,1189894750
000480,조선내화,74000,74400,400,0.54,817,60282100
120030,조선선재,99900,99900,0,0.0,4401,437920900
018470,조일알미늄,637,627,-10,-1.57,96731,61074673
002600,조흥,150000,151000,1000,0.67,74,11119000
185750,종근당,182500,182000,-500,-0.27,130870,23948473500
063160,종근당바이오,50300,50700,400,0.8,90450,4591374250
001630,종근당홀딩스,117000,116000,-1000,-0.85,17838,2074917500
044380,주연테크,1140,1180,40,3.51,621711,721284965
013890,지누스,83400,84700,1300,1.56,33579,2819828900
013870,지엠비코리아,8800,8800,0,0.0,612882,5451211150
071320,지역난방공사,35350,35800,450,1.27,9514,337863700
010580,지코,306,306,0,0.0,0,0
035000,지투알,5150,5120,-30,-0.58,24593,124825030
088790,진도,2655,2665,10,0.38,57186,151357600
003780,진양산업,4035,3910,-125,-3.1,512121,2007327895
010640,진양폴리,3020,3060,40,1.32,75230,227344930
100250,진양홀딩스,2810,2800,-10,-0.36,116161,323690040
051630,진양화학,4315,4140,-175,-4.06,446015,1877649685
272450,진에어,9530,9500,-30,-0.31,87614,828620300
011000,진원생명과학,28950,30000,1050,3.63,9619006,276707331400
002780,진흥기업,2575,2565,-10,-0.39,4337684,11681217505
002787,진흥기업2우B,18750,17550,-1200,-6.4,1195746,23941309100
002785,진흥기업우B,10450,12200,1750,16.75,2094216,26367407600
009310,참엔지니어링,1245,1215,-30,-2.41,253446,308918180
000650,천일고속,64700,64800,100,0.15,2167,139587700
012600,청호컴넷,8140,8630,490,6.02,248947,2125928970
033250,체시스,3015,2940,-75,-2.49,901696,2655760945
035720,카카오,371000,373000,2000,0.54,495271,184562294500
006380,카프로,2670,2630,-40,-1.5,170320,448382440
109070,컨버즈,4100,4100,0,0.0,0,0
001620,케이비아이동국실업,645,642,-3,-0.47,67524,43717585
029460,케이씨,23650,24000,350,1.48,131770,3137544050
344820,케이씨씨글라스,30350,30200,-150,-0.49,44258,1340988200
281820,케이씨텍,20750,20850,100,0.48,62015,1280575100
145270,케이탑리츠,775,778,3,0.39,79716,61839238
357120,코람코에너지리츠,4705,4720,15,0.32,144638,681979535
007815,코리아써우,5080,5180,100,1.97,11554,60313030
007810,코리아써키트,13350,14100,750,5.62,412469,5733645000
00781K,코리아써키트2우B,6780,6730,-50,-0.74,46114,329259190
152330,코리아오토글라스,14200,14100,-100,-0.7,131374,1850289850
003690,코리안리,7470,7470,0,0.0,366121,2743119030
192820,코스맥스,103000,104000,1000,0.97,70678,7378538500
044820,코스맥스비티아이,19750,19300,-450,-2.28,27414,532524750
005070,코스모신소재,14900,15250,350,2.35,394612,5967628050
005420,코스모화학,10300,10250,-50,-0.49,271448,2789998400
071950,코아스,1100,1090,-10,-0.91,486794,531111600
002020,코오롱,23300,22850,-450,-1.93,77330,1762128550
003070,코오롱글로벌,20650,19950,-700,-3.39,286107,5722028900
003075,코오롱글로벌우,46350,44250,-2100,-4.53,30266,1345698800
144620,코오롱머티리얼,4725,4570,-155,-3.28,1194572,5453427255
002025,코오롱우,15950,16100,150,0.94,4129,65496550
120110,코오롱인더,39500,39950,450,1.14,438549,17398954600
120115,코오롱인더우,22600,22750,150,0.66,65780,1458127350
138490,코오롱플라스틱,4255,4530,275,6.46,344954,1517160415
021240,코웨이,79400,79400,0,0.0,179823,14207185500
031820,콤텍시스템,1350,1330,-20,-1.48,717089,959208775
192400,쿠쿠홀딩스,96000,97200,1200,1.25,7152,693075800
284740,쿠쿠홈시스,41200,41250,50,0.12,26568,1099266050
015590,큐로,600,601,1,0.17,1261766,751158832
264900,크라운제과,8800,8700,-100,-1.14,33736,293723290
26490K,크라운제과우,11600,10800,-800,-6.9,935043,11181860700
005740,크라운해태홀딩스,9170,9100,-70,-0.76,384752,3425511520
005745,크라운해태홀딩스우,14000,13750,-250,-1.79,165736,2401744450
020120,키다리스튜디오,9980,10100,120,1.2,120734,1204104180
039490,키움증권,108500,108500,0,0.0,34562,3750812500
012170,키위미디어그룹,150,150,0,0.0,0,0
014580,태경비케이,3690,3690,0,0.0,170890,625546865
015890,태경산업,5050,5050,0,0.0,36323,183974670
006890,태경케미컬,8680,9230,550,6.34,2621455,24698979480
003240,태광산업,694000,688000,-6000,-0.86,1279,878325000
011280,태림포장,4480,4870,390,8.71,26224800,124944726005
004100,태양금속,1050,1070,20,1.9,18038304,21350233060
004105,태양금속우,3665,4100,435,11.87,5939557,26258281665
009410,태영건설,21600,21600,0,0.0,0,0
009415,태영건설우,32500,32500,0,0.0,0,0
001420,태원물산,3915,3950,35,0.89,25930,100954515
007980,태평양물산,1795,1785,-10,-0.56,211004,376074885
055490,테이팩스,34800,35250,450,1.29,94334,3260250050
078000,텔코웨어,12100,12200,100,0.83,4178,50808900
214420,토니모리,9950,10050,100,1.01,60533,605050010
019180,티에이치엔,2520,2530,10,0.4,228588,586625370
091810,티웨이항공,2655,2660,5,0.19,74384,197300550
004870,티웨이홀딩스,966,969,3,0.31,97712,94227067
005690,파미셀,19300,19350,50,0.26,1213166,23626681300
036580,팜스코,5070,5090,20,0.39,37973,193562110
028670,팬오션,3495,3480,-15,-0.43,1116980,3869051520
010820,퍼스텍,2205,2180,-25,-1.13,281655,614788545
016800,퍼시스,28350,28600,250,0.88,1278,36402700
001020,페이퍼코리아,1705,1750,45,2.64,347744,603476215
090080,평화산업,1210,1200,-10,-0.83,404268,484146335
010770,평화홀딩스,3565,3650,85,2.38,74933,270499625
058430,포스코강판,13150,14050,900,6.84,153990,2105880250
047050,포스코인터내셔널,13950,13850,-100,-0.72,185269,2572146650
003670,포스코케미칼,86700,91200,4500,5.19,1106653,99836948900
007630,폴루스바이오팜,1225,1225,0,0.0,0,0
017810,풀무원,17400,17600,200,1.15,48626,850789300
103140,풍산,25500,25200,-300,-1.18,340310,8642776550
005810,풍산홀딩스,26450,26700,250,0.95,3567,94545750
033180,필룩스,3670,3710,40,1.09,1190910,4392547725
086790,하나금융지주,28450,28150,-300,-1.05,1080781,30586857359
293480,하나제약,24450,24700,250,1.02,74883,1832397150
039130,하나투어,39100,39050,-50,-0.13,117179,4530151400
172580,하이골드12호,2015,2015,0,0.0,2964,5975370
153360,하이골드3호,1350,1350,0,0.0,1831,2415900
071090,하이스틸,16950,16950,0,0.0,13275,226490400
019490,하이트론,2580,2575,-5,-0.19,23328,59476420
000080,하이트진로,37150,36850,-300,-0.81,367946,13576837350
000087,하이트진로2우B,21300,21400,100,0.47,7332,156650800
000140,하이트진로홀딩스,17200,16700,-500,-2.91,39248,661029000
000145,하이트진로홀딩스우,17000,17000,0,0.0,2281,38771150
152550,한국ANKOR유전,1680,1685,5,0.3,15958,26748260
036460,한국가스공사,25050,24750,-300,-1.2,258589,6405537100
005430,한국공항,31550,31600,50,0.16,3147,98860950
071050,한국금융지주,79500,78100,-1400,-1.76,477044,37270020200
071055,한국금융지주우,69200,68700,-500,-0.72,76640,5245323800
010040,한국내화,3295,3315,20,0.61,81164,267283735
025540,한국단자,46200,46150,-50,-0.11,54175,2479483500
004090,한국석유,96600,96900,300,0.31,3136,301185200
002200,한국수출포장,18200,18250,50,0.27,7456,135379400
002960,한국쉘석유,241000,239000,-2000,-0.83,1296,310947500
123890,한국자산신탁,3645,3685,40,1.1,242398,886023395
015760,한국전력,20450,20500,50,0.24,1794727,36680099350
006200,한국전자홀딩스,729,708,-21,-2.88,814397,587134876
009540,한국조선해양,86000,85400,-600,-0.7,225417,19275168700
023350,한국종합기술,4270,4210,-60,-1.41,72024,302450120
025890,한국주강,1810,1615,-195,-10.77,2982231,5169386035
000970,한국주철관,8700,8670,-30,-0.34,48355,419135800
104700,한국철강,4945,4915,-30,-0.61,96938,478549720
017960,한국카본,9900,10200,300,3.03,884595,8863501950
161890,한국콜마,46700,46500,-200,-0.43,84227,3907739850
024720,한국콜마홀딩스,28900,28850,-50,-0.17,84381,2408288450
161390,한국타이어앤테크놀로지,34500,34400,-100,-0.29,624384,21148079150
000240,한국테크놀로지그룹,16100,16000,-100,-0.62,578339,9350930750
034830,한국토지신탁,1840,1835,-5,-0.27,1043394,1911479690
007280,한국특수형강,1670,1645,-25,-1.5,377018,619652080
168490,한국패러랠,1930,1935,5,0.26,28903,55853580
010100,한국프랜지,2140,2165,25,1.17,294010,628873350
047810,한국항공우주,23300,23950,650,2.79,488447,11551005400
123690,한국화장품,13250,13300,50,0.38,80878,1067624550
003350,한국화장품제조,39900,40350,450,1.13,18583,742073750
011500,한농화성,5750,5470,-280,-4.87,92619,514438580
002390,한독,36700,35900,-800,-2.18,76481,2751486700
014790,한라,3480,3500,20,0.57,73970,260103925
060980,한라홀딩스,29800,29400,-400,-1.34,55307,1621156000
053690,한미글로벌,8670,8680,10,0.12,78822,676375200
042700,한미반도체,10500,10500,0,0.0,217342,2259225950
008930,한미사이언스,58700,58900,200,0.34,142748,8324339900
128940,한미약품,288500,288500,0,0.0,39836,11465250000
009240,한샘,102000,100000,-2000,-1.96,73160,7434456800
020000,한섬,30000,30650,650,2.17,75159,2268686250
003680,한성기업,13150,12900,-250,-1.9,246370,3187012300
105630,한세실업,17000,17150,150,0.88,186226,3204378950
069640,한세엠케이,2890,2845,-45,-1.56,36376,104589350
016450,한세예스24홀딩스,6280,6000,-280,-4.46,372637,2258629300
010420,한솔PNS,1520,1545,25,1.64,194451,297815675
009180,한솔로지스틱스,2030,2075,45,2.22,546396,1118584500
213500,한솔제지,14450,14350,-100,-0.69,152245,2194770150
014680,한솔케미칼,148000,150000,2000,1.35,73807,11048823500
004710,한솔테크닉스,9220,9200,-20,-0.22,530154,4824878030
004150,한솔홀딩스,3510,3510,0,0.0,117687,410892930
025750,한솔홈데코,1470,1485,15,1.02,6074420,9163921425
004960,한신공영,14300,14300,0,0.0,30723,439337800
011700,한신기계,1480,1520,40,2.7,2103880,3249930760
001750,한양증권,8530,8550,20,0.23,82243,713807460
001755,한양증권우,16100,16350,250,1.55,564018,10956746950
018880,한온시스템,13450,12650,-800,-5.95,2688406,34651793900
009420,한올바이오파마,37350,36700,-650,-1.74,589262,21698244950
014130,한익스프레스,6380,6160,-220,-3.45,6302381,40434745870
300720,한일시멘트,81400,80200,-1200,-1.47,4148,334815300
002220,한일철강,1730,1735,5,0.29,24999,43447775
006390,한일현대시멘트,26900,26850,-50,-0.19,12247,327888450
003300,한일홀딩스,46550,47250,700,1.5,1790,83497350
051600,한전KPS,27750,28000,250,0.9,136455,3798849400
052690,한전기술,16900,17100,200,1.18,66533,1135676000
130660,한전산업,3625,3610,-15,-0.41,37692,136345715
002320,한진,45900,45750,-150,-0.33,156910,7157245750
097230,한진중공업,9840,9730,-110,-1.12,263312,2552605990
003480,한진중공업홀딩스,4735,4510,-225,-4.75,311549,1419560130
180640,한진칼,77000,80100,3100,4.03,713371,57014088700
18064K,한진칼우,51200,52200,1000,1.95,25316,1310217200
005110,한창,1400,1535,135,9.64,40265932,63422868545
009460,한창제지,2240,2280,40,1.79,4339015,9661902890
000880,한화,26900,26750,-150,-0.56,428497,11500372750
00088K,한화3우B,13300,13350,50,0.38,56398,749311000
088350,한화생명,1560,1565,5,0.32,2377479,3696495035
000370,한화손해보험,2910,3010,100,3.44,803231,2382933460
009830,한화솔루션,42500,42550,50,0.12,2893436,122939615400
009835,한화솔루션우,71500,69300,-2200,-3.08,199362,13919767600
272210,한화시스템,12500,12050,-450,-3.6,1587676,19466176850
012450,한화에어로스페이스,26700,27000,300,1.12,281855,7526685400
000885,한화우,63900,62900,-1000,-1.56,21305,1342019400
003530,한화투자증권,1810,1795,-15,-0.83,382343,690438695
003535,한화투자증권우,4830,5000,170,3.52,598095,3036264865
195870,해성디에스,19800,19650,-150,-0.76,100088,1962739550
101530,해태제과식품,9050,8910,-140,-1.55,45695,405357570
143210,핸즈코퍼레이션,7810,7700,-110,-1.41,69181,536780700
000720,현대건설,32200,32100,-100,-0.31,403751,12986218800
267270,현대건설기계,26850,26850,0,0.0,368383,9710894950
000725,현대건설우,216000,215000,-1000,-0.46,2203,472016000
005440,현대그린푸드,7770,7660,-110,-1.42,256586,1976956510
086280,현대글로비스,147500,147500,0,0.0,162239,23813603000
064350,현대로템,16750,17000,250,1.49,1624404,27430162650
079430,현대리바트,16050,15900,-150,-0.93,104395,1656319050
012330,현대모비스,242000,240000,-2000,-0.83,465237,111076061500
010620,현대미포조선,30400,30300,-100,-0.33,81581,2475160800
069960,현대백화점,57000,56800,-200,-0.35,151601,8653073200
004560,현대비앤지스틸,7680,7600,-80,-1.04,51645,391827040
004565,현대비앤지스틸우,82900,83300,400,0.48,7929,659162300
011760,현대상사,14950,15150,200,1.34,211964,3254781100
004310,현대약품,6190,6190,0,0.0,415615,2558338320
322000,현대에너지솔루션,35400,35250,-150,-0.42,184811,6457433250
126560,현대에이치씨엔,3815,3780,-35,-0.92,207035,782041245
017800,현대엘리베이,41400,41200,-200,-0.48,203857,8403652850
307950,현대오토에버,60500,60300,-200,-0.33,166781,9941308800
011210,현대위아,43350,42700,-650,-1.5,221840,9438971800
267260,현대일렉트릭,17950,17800,-150,-0.84,572246,10084344250
004020,현대제철,25250,25100,-150,-0.59,640678,16204495600
267250,현대중공업지주,228000,223000,-5000,-2.19,64258,14416683000
005380,현대차,184000,181000,-3000,-1.63,2584103,469435172500
005387,현대차2우B,91000,89500,-1500,-1.65,140938,12597737600
005389,현대차3우B,81500,80600,-900,-1.1,33027,2657583900
005385,현대차우,89000,87000,-2000,-2.25,147667,12926444900
001500,현대차증권,10200,10150,-50,-0.49,115596,1170238000
227840,현대코퍼레이션홀딩스,11450,11150,-300,-2.62,111625,1241928200
001450,현대해상,22700,22850,150,0.66,219793,5004387300
057050,현대홈쇼핑,74300,75900,1600,2.15,60095,4526106200
093240,형지엘리트,2075,2065,-10,-0.48,607825,1238206250
003010,혜인,5300,5240,-60,-1.13,344426,1807941890
111110,호전실업,8580,8450,-130,-1.52,30871,259927250
008770,호텔신라,76500,75900,-600,-0.78,515135,39218953800
008775,호텔신라우,63000,63200,200,0.32,10329,652742100
002460,화성산업,12150,12150,0,0.0,46007,556474900
013520,화승알앤에이,1760,1710,-50,-2.84,175646,303866070
241590,화승엔터프라이즈,14100,14100,0,0.0,490729,6841705450
006060,화승인더,7890,7930,40,0.51,564004,4457959640
010690,화신,2755,2810,55,2.0,593743,1664655860
133820,화인베스틸,2600,2675,75,2.88,852393,2258785820
010660,화천기계,3035,3010,-25,-0.82,237866,714082195
000850,화천기공,31250,31200,-50,-0.16,4384,135789900
016580,환인제약,16100,15850,-250,-1.55,153658,2432820700
032560,황금에스티,7100,7170,70,0.99,124930,887139820
004800,효성,75000,74400,-600,-0.8,97578,7279787000
094280,효성ITX,27450,27800,350,1.28,21752,599046950
298040,효성중공업,67000,66600,-400,-0.6,280714,18484032500
298050,효성첨단소재,151000,154000,3000,1.99,58684,8917459500
298020,효성티앤씨,120000,119500,-500,-0.42,39007,4611383500
298000,효성화학,135000,133000,-2000,-1.48,34323,4587537000
093370,후성,10600,10500,-100,-0.94,2093786,22037044200
081660,휠라홀딩스,36300,37000,700,1.93,302181,10970704700
005870,휴니드,6350,6300,-50,-0.79,112250,705835700
079980,휴비스,8570,8980,410,4.78,459079,4062587680
005010,휴스틸,6950,6970,20,0.29,7341,50762780
069260,휴켐스,21600,21400,-200,-0.93,348451,7505654100
000540,흥국화재,2625,3030,405,15.43,6925561,21269032595
000547,흥국화재2우B,30400,35100,4700,15.46,425801,15257408400
000545,흥국화재우,9750,12650,2900,29.74,168024,2006268400
003280,흥아해운,258,258,0,0.0,0,0
