티커,종목명,시가,종가,변동폭,등락률,거래량,거래대금
095570,AJ네트웍스,5850,5910,60,1.03,42081,246290710
006840,AK홀딩스,27650,28550,900,3.25,65002,1834330800
027410,BGF,6160,6260,100,1.62,223103,1391186830
282330,BGF리테일,163000,167000,4000,2.45,21563,3574802000
138930,BNK금융지주,7350,7520,170,2.31,1214897,9178005630
001460,BYC,390500,395000,4500,1.15,206,81551500
001465,BYC우,184000,183500,-500,-0.27,130,23899000
001040,CJ,98400,101000,2600,2.64,66615,6686097600
079160,CJCGV,29400,29900,500,1.7,303549,9038010400
00104K,CJ4우전환,84700,85800,1100,1.3,3648,311426000
000120,CJ대한통운,181500,181000,-500,-0.28,23593,4279560500
011150,CJ씨푸드,5040,4965,-75,-1.49,1574139,7892165540
011155,CJ씨푸드1우,44250,44050,-200,-0.45,397,17499800
001045,CJ우,62300,63000,700,1.12,848,53219400
097950,CJ제일제당,442500,443000,500,0.11,16179,7189070500
097955,CJ제일제당우,211000,209000,-2000,-0.95,2965,623384500
000590,CS홀딩스,67800,68500,700,1.03,2806,190875200
012030,DB,1225,1255,30,2.45,4548522,5669087625
016610,DB금융투자,6720,6980,260,3.87,251059,1743323420
005830,DB손해보험,53500,55000,1500,2.8,92492,5075325900
000990,DB하이텍,60600,64300,3700,6.11,3119365,199850169300
000995,DB하이텍1우,114000,118000,4000,3.51,1043,124711000
139130,DGB금융지주,8810,9030,220,2.5,429997,3872101810
001530,DI동일,195000,195500,500,0.26,7289,1424800500
000210,DL,77300,79200,1900,2.46,104847,8257207800
001880,DL건설,35450,35850,400,1.13,37322,1335775350
000215,DL우,45600,46450,850,1.86,4911,228233900
375500,DL이앤씨,151000,151500,500,0.33,162781,24719702500
37550K,DL이앤씨우,80000,81400,1400,1.75,15268,1245804100
004840,DRB동일,7590,7610,20,0.26,18422,140815140
155660,DSR,6680,6870,190,2.84,84823,580665370
069730,DSR제강,6700,6630,-70,-1.04,199158,1340488950
017940,E1,55400,56000,600,1.08,8741,489272600
365550,ESR켄달스퀘어리츠,7650,7630,-20,-0.26,117132,891391240
383220,FF,527000,535000,8000,1.52,37360,20114439000
007700,FF홀딩스,35950,36050,100,0.28,42146,1520997350
114090,GKL,16350,16450,100,0.61,296891,4868493700
078930,GS,44050,44450,400,0.91,146031,6521524150
006360,GS건설,42050,43600,1550,3.69,1061529,46148251350
001250,GS글로벌,2815,2915,100,3.55,543403,1577271890
007070,GS리테일,36350,36450,100,0.28,174846,6370887550
078935,GS우,36700,37300,600,1.63,5968,222681350
012630,HDC,12900,13100,200,1.55,349176,4567151750
039570,HDC아이콘트롤스,13600,13750,150,1.1,22228,305794100
089470,HDC현대EP,5910,6000,90,1.52,98809,591817850
294870,HDC현대산업개발,32100,32750,650,2.02,517951,16911356250
011200,HMM,44650,43800,-850,-1.9,4799185,211139225950
082740,HSD엔진,9040,9280,240,2.65,915700,8504010230
003560,IHQ,1825,1860,35,1.92,1629204,2993409905
175330,JB금융지주,7180,7300,120,1.67,261148,1907033090
234080,JW생명과학,18700,18950,250,1.34,40546,764803650
001060,JW중외제약,30150,30300,150,0.5,57198,1737675700
001067,JW중외제약2우B,69100,69200,100,0.14,575,39686300
001065,JW중외제약우,48450,48450,0,0.0,1616,77928200
096760,JW홀딩스,4650,4620,-30,-0.65,74049,341997155
105560,KB금융,50400,51500,1100,2.18,1993981,103275989300
002380,KCC,312500,311500,-1000,-0.32,40840,12823387000
344820,KCC글라스,65400,65800,400,0.61,118816,7867126700
009070,KCTC,8460,9150,690,8.16,12323280,112095731200
009440,KC그린홀딩스,5350,5440,90,1.68,72575,392096910
119650,KC코트렐,7510,7910,400,5.33,575025,4426556510
092220,KEC,2425,2445,20,0.82,1643521,4007311230
016380,KG동부제철,16550,17400,850,5.14,653255,11173528000
016385,KG동부제철우,131000,135000,4000,3.05,282,37968500
001390,KG케미칼,35800,34250,-1550,-4.33,334329,11717608950
033180,KH필룩스,3310,3430,120,3.63,1289440,4392964545
001940,KISCO홀딩스,20650,20750,100,0.48,20995,431924700
025000,KPX케미칼,64000,64400,400,0.63,3749,239957900
092230,KPX홀딩스,67800,68500,700,1.03,1962,133543800
000040,KR모터스,1210,1265,55,4.55,4033024,5120087870
044450,KSS해운,12350,12300,-50,-0.4,76344,945726800
030200,KT,32150,32450,300,0.93,600931,19540699800
033780,KTG,82200,83600,1400,1.7,351486,29229080800
030210,KTB투자증권,8250,8430,180,2.18,3161435,27422400180
058850,KTcs,3365,3340,-25,-0.74,395810,1332413845
058860,KTis,3080,3105,25,0.81,220306,684242060
093050,LF,18800,19000,200,1.06,142089,2706786500
003550,LG,97100,98000,900,0.93,230253,22530222900
034220,LG디스플레이,23050,23200,150,0.65,1498429,34888285850
051900,LG생활건강,1720000,1726000,6000,0.35,13592,23431438000
051905,LG생활건강우,794000,805000,11000,1.39,3983,3186363000
003555,LG우,72900,73500,600,0.82,8360,614196800
032640,LG유플러스,14600,14700,100,0.68,1123601,16557848700
011070,LG이노텍,227500,228000,500,0.22,96166,21894411500
066570,LG전자,159000,158500,-500,-0.31,781657,124493939000
066575,LG전자우,75300,76600,1300,1.73,93979,7179319900
037560,LG헬로비전,8390,8310,-80,-0.95,1123574,9439395060
051910,LG화학,833000,849000,16000,1.92,151667,127726999000
051915,LG화학우,373000,383000,10000,2.68,21987,8317979077
079550,LIG넥스원,41650,41600,-50,-0.12,104769,4384045600
006260,LS,67500,69600,2100,3.11,90666,6266532000
010120,LSELECTRIC,55000,56200,1200,2.18,86354,4821289900
000680,LS네트웍스,4845,4890,45,0.93,456475,2220609515
229640,LS전선아시아,9050,9410,360,3.98,1896039,18061839760
001120,LX인터내셔널,30200,29900,-300,-0.99,189419,5715753700
108670,LX하우시스,105000,104000,-1000,-0.95,97442,10139566000
108675,LX하우시스우,44650,44350,-300,-0.67,5641,251273600
383800,LX홀딩스,10650,10850,200,1.88,459872,4980749850
38380K,LX홀딩스1우,17150,17350,200,1.17,22732,395359950
023150,MH에탄올,11000,11300,300,2.73,114429,1280217500
035420,NAVER,415500,418500,3000,0.72,475697,198330453500
181710,NHN,79600,80300,700,0.88,62696,5014056100
005940,NH투자증권,12300,12500,200,1.63,316171,3942870950
005945,NH투자증권우,11000,11100,100,0.91,42510,472106550
338100,NH프라임리츠,4865,4920,55,1.13,50138,246375800
034310,NICE,18600,18700,100,0.54,54873,1020513350
008260,NI스틸,5100,5200,100,1.96,138515,720942920
004250,NPC,4410,4530,120,2.72,151747,674247400
004255,NPC우,2965,2930,-35,-1.18,8898,25991770
010060,OCI,114000,113000,-1000,-0.88,243347,27544488000
005490,POSCO,338000,344500,6500,1.92,596735,207503311000
010950,S-Oil,102000,105000,3000,2.94,326669,34217584500
010955,S-Oil우,60300,61200,900,1.49,8690,531638500
034120,SBS,43300,43800,500,1.15,104715,4572412150
101060,SBS미디어홀딩스,2075,2110,35,1.69,197241,413775350
005090,SGC에너지,48800,48850,50,0.1,51744,2528509200
001380,SG글로벌,3215,3350,135,4.2,662204,2205224495
004060,SG세계물산,787,800,13,1.65,799368,638772738
002360,SH에너지화학,1135,1150,15,1.32,768345,883934525
009160,SIMPAC,4850,5400,550,11.34,3723748,20247285055
123700,SJM,5600,5600,0,0.0,73035,407624190
025530,SJM홀딩스,4900,4985,85,1.73,69925,346705125
034730,SK,270000,278000,8000,2.96,122937,34002489000
011790,SKC,160000,159500,-500,-0.31,202630,32291179000
018670,SK가스,115000,114500,-500,-0.43,6385,735032500
001740,SK네트웍스,5810,5880,70,1.2,453187,2669833170
001745,SK네트웍스우,114000,118000,4000,3.51,89,10414500
006120,SK디스커버리,49600,49450,-150,-0.3,48131,2384301450
006125,SK디스커버리우,39550,39500,-50,-0.13,3980,157077600
210980,SK디앤디,36200,36350,150,0.41,33753,1227745000
068400,SK렌터카,13650,14250,600,4.4,513855,7398959050
302440,SK바이오사이언스,160500,155500,-5000,-3.12,547174,85960052000
326030,SK바이오팜,128000,127500,-500,-0.39,181619,23159620500
361610,SK아이이테크놀로지,209000,210000,1000,0.48,423982,88856495500
03473K,SK우,247000,250500,3500,1.42,2397,600655000
096770,SK이노베이션,272000,272000,0,0.0,411181,111870476000
096775,SK이노베이션우,178500,178500,0,0.0,4541,812705000
001510,SK증권,992,1005,13,1.31,3678065,3688380219
001515,SK증권우,4575,4765,190,4.15,19327,91477150
285130,SK케미칼,247000,247500,500,0.2,38103,9422546500
28513K,SK케미칼우,109000,110000,1000,0.92,6145,670188000
017670,SK텔레콤,322000,326500,4500,1.4,179022,58380052000
000660,SK하이닉스,119500,120000,500,0.42,2477201,298968546740
064960,SNT모티브,67000,68100,1100,1.64,39093,2649218500
100840,SNT에너지,22650,23400,750,3.31,83635,1949767350
003570,SNT중공업,10300,10550,250,2.43,62181,655857450
036530,SNT홀딩스,21050,20750,-300,-1.43,12530,259626050
005610,SPC삼립,80900,81300,400,0.49,8868,725051300
011810,STX,8050,8260,210,2.61,130343,1087694290
077970,STX엔진,13350,13650,300,2.25,65441,898207000
071970,STX중공업,7840,8180,340,4.34,1482823,12086936820
002820,SUNL,6520,6750,230,3.53,110485,742539890
084870,TBH글로벌,2780,2720,-60,-2.16,41227,112647025
002710,TCC스틸,5620,5650,30,0.53,1304433,7439215220
002900,TYM,2000,2005,5,0.25,1318798,2653300560
024070,WISCOM,4890,5010,120,2.45,287933,1442673855
037270,YGPLUS,5850,5910,60,1.03,294374,1739279580
000500,가온전선,33700,36200,2500,7.42,275119,9728339800
000860,강남제비스코,28950,29600,650,2.25,20795,609971700
035250,강원랜드,25450,25800,350,1.38,593107,15289413550
011420,갤럭시아에스엠,2070,1945,-125,-6.04,997860,1944339815
002100,경농,16100,16000,-100,-0.62,54667,877018250
009450,경동나비엔,64400,67200,2800,4.35,166153,11179362300
267290,경동도시가스,24200,24250,50,0.21,9854,238772850
012320,경동인베스트,39550,40150,600,1.52,6190,246303500
000050,경방,14050,14100,50,0.36,5769,81113700
214390,경보제약,13550,13400,-150,-1.11,195287,2618816450
012610,경인양행,6830,6870,40,0.59,133589,920019160
009140,경인전자,33050,33800,750,2.27,13203,436921800
013580,계룡건설,35200,35650,450,1.28,30593,1088338250
012200,계양전기,4885,4860,-25,-0.51,273716,1335662680
012205,계양전기우,8070,8130,60,0.74,4280,34483360
002140,고려산업,4110,4235,125,3.04,176332,741219140
010130,고려아연,426500,429000,2500,0.59,37423,16115343000
002240,고려제강,23100,24100,1000,4.33,69142,1658027850
009290,광동제약,8780,8860,80,0.91,128176,1138940310
017040,광명전기,3465,3605,140,4.04,17958668,66763608515
017900,광전자,3000,3055,55,1.83,353442,1078163125
037710,광주신세계,183500,185000,1500,0.82,1477,271695000
030610,교보증권,8380,8560,180,2.15,83464,711586670
339770,교촌에프앤비,20450,20200,-250,-1.22,136657,2780817900
007690,국도화학,79900,81600,1700,2.13,102949,8533203700
005320,국동,3915,3935,20,0.51,812390,3193984555
001140,국보,1280,1305,25,1.95,701504,914406055
002720,국제약품,7620,7680,60,0.79,75705,579779460
083420,그린케미칼,11350,11500,150,1.32,143906,1663966750
014530,극동유화,4785,4820,35,0.73,154774,744309765
014280,금강공업,8820,9410,590,6.69,3119801,29863795800
014285,금강공업우,22400,22950,550,2.46,64105,1456211750
008870,금비,83000,83400,400,0.48,1641,136341200
001570,금양,5170,5230,60,1.16,137821,716668540
002990,금호건설,13200,13550,350,2.65,400559,5387054600
002995,금호건설우,35850,36650,800,2.23,4397,159348200
011780,금호석유,216000,221000,5000,2.31,506197,112905232500
011785,금호석유우,121000,124500,3500,2.89,55942,6979272000
214330,금호에이치티,2415,2550,135,5.59,4447393,11068393730
001210,금호전기,3000,3130,130,4.33,78310,242219520
073240,금호타이어,6980,7040,60,0.86,607247,4259458160
092440,기신정기,5350,5360,10,0.19,90242,486181910
000270,기아,86000,87700,1700,1.98,1534082,134927756000
024110,기업은행,10050,10250,200,1.99,1205955,12349688450
013700,까뮤이앤씨,2960,2950,-10,-0.34,1768206,5266453960
004540,깨끗한나라,6550,6540,-10,-0.15,236612,1559064780
004545,깨끗한나라우,31900,32000,100,0.31,1456,46350600
001260,남광토건,15950,16200,250,1.57,103012,1674771400
008350,남선알미늄,4030,4200,170,4.22,32525957,138316953310
008355,남선알미우,42550,55300,12750,29.96,97292,5151772050
004270,남성,3545,3730,185,5.22,402211,1491278035
003920,남양유업,680000,686000,6000,0.88,2628,1810779000
003925,남양유업우,391000,402500,11500,2.94,511,204592000
025860,남해화학,9610,9730,120,1.25,372505,3614608450
005720,넥센,5190,5220,30,0.58,53270,278624320
005725,넥센우,3700,3695,-5,-0.14,4730,17368500
002350,넥센타이어,9230,9340,110,1.19,253384,2373691480
002355,넥센타이어1우B,3775,3910,135,3.58,7973,30862280
003580,넥스트사이언스,17300,17750,450,2.6,2139038,38362319350
251270,넷마블,133500,135500,2000,1.5,173417,23447429000
090350,노루페인트,12000,12200,200,1.67,190659,2318964850
090355,노루페인트우,28200,28200,0,0.0,10981,304083050
000320,노루홀딩스,13950,14150,200,1.43,23799,333961100
000325,노루홀딩스우,63400,60900,-2500,-3.94,11375,695485100
006280,녹십자,321500,325500,4000,1.24,68906,22643841500
005250,녹십자홀딩스,33350,34300,950,2.85,872236,30522476850
005257,녹십자홀딩스2우,80800,82400,1600,1.98,1016,83348700
004370,농심,307000,309000,2000,0.65,22304,6886022500
072710,농심홀딩스,79800,79400,-400,-0.5,6154,489477400
058730,다스코,6480,6730,250,3.86,558834,3709159210
023590,다우기술,27450,27450,0,0.0,91827,2527247350
019680,대교,5170,5140,-30,-0.58,384176,1961078680
019685,대교우B,3895,3865,-30,-0.77,186332,726419670
006370,대구백화점,13700,13350,-350,-2.55,13554,181337050
008060,대덕,8040,8080,40,0.5,191510,1544897320
00806K,대덕1우,13350,13850,500,3.75,21720,298526850
353200,대덕전자,15550,15650,100,0.64,381666,5975442450
35320K,대덕전자1우,15400,15450,50,0.32,25390,390396700
000490,대동,10750,10800,50,0.47,166860,1804164000
008110,대동전자,7370,7410,40,0.54,22350,165907950
005750,대림BCo,8660,8960,300,3.46,483566,4338638670
006570,대림통상,4285,4340,55,1.28,35661,154341715
001680,대상,26600,26600,0,0.0,138640,3705545450
001685,대상우,20800,20900,100,0.48,1863,38795000
084690,대상홀딩스,11100,11200,100,0.9,98740,1111351750
084695,대상홀딩스우,13450,13700,250,1.86,7784,105576850
128820,대성산업,5090,5160,70,1.38,158774,824124200
117580,대성에너지,6670,6690,20,0.3,60989,408481860
016710,대성홀딩스,37800,37400,-400,-1.06,42624,1599753750
003540,대신증권,18650,18750,100,0.54,54568,1021822800
003547,대신증권2우B,16400,16450,50,0.3,25300,414009650
003545,대신증권우,16800,16950,150,0.89,47943,809749750
009190,대양금속,6010,5950,-60,-1.0,2965517,17776469440
014160,대영포장,3455,3530,75,2.17,102715953,383557184870
047040,대우건설,7350,7400,50,0.68,3142133,23195197870
009320,대우부품,2500,2580,80,3.2,217270,555132900
042660,대우조선해양,32700,33350,650,1.99,517728,17362270350
003090,대웅,37800,38450,650,1.72,479014,18449407500
069620,대웅제약,157500,158000,500,0.32,64193,10181786500
000430,대원강업,3960,4085,125,3.16,150744,610727530
006340,대원전선,2715,2725,10,0.37,3383604,9284496925
006345,대원전선우,5170,5380,210,4.06,119359,642753640
003220,대원제약,16450,16500,50,0.3,77462,1286915000
024890,대원화성,2885,2885,0,0.0,204889,594635830
002880,대유에이텍,1340,1340,0,0.0,1185981,1598510120
000300,대유플러스,1540,1535,-5,-0.32,1478560,2264409540
012800,대창,2430,2465,35,1.44,1937177,4805535140
015230,대창단조,8950,8900,-50,-0.56,48335,430206040
001070,대한방직,43800,44000,200,0.46,363,15929000
006650,대한유화,225500,228000,2500,1.11,38657,8839342500
001440,대한전선,2980,2915,-65,-2.18,13026309,38117408110
084010,대한제강,22250,22450,200,0.9,435472,9951220500
001790,대한제당,3195,3230,35,1.1,269219,870866820
001795,대한제당우,4030,4020,-10,-0.25,92162,371517160
001130,대한제분,170000,171500,1500,0.88,5460,930939000
003490,대한항공,30300,30500,200,0.66,1768542,53949700500
003495,대한항공우,40550,40900,350,0.86,6389,261276800
005880,대한해운,3415,3415,0,0.0,1879038,6446976375
003830,대한화섬,158000,159000,1000,0.63,1107,178654000
016090,대현,2960,3040,80,2.7,515631,1549965870
069460,대호에이엘,4215,4210,-5,-0.12,247921,1044344150
192080,더블유게임즈,60500,61400,900,1.49,84597,5188834000
012510,더존비즈온,93000,93700,700,0.75,128860,12017987000
004830,덕성,18700,18300,-400,-2.14,413268,7637534800
004835,덕성우,28300,28000,-300,-1.06,19505,550711700
024900,덕양산업,3860,3900,40,1.04,264684,1033687070
145720,덴티움,61100,62200,1100,1.8,30401,1894816900
002150,도화엔지니어링,9050,9080,30,0.33,65520,592995650
001230,동국제강,21000,21200,200,0.95,1284541,27541259450
023450,동남합성,58600,61500,2900,4.95,8309,499107800
004140,동방,6770,7310,540,7.98,10210429,73033892450
007590,동방아그로,8220,8350,130,1.58,50960,422917480
005960,동부건설,13900,14100,200,1.44,196970,2778274550
005965,동부건설우,55100,52700,-2400,-4.36,7593,399919600
026960,동서,29700,29900,200,0.67,146171,4326783900
002210,동성제약,10150,10200,50,0.49,70885,719847050
102260,동성케미컬,6190,6160,-30,-0.48,143481,884050200
000640,동아쏘시오홀딩스,125500,126500,1000,0.8,12357,1555717000
170900,동아에스티,83500,83900,400,0.48,25567,2141776700
028100,동아지질,20650,21050,400,1.94,66459,1392088600
282690,동아타이어,12100,12250,150,1.24,33183,403072000
001520,동양,2100,2110,10,0.48,3001798,6339703175
001527,동양2우B,21400,21150,-250,-1.17,4081,86323750
001529,동양3우B,57500,57400,-100,-0.17,2686,153071000
084670,동양고속,24150,24400,250,1.04,7068,172332050
082640,동양생명,5410,5440,30,0.55,92771,505018300
001525,동양우,11300,11350,50,0.44,20799,233689300
008970,동양철관,1615,1635,20,1.24,1110032,1817254300
092780,동양피스톤,6680,6570,-110,-1.65,594707,3935846540
049770,동원FB,220500,218500,-2000,-0.91,6411,1402361000
018500,동원금속,1025,1055,30,2.93,289664,305457595
006040,동원산업,254500,258000,3500,1.38,7308,1892270500
030720,동원수산,9670,9980,310,3.21,93967,935772020
014820,동원시스템즈,42700,45450,2750,6.44,112873,5057378700
014825,동원시스템즈우,36000,37200,1200,3.33,974,36130250
163560,동일고무벨트,9580,9730,150,1.57,22361,216871890
004890,동일산업,102000,102500,500,0.49,1533,156922000
002690,동일제강,4480,4685,205,4.58,133508,616212590
000020,동화약품,14950,15050,100,0.67,160334,2407544150
000150,두산,100500,105500,5000,4.98,111651,11625555500
000157,두산2우B,146000,143500,-2500,-1.71,47177,7126730000
241560,두산밥캣,48600,49600,1000,2.06,197475,9799057850
000155,두산우,68000,69500,1500,2.21,36066,2506024500
042670,두산인프라코어,14450,14450,0,0.0,0,0
034020,두산중공업,26100,25500,-600,-2.3,9194495,239126168300
336260,두산퓨얼셀,46000,47150,1150,2.5,514007,24140445600
33626K,두산퓨얼셀1우,16200,16450,250,1.54,37958,622298500
33626L,두산퓨얼셀2우B,21400,21300,-100,-0.47,18876,405545150
016740,두올,4650,4790,140,3.01,255214,1222477755
192650,드림텍,12250,12900,650,5.31,1334876,16995363500
024090,디씨엠,15200,15500,300,1.97,97116,1475989450
003160,디아이,8710,8680,-30,-0.34,266405,2315403000
092200,디아이씨,7180,7050,-130,-1.81,545041,3873032240
013570,디와이,5970,6020,50,0.84,90091,540788330
210540,디와이파워,15900,16100,200,1.26,29163,468221750
007340,디티알오토모티브,39050,39050,0,0.0,23074,903131200
026890,디피씨,13900,13950,50,0.36,356158,4983113300
115390,락앤락,13600,13950,350,2.57,58959,821029950
032350,롯데관광개발,19100,19750,650,3.4,465051,9046546350
330590,롯데리츠,5980,5970,-10,-0.17,426179,2546365640
000400,롯데손해보험,1890,1910,20,1.06,211904,405324445
023530,롯데쇼핑,108000,111000,3000,2.78,92866,10166112000
004000,롯데정밀화학,67000,67900,900,1.34,176662,11997121800
286940,롯데정보통신,39400,39500,100,0.25,20588,815838350
280360,롯데제과,138000,139500,1500,1.09,6749,938515500
004990,롯데지주,37700,38350,650,1.72,205234,7835817600
00499K,롯데지주우,59000,59500,500,0.85,300,17783600
005300,롯데칠성,137000,137000,0,0.0,30384,4180257000
005305,롯데칠성우,76300,77100,800,1.05,1271,97749300
011170,롯데케미칼,253000,255000,2000,0.79,89984,22924487500
002270,롯데푸드,431000,449000,18000,4.18,3976,1771000000
071840,롯데하이마트,33800,33950,150,0.44,43781,1488236350
027740,마니커,709,715,6,0.85,1521278,1084359194
204320,만도,61700,62100,400,0.65,222078,13806387100
001080,만호제강,22100,22500,400,1.81,3290,73498450
088980,맥쿼리인프라,12350,12350,0,0.0,394964,4870289500
094800,맵스리얼티1,4655,4650,-5,-0.11,32106,149532355
138040,메리츠금융지주,22300,22000,-300,-1.35,169122,3760358650
008560,메리츠증권,4650,4795,145,3.12,1678094,8001466430
000060,메리츠화재,20500,20650,150,0.73,279114,5825878800
090370,메타랩스,1230,1250,20,1.63,544982,676068825
017180,명문제약,5640,5710,70,1.24,154460,881047180
009900,명신산업,30300,30050,-250,-0.83,345067,10418230650
012690,모나리자,5280,5260,-20,-0.38,270238,1422821610
005360,모나미,5660,5840,180,3.18,258554,1500871990
204210,모두투어리츠,4490,4575,85,1.89,11509,52364680
009680,모토닉,11400,11600,200,1.75,27046,311545650
009580,무림PP,5450,5470,20,0.37,300111,1655803680
009200,무림페이퍼,3355,3430,75,2.24,228816,781444905
033920,무학,8140,8270,130,1.6,27761,230119520
008420,문배철강,5070,5130,60,1.18,208850,1072666270
025560,미래산업,18400,18950,550,2.99,35733,672900900
007120,미래아이앤지,670,662,-8,-1.19,934974,622199697
357250,미래에셋맵스리츠,5010,5000,-10,-0.2,65829,328964755
085620,미래에셋생명,4115,4160,45,1.09,75469,311301715
006800,미래에셋증권,9030,9180,150,1.66,804743,7369651650
00680K,미래에셋증권2우B,4590,4615,25,0.54,450382,2081017975
006805,미래에셋증권우,6300,6330,30,0.48,51916,329773790
002840,미원상사,214000,214500,500,0.23,1884,401359500
268280,미원에스씨,190500,191000,500,0.26,3838,730634500
107590,미원홀딩스,125000,125500,500,0.4,1608,200881000
134380,미원화학,80000,80000,0,0.0,384,30691000
003650,미창석유,83400,83900,500,0.6,935,77793100
155900,바다로19호,2725,2725,0,0.0,9858,26884990
003610,방림,2490,2505,15,0.6,89872,224894750
001340,백광산업,6680,6660,-20,-0.3,556480,3733265510
035150,백산,11050,11000,-50,-0.45,1010172,11366238050
002410,범양건영,7300,9490,2190,30.0,25355921,220955652160
096300,베트남개발1,233,234,1,0.43,104707,24397840
007210,벽산,4765,4835,70,1.47,4430107,21357021065
002760,보락,2210,2235,25,1.13,240067,535852495
003850,보령제약,22050,22400,350,1.59,108329,2430053500
000890,보해양조,1130,1160,30,2.65,1454534,1675922730
003000,부광약품,20200,20250,50,0.25,362966,7369632750
001270,부국증권,24850,24800,-50,-0.2,5627,139780450
001275,부국증권우,22600,22600,0,0.0,622,14048100
026940,부국철강,4780,5420,640,13.39,13895141,75812654220
015350,부산가스,56700,56800,100,0.18,4105,234427400
011390,부산산업,140000,142500,2500,1.79,7006,1001849500
005030,부산주공,620,636,16,2.58,387990,246142179
002070,비비안,3900,3985,85,2.18,625518,2468712260
100220,비상교육,14150,14150,0,0.0,420124,5940698200
030790,비케이탑스,9900,9940,40,0.4,128839,1289694750
005180,빙그레,60900,62100,1200,1.97,35204,2174023800
003960,사조대림,26100,26750,650,2.49,53815,1429577700
008040,사조동아원,1355,1390,35,2.58,590689,819730970
007160,사조산업,62700,70900,8200,13.08,285537,20020884600
014710,사조씨푸드,6720,6670,-50,-0.74,554740,3743810580
006090,사조오양,12350,12600,250,2.02,249409,3186666750
001470,삼부토건,3305,3865,560,16.94,109159363,421318397240
006400,삼성SDI,736000,730000,-6000,-0.82,227623,166195424000
006405,삼성SDI우,456000,452000,-4000,-0.88,7283,3301460000
006660,삼성공조,24750,26200,1450,5.86,400572,10309302250
028260,삼성물산,128000,131000,3000,2.34,256256,33501028000
02826K,삼성물산우B,126500,128500,2000,1.58,3495,449546500
207940,삼성바이오로직스,857000,870000,13000,1.52,58273,50456867000
032830,삼성생명,75600,77100,1500,1.98,262959,20264597200
018260,삼성에스디에스,182000,184000,2000,1.1,83495,15341293000
028050,삼성엔지니어링,23000,22850,-150,-0.65,1739374,39838701200
009150,삼성전기,182000,186500,4500,2.47,571323,106563641000
009155,삼성전기우,105500,106500,1000,0.95,11142,1193275000
005930,삼성전자,79400,79700,300,0.38,9768108,779142132784
005935,삼성전자우,72200,72300,100,0.14,1019946,73968240525
001360,삼성제약,7300,7470,170,2.33,2365642,17578174000
010140,삼성중공업,6550,6660,110,1.68,5636804,37848877130
010145,삼성중공우,298500,300500,2000,0.67,332,100082000
016360,삼성증권,42850,43050,200,0.47,183847,7944431250
068290,삼성출판사,41800,42150,350,0.84,54133,2297549950
029780,삼성카드,34650,34700,50,0.14,201219,6989430600
000810,삼성화재,209500,213000,3500,1.67,45214,9617232000
000815,삼성화재우,161500,164500,3000,1.86,7513,1233285500
006110,삼아알미늄,12950,13800,850,6.56,689555,9466862000
145990,삼양사,61600,61900,300,0.49,17507,1085505800
145995,삼양사우,47300,47800,500,1.06,497,23746800
003230,삼양식품,88500,89000,500,0.56,17465,1557846300
002170,삼양통상,72900,73700,800,1.1,5183,381618300
272550,삼양패키징,27750,27650,-100,-0.36,11017,304544000
000070,삼양홀딩스,101500,102000,500,0.49,15445,1583224500
000075,삼양홀딩스우,70100,70100,0,0.0,767,53423000
002810,삼영무역,16550,16400,-150,-0.91,23156,379713750
005680,삼영전자,13450,13400,-50,-0.37,41864,559711600
003720,삼영화학,3430,3300,-130,-3.79,716942,2406737305
023000,삼원강재,3520,3585,65,1.85,74007,264074970
004380,삼익THK,13100,13150,50,0.38,20136,263824250
002450,삼익악기,1835,1875,40,2.18,304559,569613920
004440,삼일씨엔에스,13650,14200,550,4.03,100214,1413870500
000520,삼일제약,9180,9290,110,1.2,30218,279130120
009770,삼정펄프,33700,34350,650,1.93,1325,44960500
005500,삼진제약,27150,27200,50,0.18,39570,1072677350
004690,삼천리,90900,91700,800,0.88,4289,392588900
010960,삼호개발,6150,6520,370,6.02,360878,2314881880
004450,삼화왕관,45750,45200,-550,-1.2,758,34384150
009470,삼화전기,35200,36000,800,2.27,46833,1671084700
011230,삼화전자,3920,4110,190,4.85,104828,429897085
001820,삼화콘덴서,61500,61600,100,0.16,79518,4894375500
000390,삼화페인트,12000,12000,0,0.0,91729,1098471450
001290,상상인증권,1330,1320,-10,-0.75,214253,283392375
041650,상신브레이크,4740,4750,10,0.21,134031,641081535
075180,새론오토모티브,7030,7090,60,0.85,44373,311141090
007540,샘표,56500,57500,1000,1.77,8092,463718300
248170,샘표식품,58800,60400,1600,2.72,26367,1591596900
007860,서연,15650,15600,-50,-0.32,272770,4258779800
200880,서연이화,8700,8790,90,1.03,138034,1215159910
017390,서울가스,139500,140500,1000,0.72,1631,228265000
004410,서울식품,448,465,17,3.79,210523646,99859947112
004415,서울식품우,5500,5540,40,0.73,36561,202666700
021050,서원,2660,3070,410,15.41,36961403,112317824470
008490,서흥,53700,53900,200,0.37,30055,1624771500
007610,선도전기,4160,4405,245,5.89,665007,2903045420
136490,선진,16200,16300,100,0.62,58644,961527700
014910,성문전자,2510,2605,95,3.78,203927,518373220
014915,성문전자우,9990,10250,260,2.6,3992,40737850
003080,성보화학,4950,5000,50,1.01,93251,464313815
004980,성신양회,12050,12150,100,0.83,170095,2061197700
004985,성신양회우,18000,18050,50,0.28,19103,344262400
011300,성안,787,787,0,0.0,0,0
000180,성창기업지주,2800,2915,115,4.11,838816,2457431615
002420,세기상사,6160,6160,0,0.0,0,0
004360,세방,14200,14300,100,0.7,81874,1169584800
004365,세방우,8240,8280,40,0.49,4953,40620590
004490,세방전지,91300,92900,1600,1.75,58074,5415880000
001430,세아베스틸,30700,31050,350,1.14,173981,5455978900
306200,세아제강,105000,107500,2500,2.38,12002,1287057000
003030,세아제강지주,79200,80500,1300,1.64,17914,1446149400
019440,세아특수강,16700,16750,50,0.3,7404,123861750
058650,세아홀딩스,101500,102000,500,0.49,1497,152904500
013000,세우글로벌,2470,2470,0,0.0,0,0
091090,세원이앤씨,2240,2235,-5,-0.22,1655786,3763222840
021820,세원정공,8090,8090,0,0.0,0,0
067830,세이브존IC,3720,3625,-95,-2.55,134056,489170535
033530,세종공업,9110,9420,310,3.4,364865,3408816050
075580,세진중공업,6920,7120,200,2.89,249076,1762833120
027970,세하,2295,2320,25,1.09,5073582,12030355520
145210,세화아이엠씨,866,852,-14,-1.62,2734309,2325533098
308170,센트랄모텍,26750,26900,150,0.56,44714,1194902350
012600,센트럴인사이트,2490,2490,0,0.0,0,0
068270,셀트리온,262000,262500,500,0.19,301660,79744159500
336370,솔루스첨단소재,51300,52600,1300,2.53,478595,24907453400
33637K,솔루스첨단소재1우,16750,16950,200,1.19,8303,139962400
33637L,솔루스첨단소재2우B,29100,29700,600,2.06,2783,82472850
248070,솔루엠,27650,28000,350,1.27,495383,13865517850
004430,송원산업,18950,19050,100,0.53,118147,2258899100
017550,수산중공업,4005,4005,0,0.0,781492,3145834390
053210,스카이라이프,10450,10600,150,1.44,123476,1309855400
134790,시디즈,73000,72300,-700,-0.96,2820,203634300
016590,신대양제지,86000,84700,-1300,-1.51,9813,839500900
029530,신도리코,31900,32400,500,1.57,12501,403016200
004970,신라교역,12400,12450,50,0.4,39185,485240450
011930,신성이엔지,2780,2770,-10,-0.36,1162728,3236551125
005390,신성통상,3290,3215,-75,-2.28,2344789,7725829540
004170,신세계,272000,275000,3000,1.1,58427,16007824000
035510,신세계IC,176500,177000,500,0.28,8357,1485325500
034300,신세계건설,45150,47200,2050,4.54,51661,2416304500
031430,신세계인터내셔날,195500,199500,4000,2.05,25967,5175117500
031440,신세계푸드,97900,99700,1800,1.84,9446,939907700
006880,신송홀딩스,5560,5840,280,5.04,123049,710042830
005800,신영와코루,116500,115500,-1000,-0.86,1212,140352500
001720,신영증권,63200,64000,800,1.27,4799,305411400
001725,신영증권우,64100,64300,200,0.31,852,54639800
009270,신원,1795,1800,5,0.28,486434,876838685
009275,신원우,50300,51200,900,1.79,195,9814600
002700,신일전자,1960,2070,110,5.61,8847699,18136097390
019170,신풍제약,67100,65300,-1800,-2.68,1424669,93760219800
019175,신풍제약우,88300,85100,-3200,-3.62,44731,3844099200
002870,신풍제지,3510,3560,50,1.42,1143056,4153547585
293940,신한알파리츠,7850,7900,50,0.64,73330,576597220
055550,신한지주,38200,39150,950,2.49,1164432,45646938050
001770,신화실업,27300,27950,650,2.38,17759,486891700
004080,신흥,15400,15050,-350,-2.27,45726,688906000
102280,쌍방울,817,838,21,2.57,20456292,17144168981
003410,쌍용CE,8060,8100,40,0.5,872918,7077051660
003620,쌍용차,2770,2770,0,0.0,0,0
004770,써니전자,3475,3540,65,1.87,273175,965743610
015540,쎌마테라퓨틱스,6410,6410,0,0.0,0,0
004920,씨아이테크,1310,1275,-35,-2.67,241681,310189940
112610,씨에스윈드,74800,76500,1700,2.27,226080,17191954900
008700,아남전자,2810,2840,30,1.07,375625,1065000725
002790,아모레G,60800,61600,800,1.32,125564,7711130000
00279K,아모레G3우전환,43700,43650,-50,-0.11,4222,183308750
002795,아모레G우,23500,23650,150,0.64,10873,256087400
090430,아모레퍼시픽,239500,241500,2000,0.84,97100,23229677500
090435,아모레퍼시픽우,85000,85300,300,0.35,31859,2711159500
002030,아세아,123500,126000,2500,2.02,3130,390588000
183190,아세아시멘트,122000,123500,1500,1.23,16405,2046159500
002310,아세아제지,53800,53600,-200,-0.37,18132,973762200
012170,아센디오,2700,2755,55,2.04,57524,157075280
267850,아시아나IDT,24350,24350,0,0.0,0,0
020560,아시아나항공,17200,17200,0,0.0,0,0
122900,아이마켓코리아,10250,10400,150,1.46,207436,2230021750
010780,아이에스동서,56800,56900,100,0.18,46953,2690438000
001780,알루코,4900,4990,90,1.84,1172363,5877989375
018250,애경산업,25750,26200,450,1.75,49633,1295752400
161000,애경유화,11100,11300,200,1.8,99788,1127304450
011090,에넥스,3045,2995,-50,-1.64,1998328,6085972815
005850,에스엘,32650,32600,-50,-0.15,145654,4800744900
012750,에스원,81400,82000,600,0.74,39636,3251143000
023960,에쓰씨엔지니어링,5470,5840,370,6.76,2805571,16427333010
298690,에어부산,3575,3575,0,0.0,0,0
140910,에이리츠,13450,13400,-50,-0.37,93126,1213869400
078520,에이블씨엔씨,9200,9330,130,1.41,191361,1775456250
015260,에이엔피,1585,1625,40,2.52,127080,204214240
007460,에이프로젠MED,2240,2280,40,1.79,2392135,5438198765
003060,에이프로젠제약,1240,1265,25,2.02,1952158,2460254230
244920,에이플러스에셋,10850,11650,800,7.37,798344,9027786000
036570,엔씨소프트,800000,772000,-28000,-3.5,153684,119023908000
138250,엔에스쇼핑,13200,13200,0,0.0,36339,477885050
380440,엔에이치스팩19호,2185,2220,35,1.6,460837,1017728170
085310,엔케이,1320,1355,35,2.65,624887,834982945
009810,엔케이물산,919,919,0,0.0,541172,497176946
900140,엘브이엠씨홀딩스,3710,3655,-55,-1.48,271632,998695675
097520,엠씨넥스,45250,45200,-50,-0.11,118886,5390235500
014440,영보화학,4980,5170,190,3.82,136737,698884720
111770,영원무역,40200,41100,900,2.24,182237,7404265850
009970,영원무역홀딩스,48300,48150,-150,-0.31,12750,610529000
003520,영진약품,5750,5780,30,0.52,486485,2813882440
000670,영풍,625000,631000,6000,0.96,1318,830272000
006740,영풍제지,8300,8390,90,1.08,2749795,23673692280
012280,영화금속,2320,2260,-60,-2.59,2611510,6053785405
012160,영흥,1200,1220,20,1.67,515031,624194440
015360,예스코홀딩스,37750,37450,-300,-0.79,853,31917600
007310,오뚜기,524000,529000,5000,0.95,3661,1935525000
002630,오리엔트바이오,1390,1335,-55,-3.96,1706008,2286798085
271560,오리온,117000,118000,1000,0.85,40925,4816578000
001800,오리온홀딩스,15950,16450,500,3.13,119553,1946693750
070960,용평리조트,5760,5730,-30,-0.52,139805,803720010
316140,우리금융지주,11150,11250,100,0.9,1929374,21763544000
033660,우리금융캐피탈,11650,11650,0,0.0,14196,165402800
118000,우리들휴브레인,2020,2090,70,3.47,5827440,12154836645
010050,우리종금,1005,1000,-5,-0.5,3853939,3871470109
006980,우성사료,34900,35800,900,2.58,26504,949560100
017370,우신시스템,5760,5640,-120,-2.08,149038,850525760
105840,우진,9070,9130,60,0.66,2780861,26386148640
010400,우진아이엔에스,8900,8790,-110,-1.24,9158,80518900
049800,우진플라임,4150,4175,25,0.6,54102,224518390
016880,웅진,2555,2515,-40,-1.57,769767,1947768385
095720,웅진씽크빅,3970,4015,45,1.13,452401,1811984220
005820,원림,26450,26550,100,0.38,9215,241766750
010600,웰바이오텍,2955,3000,45,1.52,626442,1887371405
008600,윌비스,2430,2420,-10,-0.41,919860,2236621800
033270,유나이티드제약,54800,54700,-100,-0.18,169903,9330128000
014830,유니드,74900,75200,300,0.4,24866,1870552100
000910,유니온,7680,7830,150,1.95,141688,1114161280
047400,유니온머티리얼,3820,3905,85,2.23,284214,1108741190
011330,유니켐,1630,1645,15,0.92,169615,279087535
077500,유니퀘스트,11350,11350,0,0.0,95087,1080026650
002920,유성기업,3845,3935,90,2.34,166644,651559810
000700,유수홀딩스,6600,6710,110,1.67,30432,204141280
003470,유안타증권,4420,4510,90,2.04,476511,2148105370
003475,유안타증권우,4615,4655,40,0.87,19981,92886775
011690,유양디앤유,2440,2440,0,0.0,0,0
072130,유엔젤,4840,4850,10,0.21,731246,3589418370
000220,유유제약,10900,10950,50,0.46,937198,10247730000
000225,유유제약1우,15000,15100,100,0.67,43080,643786000
000227,유유제약2우B,28800,28950,150,0.52,3137,90632150
001200,유진투자증권,4295,4350,55,1.28,224055,973439765
000100,유한양행,61800,62200,400,0.65,112652,7023544600
000105,유한양행우,60100,60800,700,1.16,836,50968700
003460,유화증권,2790,2800,10,0.36,109728,307027100
003465,유화증권우,2830,2820,-10,-0.35,3986,11235270
008730,율촌화학,20950,21000,50,0.24,54084,1142265650
008250,이건산업,14150,14650,500,3.53,466747,6772071650
025820,이구산업,4155,4225,70,1.68,313534,1329821770
214320,이노션,63500,64100,600,0.94,20648,1320341700
088260,이리츠코크렙,5990,6000,10,0.17,112186,671905100
139480,이마트,152000,154500,2500,1.64,119802,18522621000
007660,이수페타시스,3840,3800,-40,-1.04,268753,1029260295
005950,이수화학,11900,12000,100,0.84,174843,2092913950
015020,이스타코,4970,4625,-345,-6.94,7054310,32784240025
093230,이아이디,589,582,-7,-1.19,50453604,29604872756
074610,이엔플러스,4070,4080,10,0.25,363550,1484180980
102460,이연제약,71500,71700,200,0.28,1494438,107166578500
084680,이월드,3310,3435,125,3.78,1533173,5265226005
350520,이지스레지던스리츠,5030,5040,10,0.2,80040,401998400
334890,이지스밸류리츠,5660,5610,-50,-0.88,57380,322638850
000760,이화산업,21300,20800,-500,-2.35,3625,75758700
014990,인디에프,1430,1440,10,0.7,143335,205750715
101140,인바이오젠,4085,4460,375,9.18,9660552,42651358545
006490,인스코비,3110,3235,125,4.02,8109654,26564437450
023800,인지컨트롤스,17150,17050,-100,-0.58,76269,1310146250
034590,인천도시가스,28250,28850,600,2.12,3104,87833150
129260,인터지스,4045,4080,35,0.87,131942,538437030
023810,인팩,14350,14350,0,0.0,104021,1499761000
249420,일동제약,15700,15800,100,0.64,51286,810772000
000230,일동홀딩스,14050,13950,-100,-0.71,7667,106941550
013360,일성건설,4070,4400,330,8.11,7261267,31000196685
003120,일성신약,83500,83100,-400,-0.48,3311,276256500
003200,일신방직,98800,101000,2200,2.23,7729,774409600
007110,일신석재,2420,2445,25,1.03,1244528,3055062355
007570,일양약품,36000,35850,-150,-0.42,133233,4798047250
007575,일양약품우,37000,37350,350,0.95,1352,50111100
008500,일정실업,20000,19950,-50,-0.25,2003,39251550
081000,일진다이아,41200,42700,1500,3.64,250942,10780995000
020760,일진디스플,4265,4340,75,1.76,92564,398601235
020150,일진머티리얼즈,71000,71200,200,0.28,150231,10678042400
103590,일진전기,5220,5410,190,3.64,294911,1576046370
015860,일진홀딩스,5530,5670,140,2.53,136678,774145090
226320,잇츠한불,25450,25800,350,1.38,24472,629147350
317400,자이에스앤디,10700,10700,0,0.0,121433,1298315000
033240,자화전자,20800,20650,-150,-0.72,123745,2547302750
000950,전방,36600,37650,1050,2.87,8450,311948500
348950,제이알글로벌리츠,5290,5300,10,0.19,418713,2214076930
194370,제이에스코퍼레이션,18800,18950,150,0.8,49497,938020350
025620,제이준코스메틱,1575,1825,250,15.87,22569147,43845677310
036420,제이콘텐트리,43800,45500,1700,3.88,113904,5156040050
030000,제일기획,24450,24850,400,1.64,172743,4257780350
271980,제일약품,45100,46100,1000,2.22,114682,5223274200
001560,제일연마,8310,8450,140,1.68,14766,123251890
002620,제일파마홀딩스,23000,23200,200,0.87,12283,283798950
006220,제주은행,6850,7020,170,2.48,114167,795567050
089590,제주항공,22900,23050,150,0.66,190147,4350300050
004910,조광페인트,8380,8460,80,0.95,63372,533788430
004700,조광피혁,55700,55800,100,0.18,1247,69598800
001550,조비,23300,23100,-200,-0.86,48128,1111367700
000480,조선내화,90000,90300,300,0.33,1541,137607800
120030,조선선재,122000,123500,1500,1.23,4517,557735000
018470,조일알미늄,982,1010,28,2.85,1253523,1273322003
002600,조흥,194500,193000,-1500,-0.77,201,38609500
185750,종근당,133500,135500,2000,1.5,75590,10220751000
063160,종근당바이오,58600,58900,300,0.51,76619,4542134300
001630,종근당홀딩스,106500,106500,0,0.0,9445,1006406500
044380,주연테크,1530,1575,45,2.94,36669485,59960062835
013890,지누스,103500,105500,2000,1.93,41799,4425745000
013870,지엠비코리아,7040,7070,30,0.43,43488,307498910
071320,지역난방공사,42250,41900,-350,-0.83,12354,519693900
010580,지코,306,306,0,0.0,0,0
035000,지투알,6700,6700,0,0.0,13137,87949820
088790,진도,4665,4785,120,2.57,89545,421987480
003780,진양산업,5750,5920,170,2.96,227210,1329445020
010640,진양폴리,3900,4065,165,4.23,110977,439719240
100250,진양홀딩스,3090,3110,20,0.65,59098,183304600
051630,진양화학,4190,4300,110,2.63,84661,363709115
272450,진에어,19150,19150,0,0.0,255226,4851768750
011000,진원생명과학,52100,51300,-800,-1.54,1511397,78200981000
002780,진흥기업,2465,2550,85,3.45,2402674,6026171460
002787,진흥기업2우B,15500,16100,600,3.87,5701,91154450
002785,진흥기업우B,7160,7340,180,2.51,3247,23550430
009310,참엔지니어링,1740,1720,-20,-1.15,456596,792765140
000650,천일고속,72000,73400,1400,1.94,1231,89584100
033250,체시스,1725,1760,35,2.03,244091,424976265
035720,카카오,160500,162000,1500,0.93,3248064,520764683500
006380,카프로,4800,4895,95,1.98,326692,1595502710
109070,컨버즈,4100,4100,0,0.0,0,0
001620,케이비아이동국실업,1140,1155,15,1.32,1168603,1345523200
029460,케이씨,25450,25850,400,1.57,44133,1139478150
281820,케이씨텍,27500,27150,-350,-1.27,139240,3790045150
145270,케이탑리츠,1670,1675,5,0.3,457779,766953130
357120,코람코에너지리츠,6190,6180,-10,-0.16,57102,352081810
007815,코리아써우,7450,7870,420,5.64,9617,73525600
007810,코리아써키트,13200,13400,200,1.52,57173,762891600
00781K,코리아써키트2우B,9440,9300,-140,-1.48,7490,69971440
003690,코리안리,9490,9530,40,0.42,149153,1424007550
192820,코스맥스,132000,138000,6000,4.55,202023,28056388000
044820,코스맥스비티아이,19000,19250,250,1.32,14067,272228700
005070,코스모신소재,30600,30400,-200,-0.65,743078,22561864200
005420,코스모화학,11550,11450,-100,-0.87,153324,1769781800
071950,코아스,1480,1520,40,2.7,261165,392370845
002020,코오롱,30450,31200,750,2.46,43289,1346532750
003070,코오롱글로벌,23050,23050,0,0.0,43674,1017818000
003075,코오롱글로벌우,31250,32100,850,2.72,2773,88381600
144620,코오롱머티리얼,2870,2905,35,1.22,68263,197036860
002025,코오롱우,21200,21500,300,1.42,8894,189706450
120110,코오롱인더,78800,78700,-100,-0.13,217355,17158406300
120115,코오롱인더우,33750,34400,650,1.93,12585,430741100
138490,코오롱플라스틱,7440,7490,50,0.67,227176,1693790310
021240,코웨이,76100,78000,1900,2.5,123002,9567493000
031820,콤텍시스템,1235,1255,20,1.62,1608986,1990899340
192400,쿠쿠홀딩스,121500,120000,-1500,-1.23,8804,1056274500
284740,쿠쿠홈시스,43250,43700,450,1.04,44670,1949650350
015590,큐로,617,611,-6,-0.97,5374023,3285221542
264900,크라운제과,12100,12300,200,1.65,35405,432966850
26490K,크라운제과우,18450,18450,0,0.0,10542,194600100
005740,크라운해태홀딩스,10550,10850,300,2.84,37247,400013050
005745,크라운해태홀딩스우,16650,16600,-50,-0.3,10716,176686850
020120,키다리스튜디오,14950,15100,150,1.0,78989,1201816450
039490,키움증권,119500,120500,1000,0.84,66890,8091739500
014580,태경비케이,4960,5000,40,0.81,292062,1460530790
015890,태경산업,6750,6730,-20,-0.3,390570,2640606490
006890,태경케미컬,19400,18950,-450,-2.32,532320,10173433200
003240,태광산업,1081000,1107000,26000,2.41,898,994822000
011280,태림포장,5320,5440,120,2.26,4795693,26515603830
004100,태양금속,1680,1680,0,0.0,239748,403351930
004105,태양금속우,3330,3365,35,1.05,42435,142810900
009410,태영건설,12600,12650,50,0.4,145840,1844315450
009415,태영건설우,16250,16450,200,1.23,11432,187224250
001420,태원물산,5940,5770,-170,-2.86,116987,679396870
007980,태평양물산,2435,2475,40,1.64,460357,1152280010
055490,테이팩스,52400,53100,700,1.34,11203,592663600
078000,텔코웨어,12300,12450,150,1.22,7177,88890950
214420,토니모리,8270,8450,180,2.18,38193,321940520
019180,티에이치엔,3670,3700,30,0.82,265428,975678410
363280,티와이홀딩스,29100,29900,800,2.75,170295,5088725700
36328K,티와이홀딩스우,26450,27700,1250,4.73,20508,561336350
091810,티웨이항공,3825,3910,85,2.22,544293,2109154955
004870,티웨이홀딩스,1330,1360,30,2.26,213995,287993270
005690,파미셀,19050,19150,100,0.52,1118922,21428341750
036580,팜스코,6700,6860,160,2.39,127596,866923130
004720,팜젠사이언스,14250,14200,-50,-0.35,2643263,38364325050
028670,팬오션,7940,7870,-70,-0.88,4774055,38013029130
010820,퍼스텍,2635,2725,90,3.42,294742,796879135
016800,퍼시스,37000,37300,300,0.81,3747,139073200
001020,페이퍼코리아,2285,2310,25,1.09,90608,209133790
090080,평화산업,1770,1820,50,2.82,1050703,1928396845
010770,평화홀딩스,4855,4980,125,2.57,57798,283838585
058430,포스코강판,78000,76000,-2000,-2.56,673911,53018101500
047050,포스코인터내셔널,23650,23500,-150,-0.63,567538,13383136700
003670,포스코케미칼,158500,161500,3000,1.89,665022,106444798000
007630,폴루스바이오팜,1225,1225,0,0.0,0,0
017810,풀무원,19450,19400,-50,-0.26,60515,1177559400
103140,풍산,36800,37150,350,0.95,163095,6080639450
005810,풍산홀딩스,27000,27200,200,0.74,15109,410243950
950210,프레스티지바이오파마,30900,30500,-400,-1.29,151826,4654829950
086790,하나금융지주,42500,43150,650,1.53,1309915,57072968500
293480,하나제약,21950,21900,-50,-0.23,32582,713951200
039130,하나투어,75700,77900,2200,2.91,111715,8598171100
172580,하이골드12호,2565,2570,5,0.19,23895,61363345
153360,하이골드3호,1960,1955,-5,-0.26,8136,15904080
352820,하이브,308000,307000,-1000,-0.32,387814,119449262000
071090,하이스틸,3385,3480,95,2.81,188516,645978275
019490,하이트론,8290,7950,-340,-4.1,187883,1523807080
000080,하이트진로,34500,34900,400,1.16,381886,13363620600
000087,하이트진로2우B,21400,21600,200,0.93,1930,41482050
000140,하이트진로홀딩스,15750,16100,350,2.22,29301,469389400
000145,하이트진로홀딩스우,18200,18550,350,1.92,905,16614000
152550,한국ANKOR유전,1595,1600,5,0.31,7901,12728670
036460,한국가스공사,35250,35300,50,0.14,222803,7910619850
005430,한국공항,45400,46500,1100,2.42,7825,362897400
071050,한국금융지주,95200,97000,1800,1.89,183216,17747081100
071055,한국금융지주우,77700,79400,1700,2.19,18518,1459156400
010040,한국내화,4870,4895,25,0.51,241309,1181195665
025540,한국단자,98600,97500,-1100,-1.12,50501,4990743200
004090,한국석유,15350,15500,150,0.98,76667,1194051900
002200,한국수출포장,29900,30650,750,2.51,222799,6834113600
002960,한국쉘석유,282500,282500,0,0.0,2175,614009000
000240,한국앤컴퍼니,18750,18950,200,1.07,137177,2601611800
123890,한국자산신탁,4615,4625,10,0.22,307199,1428105680
015760,한국전력,24300,24750,450,1.85,1938747,48109003150
006200,한국전자홀딩스,1500,1535,35,2.33,2968533,4620132435
009540,한국조선해양,124500,127000,2500,2.01,257881,32809188500
023350,한국종합기술,9860,10050,190,1.93,319055,3207864600
025890,한국주강,2840,2930,90,3.17,205162,586107250
000970,한국주철관,9840,10050,210,2.13,134931,1347121090
104700,한국철강,9570,9650,80,0.84,140301,1361133880
017960,한국카본,11500,11650,150,1.3,250690,2917425000
161890,한국콜마,54400,55300,900,1.65,121263,6673071100
024720,한국콜마홀딩스,28850,28850,0,0.0,42890,1237151850
161390,한국타이어앤테크놀로지,49800,50500,700,1.41,116788,5911145450
034830,한국토지신탁,2265,2285,20,0.88,747549,1707393480
007280,한국특강,3690,3700,10,0.27,184594,680372980
168490,한국패러랠,2020,2025,5,0.25,47328,95388905
010100,한국프랜지,3550,3610,60,1.69,382659,1373946180
047810,한국항공우주,33750,34050,300,0.89,1232363,42552860200
123690,한국화장품,11500,11500,0,0.0,34196,392137750
003350,한국화장품제조,34450,34700,250,0.73,8627,297094150
011500,한농화성,14100,14050,-50,-0.35,73820,1040889100
002390,한독,27100,27350,250,0.92,15586,427083350
014790,한라,5650,5840,190,3.36,320608,1874891870
060980,한라홀딩스,46300,47100,800,1.73,58394,2742310500
053690,한미글로벌,11800,11950,150,1.27,54196,648114000
042700,한미반도체,34250,33850,-400,-1.17,322932,10994379700
008930,한미사이언스,82300,84900,2600,3.16,294608,24644911800
128940,한미약품,339000,343000,4000,1.18,32548,11139093500
009240,한샘,105500,108500,3000,2.84,139709,15213271000
020000,한섬,38800,40500,1700,4.38,162024,6463759050
003680,한성기업,8320,8490,170,2.04,45099,379173690
105630,한세실업,21900,22400,500,2.28,218910,4846662400
069640,한세엠케이,10050,10050,0,0.0,868498,8925370180
016450,한세예스24홀딩스,9580,9700,120,1.25,98925,954422140
010420,한솔PNS,2530,2555,25,0.99,254569,651200590
009180,한솔로지스틱스,4695,4795,100,2.13,4682539,22661999405
213500,한솔제지,15650,15700,50,0.32,116906,1837755050
014680,한솔케미칼,232500,236500,4000,1.72,27276,6438810000
004710,한솔테크닉스,8670,8760,90,1.04,113045,991132570
004150,한솔홀딩스,4470,4520,50,1.12,150977,679153355
025750,한솔홈데코,2045,2120,75,3.67,1833289,3860719355
004960,한신공영,25000,25350,350,1.4,16482,415149100
011700,한신기계,2720,2860,140,5.15,1462314,4141684730
001750,한양증권,15500,15900,400,2.58,58991,930075100
001755,한양증권우,20900,21500,600,2.87,5932,126207800
018880,한온시스템,15950,16450,500,3.13,717885,11729225550
009420,한올바이오파마,21100,21650,550,2.61,275817,5908798000
014130,한익스프레스,7470,7470,0,0.0,739527,5600214470
300720,한일시멘트,157000,167000,10000,6.37,124940,21628191000
002220,한일철강,2980,3050,70,2.35,118970,357782865
006390,한일현대시멘트,36050,36350,300,0.83,40382,1470767950
003300,한일홀딩스,13200,13450,250,1.89,55639,752901150
051600,한전KPS,41800,42450,650,1.56,213019,9037064650
052690,한전기술,56000,54100,-1900,-3.39,846709,47132773700
130660,한전산업,17100,16200,-900,-5.26,2198071,36319884750
002320,한진,41850,43050,1200,2.87,105456,4516628600
097230,한진중공업,8370,8370,0,0.0,76245,641641480
003480,한진중공업홀딩스,6250,6180,-70,-1.12,205153,1276194470
180640,한진칼,62200,65800,3600,5.79,126977,8242965100
18064K,한진칼우,42550,42850,300,0.71,3262,139947150
005110,한창,1545,1635,90,5.83,4855062,7830647520
009460,한창제지,2655,2700,45,1.69,1281057,3460935435
000880,한화,30000,30800,800,2.67,384793,11785028500
00088K,한화3우B,15050,15100,50,0.33,113157,1706932100
088350,한화생명,3525,3550,25,0.71,3105602,11106558710
000370,한화손해보험,4725,4765,40,0.85,462677,2208743110
009830,한화솔루션,42900,42750,-150,-0.35,1021344,43502109350
009835,한화솔루션우,52400,51800,-600,-1.15,5100,265829700
272210,한화시스템,16900,17050,150,0.89,671623,11545954550
012450,한화에어로스페이스,51300,51200,-100,-0.19,558211,28781199900
000885,한화우,43400,44300,900,2.07,2117,93528150
003530,한화투자증권,4500,4670,170,3.78,2429133,11354942980
003535,한화투자증권우,13850,16250,2400,17.33,197552,3098130450
195870,해성디에스,38600,39900,1300,3.37,327916,12934131000
101530,해태제과식품,9470,9640,170,1.8,30035,287502590
143210,핸즈코퍼레이션,6200,6280,80,1.29,43908,275483280
000720,현대건설,57100,57700,600,1.05,712359,41033963900
267270,현대건설기계,51600,52600,1000,1.94,64010,3366816200
000725,현대건설우,208000,211000,3000,1.44,325,68575500
005440,현대그린푸드,10050,10150,100,1.0,426539,4321791750
086280,현대글로비스,199000,200500,1500,0.75,72164,14466703500
064350,현대로템,23100,23150,50,0.22,913792,21189834350
079430,현대리바트,19450,19750,300,1.54,151770,2990132000
012330,현대모비스,276500,281000,4500,1.63,163508,45872401500
010620,현대미포조선,79700,80000,300,0.38,253452,20463597200
069960,현대백화점,81800,82300,500,0.61,130316,10722335200
004560,현대비앤지스틸,20350,20800,450,2.21,177159,3688074550
004565,현대비앤지스틸우,88600,93700,5100,5.76,821,76214800
004310,현대약품,6860,7000,140,2.04,143979,1000097910
322000,현대에너지솔루션,30100,30300,200,0.66,25334,765757650
017800,현대엘리베이,49800,50500,700,1.41,238502,12008999150
307950,현대오토에버,128000,128000,0,0.0,41396,5306551000
011210,현대위아,91400,91300,-100,-0.11,408709,37820777900
267260,현대일렉트릭,19250,20400,1150,5.97,221826,4421857350
004020,현대제철,51600,53100,1500,2.91,1214813,64802215900
267250,현대중공업지주,66600,68300,1700,2.55,160837,10978563300
005380,현대차,226000,230000,4000,1.77,529258,121763889000
005387,현대차2우B,109500,111000,1500,1.37,96556,10730154500
005389,현대차3우B,101500,102500,1000,0.99,54697,5598148500
005385,현대차우,110500,112000,1500,1.36,44465,4994606000
001500,현대차증권,12900,13150,250,1.94,69555,913128450
011760,현대코퍼레이션,19950,20000,50,0.25,49511,994648200
227840,현대코퍼레이션홀딩스,14950,15150,200,1.34,95836,1452612300
126560,현대퓨처넷,4325,4370,45,1.04,245839,1078885140
001450,현대해상,24700,25300,600,2.43,587475,14813006900
057050,현대홈쇼핑,86200,87000,800,0.93,19462,1695408300
093240,형지엘리트,5190,5200,10,0.19,886102,4591170640
003010,혜인,6800,6950,150,2.21,74257,512915060
111110,호전실업,12900,13500,600,4.65,94025,1257523100
008770,호텔신라,92700,93300,600,0.65,205543,19205082200
008775,호텔신라우,87900,88600,700,0.8,4194,372372400
002460,화성산업,13400,13600,200,1.49,49605,673394950
378850,화승알앤에이,5980,6000,20,0.33,54848,329877300
241590,화승엔터프라이즈,16450,17250,800,4.86,248362,4228878600
006060,화승인더,7380,7560,180,2.44,287754,2157926190
013520,화승코퍼레이션,3150,3110,-40,-1.27,391711,1229752740
010690,화신,10050,9880,-170,-1.69,698205,6980789290
133820,화인베스틸,2795,2970,175,6.26,560086,1634865585
010660,화천기계,2755,2760,5,0.18,88044,242860230
000850,화천기공,37350,37800,450,1.2,8304,313123750
016580,환인제약,22150,21950,-200,-0.9,88464,1939809150
032560,황금에스티,9120,9260,140,1.54,93272,861073380
004800,효성,104500,108500,4000,3.83,192657,20951884500
094280,효성ITX,21850,22200,350,1.6,33708,743502850
298040,효성중공업,70100,71400,1300,1.85,31813,2251751100
298050,효성첨단소재,513000,514000,1000,0.19,79147,40496254000
298020,효성티앤씨,890000,878000,-12000,-1.35,37330,32874825000
298000,효성화학,381500,379000,-2500,-0.66,39032,14883371500
093370,후성,11450,11900,450,3.93,4500843,52672867800
081660,휠라홀딩스,53000,53400,400,0.75,253807,13642099100
005870,휴니드,8040,8130,90,1.12,69570,565109330
079980,휴비스,10650,10700,50,0.47,210926,2253631900
005010,휴스틸,13800,14050,250,1.81,36821,515150300
069260,휴켐스,22400,24250,1850,8.26,2273022,54847879550
000540,흥국화재,4340,4395,55,1.27,102299,448009685
000547,흥국화재2우B,28400,29350,950,3.35,2118,61500450
000545,흥국화재우,10050,10300,250,2.49,4342,44386000
003280,흥아해운,1035,1035,0,0.0,0,0
