티커,종목명,시가,종가,변동폭,등락률,거래량,거래대금
095570,AJ네트웍스,6120,6260,140,2.29,269264,1707653930
006840,AK홀딩스,33600,33500,-100,-0.3,92685,3134939350
027410,BGF,6950,6930,-20,-0.29,231169,1605430920
282330,BGF리테일,180000,177500,-2500,-1.39,25706,4631744000
138930,BNK금융지주,8160,8100,-60,-0.74,1567918,12699159810
001460,BYC,385000,390000,5000,1.3,347,134877500
001465,BYC우,168000,171000,3000,1.79,65,11155000
001040,CJ,109500,107500,-2000,-1.83,165962,17961604500
079160,CJCGV,27450,27700,250,0.91,254460,7002350950
00104K,CJ4우전환,85800,84700,-1100,-1.28,10541,895551900
000120,CJ대한통운,171500,170000,-1500,-0.87,36920,6267919000
011150,CJ씨푸드,4705,4660,-45,-0.96,985945,4598284725
011155,CJ씨푸드1우,44000,47200,3200,7.27,9712,448849750
001045,CJ우,66200,64800,-1400,-2.11,4880,317743000
097950,CJ제일제당,462000,454000,-8000,-1.73,97157,44270560000
097955,CJ제일제당우,222000,216000,-6000,-2.7,19697,4248550500
000590,CS홀딩스,76600,78200,1600,2.09,7335,564085600
012030,DB,910,927,17,1.87,990896,914369992
016610,DB금융투자,7460,7300,-160,-2.14,316819,2332628290
005830,DB손해보험,51600,51700,100,0.19,299937,15443485200
000990,DB하이텍,57600,55400,-2200,-3.82,2332373,131933038100
000995,DB하이텍1우,123500,133500,10000,8.1,8963,1208054500
139130,DGB금융지주,9380,9340,-40,-0.43,719030,6681677670
001530,DI동일,181500,186500,5000,2.75,8033,1477393000
000210,DL,82800,85100,2300,2.78,344450,29239433800
001880,DL건설,35600,35900,300,0.84,56137,2016312750
000215,DL우,51000,50800,-200,-0.39,33960,1728431400
375500,DL이앤씨,139500,139500,0,0.0,135962,18933212500
37550K,DL이앤씨우,78900,78500,-400,-0.51,14510,1138451200
004840,DRB동일,7080,7160,80,1.13,19847,141276890
155660,DSR,7140,6980,-160,-2.24,232278,1628158590
069730,DSR제강,6520,6320,-200,-3.07,352620,2260010870
017940,E1,48700,48600,-100,-0.21,15844,767464850
365550,ESR켄달스퀘어리츠,6750,6510,-240,-3.56,769444,5051808460
007700,FF,180000,180000,0,0.0,0,0
114090,GKL,16650,16950,300,1.8,873912,14866637450
078930,GS,47700,48250,550,1.15,342821,16491897150
006360,GS건설,43450,43450,0,0.0,455864,19859775300
001250,GS글로벌,2810,2845,35,1.25,569801,1610420025
007070,GS리테일,36850,36700,-150,-0.41,342916,12578238200
078935,GS우,38900,39000,100,0.26,9640,373899000
012630,HDC,14200,14050,-150,-1.06,748984,10487539000
039570,HDC아이콘트롤스,12100,12400,300,2.48,122057,1512155250
089470,HDC현대EP,6030,6110,80,1.33,59313,360736900
294870,HDC현대산업개발,28600,28750,150,0.52,450443,12918423050
011200,HMM,44450,43700,-750,-1.69,20548921,914681417600
082740,HSD엔진,10150,10100,-50,-0.49,1254073,12572760940
003560,IHQ,2470,2580,110,4.45,5492843,14328967375
175330,JB금융지주,7890,7900,10,0.13,458703,3621530100
234080,JW생명과학,18700,18750,50,0.27,72483,1357606800
001060,JW중외제약,28400,28600,200,0.7,40188,1146912450
001067,JW중외제약2우B,81000,85300,4300,5.31,18632,1678376900
001065,JW중외제약우,59500,63200,3700,6.22,37658,2499516600
096760,JW홀딩스,4770,4785,15,0.31,69823,334210990
105560,KB금융,58800,57600,-1200,-2.04,1263046,72736346800
002380,KCC,335500,340500,5000,1.49,53130,18036679000
009070,KCTC,8080,7970,-110,-1.36,1120843,9049674260
009440,KC그린홀딩스,4490,4540,50,1.11,62437,285485670
119650,KC코트렐,7530,7680,150,1.99,378264,2954271790
092220,KEC,2045,2050,5,0.24,1078416,2179723465
016380,KG동부제철,22200,20750,-1450,-6.53,1310458,27678703800
016385,KG동부제철우,165000,169000,4000,2.42,1853,306563000
001390,KG케미칼,29300,29300,0,0.0,111947,3278494250
033180,KH필룩스,3445,3430,-15,-0.44,2778393,9544540505
001940,KISCO홀딩스,19450,19350,-100,-0.51,47637,913455550
025000,KPX케미칼,71900,73400,1500,2.09,14612,1060032300
092230,KPX홀딩스,79400,76600,-2800,-3.53,42798,3304494400
000040,KR모터스,1180,1190,10,0.85,457177,543986000
044450,KSS해운,13450,13350,-100,-0.74,1881413,25047670250
030200,KT,31550,31000,-550,-1.74,1390255,43394687850
033780,KTG,82000,82300,300,0.37,366829,30177496100
030210,KTB투자증권,5540,5630,90,1.62,534687,2981801180
058850,KTcs,3055,3140,85,2.78,826338,2584773490
058860,KTis,3065,3125,60,1.96,353801,1097837775
093050,LF,19250,19300,50,0.26,91926,1769154200
003550,LG,126500,126500,0,0.0,0,0
034220,LG디스플레이,21900,22000,100,0.46,3037543,67125053650
001120,LG상사,34600,34750,150,0.43,173381,6019968250
051900,LG생활건강,1519000,1521000,2000,0.13,23542,35801877000
051905,LG생활건강우,711000,712000,1000,0.14,2674,1904092000
003555,LG우,99500,99500,0,0.0,0,0
032640,LG유플러스,14850,14800,-50,-0.34,2644752,38865912950
011070,LG이노텍,189500,195500,6000,3.17,159213,30924210000
066570,LG전자,148000,148500,500,0.34,634322,94223405500
066575,LG전자우,71300,71500,200,0.28,56794,4058042800
108670,LG하우시스,104000,104000,0,0.0,106869,11096296000
108675,LG하우시스우,50200,49750,-450,-0.9,15320,764110750
037560,LG헬로비전,5090,5180,90,1.77,580691,2987153920
051910,LG화학,850000,854000,4000,0.47,218492,186910631000
051915,LG화학우,408000,407000,-1000,-0.25,18529,7538117500
079550,LIG넥스원,38650,39700,1050,2.72,77695,3049095600
006260,LS,72200,71300,-900,-1.25,181646,13055921000
010120,LSELECTRIC,55100,55200,100,0.18,51575,2849290700
000680,LS네트웍스,2905,2940,35,1.2,168130,498869405
229640,LS전선아시아,8220,8200,-20,-0.24,204333,1673721230
023150,MH에탄올,10200,10150,-50,-0.49,80041,820856900
035420,NAVER,337500,342500,5000,1.48,460390,157285603500
181710,NHN,70600,72500,1900,2.69,115893,8420634500
005940,NH투자증권,13000,13300,300,2.31,1217743,16033540650
005945,NH투자증권우,11850,11800,-50,-0.42,102534,1209232750
338100,NH프라임리츠,4550,4570,20,0.44,46456,211991755
034310,NICE,19000,18900,-100,-0.53,27188,513590350
008260,NI스틸,5640,5600,-40,-0.71,1332601,7372519800
004250,NPC,4460,4520,60,1.35,1274056,5936525735
004255,NPC우,2940,2985,45,1.53,29542,88074710
010060,OCI,116000,116500,500,0.43,255176,29874937500
005490,POSCO,383500,380000,-3500,-0.91,567800,215540023500
010950,S-Oil,95500,96100,600,0.63,541742,51778244000
010955,S-Oil우,55200,55800,600,1.09,36356,2005398400
034120,SBS,29300,35100,5800,19.8,1225126,40531770200
101060,SBS미디어홀딩스,1965,2050,85,4.33,1660495,3365329820
005090,SGC에너지,43350,43900,550,1.27,44093,1927974700
001380,SG글로벌,4145,4230,85,2.05,1375158,5847552615
004060,SG세계물산,747,756,9,1.2,474711,357937284
002360,SH에너지화학,1175,1170,-5,-0.43,3869010,4560587500
009160,SIMPAC,4490,4800,310,6.9,492367,2330827360
123700,SJM,5350,5650,300,5.61,279991,1556375770
025530,SJM홀딩스,4295,4360,65,1.51,54185,234139165
034730,SK,264000,270000,6000,2.27,173146,46519421500
011790,SKC,128500,129000,500,0.39,287567,37174262500
018670,SK가스,104000,105000,1000,0.96,9219,963213500
001740,SK네트웍스,5490,5630,140,2.55,1353497,7564835390
001745,SK네트웍스우,130500,127500,-3000,-2.3,620,80776500
006120,SK디스커버리,54100,54000,-100,-0.18,47138,2549312600
006125,SK디스커버리우,42500,42650,150,0.35,5307,226880050
210980,SK디앤디,35550,36050,500,1.41,64843,2322589350
068400,SK렌터카,13050,12850,-200,-1.53,665795,8778541250
302440,SK바이오사이언스,145500,146000,500,0.34,360255,52673852000
326030,SK바이오팜,108000,110500,2500,2.31,225513,24884157000
361610,SK아이이테크놀로지,144000,141000,-3000,-2.08,1510892,216996886500
03473K,SK우,250000,251500,1500,0.6,2806,707370000
096770,SK이노베이션,258000,269000,11000,4.26,883903,236701105500
096775,SK이노베이션우,183000,187500,4500,2.46,14483,2700516000
001510,SK증권,1010,1010,0,0.0,4673326,4740920805
001515,SK증권우,5500,5500,0,0.0,29557,162980960
285130,SK케미칼,250000,254500,4500,1.8,61726,15662438000
28513K,SK케미칼우,121000,121500,500,0.41,13295,1598917000
017670,SK텔레콤,312500,317000,4500,1.44,319487,101872321500
000660,SK하이닉스,117500,118500,1000,0.85,3227201,383650636500
064960,SNT모티브,59600,61800,2200,3.69,74892,4559119700
100840,SNT에너지,18500,18500,0,0.0,16415,302327000
003570,SNT중공업,8330,8800,470,5.64,348202,3072644590
036530,SNT홀딩스,19900,20050,150,0.75,79884,1619044550
005610,SPC삼립,90200,87900,-2300,-2.55,79010,6976836400
011810,STX,10400,9840,-560,-5.38,368959,3650075490
077970,STX엔진,15450,15000,-450,-2.91,416239,6437214100
071970,STX중공업,9220,8850,-370,-4.01,939991,8381040370
002820,SUNL,6850,7000,150,2.19,67601,465516800
084870,TBH글로벌,2035,2020,-15,-0.74,96785,195189640
002710,TCC스틸,5210,5070,-140,-2.69,562469,2878361870
002900,TYM,1745,1740,-5,-0.29,2000923,3472487265
024070,WISCOM,4215,4500,285,6.76,1203959,5477633075
037270,YGPLUS,5860,5920,60,1.02,303757,1788036980
000500,가온전선,28000,28150,150,0.54,25692,725173150
000860,강남제비스코,30100,29800,-300,-1.0,16671,498919250
035250,강원랜드,25600,25950,350,1.37,929057,24083734050
011420,갤럭시아에스엠,2020,2025,5,0.25,292481,585080950
002100,경농,15700,15700,0,0.0,104838,1649746650
009450,경동나비엔,60900,64800,3900,6.4,285142,18195129200
267290,경동도시가스,23400,23700,300,1.28,17454,412230850
012320,경동인베스트,45400,45450,50,0.11,5555,249447850
000050,경방,14650,14700,50,0.34,114592,1699011350
214390,경보제약,13050,13100,50,0.38,123387,1614941750
012610,경인양행,7180,7150,-30,-0.42,256385,1828981890
009140,경인전자,30000,30650,650,2.17,3354,101025400
013580,계룡건설,33850,34350,500,1.48,60101,2074182200
012200,계양전기,4450,4520,70,1.57,100259,451170585
012205,계양전기우,8280,8400,120,1.45,55862,482671110
002140,고려산업,4745,4095,-650,-13.7,1513318,6573248380
010130,고려아연,469500,459000,-10500,-2.24,90025,41402498000
002240,고려제강,27800,27200,-600,-2.16,127233,3464983650
009290,광동제약,8940,9010,70,0.78,79123,711987140
017040,광명전기,2685,2670,-15,-0.56,444802,1194961095
017900,광전자,2420,2485,65,2.69,251111,620306280
037710,광주신세계,185500,189500,4000,2.16,3893,733569000
030610,교보증권,8950,8950,0,0.0,211318,1884909820
339770,교촌에프앤비,20150,20300,150,0.74,168480,3438053200
007690,국도화학,73700,73300,-400,-0.54,39409,2894760100
005320,국동,3680,3710,30,0.82,210221,779374100
001140,국보,1880,1820,-60,-3.19,1517808,2733431535
002720,국제약품,7260,7350,90,1.24,73106,535243630
083420,그린케미칼,11850,11900,50,0.42,116878,1396344900
014530,극동유화,5650,5390,-260,-4.6,1512384,8251673580
014280,금강공업,6770,6780,10,0.15,132468,913014740
014285,금강공업우,14450,14750,300,2.08,5894,87448750
008870,금비,78900,80300,1400,1.77,3626,291414000
001570,금양,5070,5070,0,0.0,166207,844340440
002990,금호건설,10200,10450,250,2.45,206919,2139921300
002995,금호건설우,39000,42000,3000,7.69,24388,1036173850
011780,금호석유,236500,244000,7500,3.17,683359,162422516500
011785,금호석유우,127000,128000,1000,0.79,95405,12074979500
214330,금호에이치티,2430,2510,80,3.29,4480061,11172694860
001210,금호전기,3035,3090,55,1.81,189025,579660990
073240,금호타이어,5460,5680,220,4.03,2702780,15384885880
092440,기신정기,5160,5230,70,1.36,77139,399470200
000270,기아,81800,82600,800,0.98,2580701,214688087400
024110,기업은행,10650,10700,50,0.47,2646200,28266011550
013700,까뮤이앤씨,2510,2505,-5,-0.2,575185,1448646120
004540,깨끗한나라,6420,6800,380,5.92,1176092,7873990910
004545,깨끗한나라우,40400,42900,2500,6.19,28078,1185788300
001260,남광토건,18350,17600,-750,-4.09,393507,6961901200
008350,남선알미늄,3870,3795,-75,-1.94,2063785,7991737495
008355,남선알미우,44950,46000,1050,2.34,4900,225543400
004270,남성,3790,3795,5,0.13,138724,528252420
003920,남양유업,375000,383500,8500,2.27,8163,3149205500
003925,남양유업우,172500,174500,2000,1.16,706,123497000
025860,남해화학,9740,9600,-140,-1.44,476756,4590148230
005720,넥센,5130,5080,-50,-0.97,37925,194212110
005725,넥센우,3715,3640,-75,-2.02,8941,32694305
002350,넥센타이어,8670,8590,-80,-0.92,171275,1479832310
002355,넥센타이어1우B,3625,3670,45,1.24,9910,36267935
003580,넥스트사이언스,15600,18050,2450,15.71,4091737,72215680600
251270,넷마블,128500,127500,-1000,-0.78,182417,23298208000
090350,노루페인트,13600,13400,-200,-1.47,675964,9100879000
090355,노루페인트우,50700,47200,-3500,-6.9,53775,2501970850
000320,노루홀딩스,15250,15050,-200,-1.31,85238,1282300500
000325,노루홀딩스우,105000,99000,-6000,-5.71,30947,3048268500
006280,녹십자,356500,352500,-4000,-1.12,453657,164386081000
005250,녹십자홀딩스,36850,36600,-250,-0.68,710682,26526138450
005257,녹십자홀딩스2우,99400,99500,100,0.1,7353,738802400
004370,농심,302500,301000,-1500,-0.5,65872,19958401500
072710,농심홀딩스,82900,87700,4800,5.79,73687,6438311800
058730,다스코,5430,5410,-20,-0.37,32116,173850370
023590,다우기술,27050,27450,400,1.48,124330,3415656000
019680,대교,4480,4470,-10,-0.22,198439,880384200
019685,대교우B,3165,3165,0,0.0,129918,412775175
006370,대구백화점,11100,10950,-150,-1.35,7628,83800350
008060,대덕,7180,7220,40,0.56,238410,1716673530
00806K,대덕1우,11200,11200,0,0.0,19115,214769350
353200,대덕전자,14850,14950,100,0.67,441749,6613526700
35320K,대덕전자1우,13950,13900,-50,-0.36,88971,1247525350
000490,대동,10700,11050,350,3.27,259539,2840101850
008110,대동전자,8550,8620,70,0.82,29692,253253220
005750,대림BCo,7310,7290,-20,-0.27,75003,543705930
006570,대림통상,4130,4110,-20,-0.48,10393,42646195
001680,대상,30700,29850,-850,-2.77,1125105,33802931600
001685,대상우,23950,23450,-500,-2.09,80050,1914063500
084690,대상홀딩스,13150,13150,0,0.0,341945,4445110900
084695,대상홀딩스우,18200,20350,2150,11.81,1358898,30066358050
128820,대성산업,5180,5130,-50,-0.97,589248,3020712770
117580,대성에너지,5860,5920,60,1.02,85379,503402890
016710,대성홀딩스,33350,34250,900,2.7,11593,396188350
003540,대신증권,18800,18750,-50,-0.27,114817,2168164100
003547,대신증권2우B,16150,16100,-50,-0.31,27508,443848700
003545,대신증권우,16550,16450,-100,-0.6,111249,1834330900
009190,대양금속,4700,4550,-150,-3.19,923668,4256854540
014160,대영포장,2570,2595,25,0.97,892909,2320605805
047040,대우건설,7370,7400,30,0.41,1792547,13308454710
009320,대우부품,2430,2450,20,0.82,174737,426309365
042660,대우조선해양,37600,36400,-1200,-3.19,849256,31132216500
003090,대웅,35400,35250,-150,-0.42,257391,9105504000
069620,대웅제약,147000,147500,500,0.34,43666,6496183000
000430,대원강업,4185,4270,85,2.03,151740,645718945
006340,대원전선,1600,1590,-10,-0.63,1797518,2894063785
006345,대원전선우,3570,3545,-25,-0.7,76070,269976345
003220,대원제약,16200,16350,150,0.93,42216,689300250
024890,대원화성,2760,2965,205,7.43,34489579,109928731545
002880,대유에이텍,1180,1180,0,0.0,592817,701362130
000300,대유플러스,1110,1115,5,0.45,2453034,2733519860
012800,대창,2685,2575,-110,-4.1,4829370,12652523910
015230,대창단조,9370,9410,40,0.43,173746,1614395420
001070,대한방직,43550,43650,100,0.23,13465,586957350
006650,대한유화,267500,272000,4500,1.68,46555,12658104000
001440,대한전선,1240,1250,10,0.81,6898987,8642940135
084010,대한제강,21550,20250,-1300,-6.03,986650,20374337900
001790,대한제당,3850,3725,-125,-3.25,1879354,7188178000
001795,대한제당우,6000,6080,80,1.33,407730,2475376360
001130,대한제분,193500,187500,-6000,-3.1,34780,6587384500
003490,대한항공,29500,29300,-200,-0.68,3542799,102380537100
003495,대한항공우,41150,40400,-750,-1.82,16112,657644200
005880,대한해운,3455,3385,-70,-2.03,7811438,27296593155
003830,대한화섬,139500,140000,500,0.36,388,54133000
016090,대현,2720,2640,-80,-2.94,678296,1804280940
069460,대호에이엘,3500,3620,120,3.43,7160578,25399548070
192080,더블유게임즈,64800,64500,-300,-0.46,106748,6942108400
012510,더존비즈온,78900,79200,300,0.38,79512,6324107500
004830,덕성,23300,23550,250,1.07,788164,18604388350
004835,덕성우,47600,49100,1500,3.15,157192,7598944000
024900,덕양산업,3325,3385,60,1.8,144004,490745495
145720,덴티움,55900,57700,1800,3.22,48878,2781437100
002150,도화엔지니어링,9590,9550,-40,-0.42,186730,1799400990
001230,동국제강,23900,23400,-500,-2.09,4345825,101981005150
023450,동남합성,52000,52700,700,1.35,1083,56601300
004140,동방,6420,6250,-170,-2.65,1911885,11997531850
007590,동방아그로,8220,8010,-210,-2.55,77100,618986290
005960,동부건설,12700,12750,50,0.39,114565,1458374300
005965,동부건설우,69500,75600,6100,8.78,95366,7804249600
026960,동서,30950,30400,-550,-1.78,163287,4983288900
002210,동성제약,11550,11600,50,0.43,103168,1194011500
102260,동성케미컬,6390,6450,60,0.94,96574,619970880
000640,동아쏘시오홀딩스,124000,124500,500,0.4,31445,3905430000
170900,동아에스티,85800,85800,0,0.0,31394,2682594100
028100,동아지질,20800,21950,1150,5.53,708089,15390834900
282690,동아타이어,13300,13050,-250,-1.88,52330,684051700
001520,동양,1475,1460,-15,-1.02,991022,1439376280
001527,동양2우B,38000,39350,1350,3.55,134791,5561809200
001529,동양3우B,95000,95000,0,0.0,0,0
084670,동양고속,23850,24000,150,0.63,3277,78449200
082640,동양생명,6100,5720,-380,-6.23,1170885,6812245050
001525,동양우,17600,16400,-1200,-6.82,261343,4757365300
008970,동양철관,1780,1665,-115,-6.46,7352997,12590282860
092780,동양피스톤,5750,5760,10,0.17,27174,156679650
049770,동원FB,240000,234000,-6000,-2.5,20534,4892499000
018500,동원금속,1160,1145,-15,-1.29,1096513,1282886380
006040,동원산업,303000,294000,-9000,-2.97,5003,1484756000
030720,동원수산,9250,9220,-30,-0.32,82373,758588510
014820,동원시스템즈,43200,43250,50,0.12,35182,1504093900
014825,동원시스템즈우,42500,46000,3500,8.24,10121,449414750
163560,동일고무벨트,10000,9990,-10,-0.1,54458,545305760
004890,동일산업,100000,100000,0,0.0,2695,270229800
002690,동일제강,5050,4840,-210,-4.16,817584,3992602300
000020,동화약품,14550,14700,150,1.03,98572,1444904800
000150,두산,69200,68500,-700,-1.01,90058,6212684400
000157,두산2우B,75100,77300,2200,2.93,3945,304428700
241560,두산밥캣,49300,49300,0,0.0,185057,9188710150
000155,두산우,48550,48200,-350,-0.72,9082,438724800
042670,두산인프라코어,10550,10400,-150,-1.42,1993289,20879242350
034020,두산중공업,12450,12300,-150,-1.2,1612004,19915103900
336260,두산퓨얼셀,39100,39450,350,0.9,423558,16766899300
33626K,두산퓨얼셀1우,14700,14750,50,0.34,29110,430853050
33626L,두산퓨얼셀2우B,17850,18000,150,0.84,4383,79008600
016740,두올,4700,4860,160,3.4,2764853,13583470650
192650,드림텍,9490,9490,0,0.0,162024,1540879750
024090,디씨엠,16600,16650,50,0.3,23579,390766900
003160,디아이,6770,6940,170,2.51,172052,1195217540
092200,디아이씨,4465,5150,685,15.34,14170540,70366514950
013570,디와이,5930,5980,50,0.84,171135,1024264540
210540,디와이파워,19150,19050,-100,-0.52,220745,4179458900
007340,디티알오토모티브,37150,37250,100,0.27,27892,1033831800
026890,디피씨,13950,14050,100,0.72,762735,10815649850
115390,락앤락,13900,14000,100,0.72,42196,589587300
032350,롯데관광개발,18250,18900,650,3.56,1311200,24833450600
330590,롯데리츠,5550,5540,-10,-0.18,549510,3038140680
000400,롯데손해보험,2020,2075,55,2.72,3046968,6252508080
023530,롯데쇼핑,115500,114500,-1000,-0.87,141795,16308582000
004000,롯데정밀화학,60800,61400,600,0.99,132972,8123532100
286940,롯데정보통신,40000,40000,0,0.0,43948,1747877850
280360,롯데제과,159000,154000,-5000,-3.14,21727,3368938000
004990,롯데지주,38000,37450,-550,-1.45,344064,12933948950
00499K,롯데지주우,63800,64300,500,0.78,1441,92856500
005300,롯데칠성,165000,166500,1500,0.91,65999,10932153000
005305,롯데칠성우,90500,89100,-1400,-1.55,4588,406760400
011170,롯데케미칼,283000,282500,-500,-0.18,221417,62533001000
002270,롯데푸드,434000,428500,-5500,-1.27,8468,3677030000
071840,롯데하이마트,40800,40050,-750,-1.84,64385,2604884300
027740,마니커,769,762,-7,-0.91,1381959,1055894105
204320,만도,64500,65600,1100,1.71,609076,40276449000
001080,만호제강,23450,23800,350,1.49,22441,531922750
088980,맥쿼리인프라,12100,12050,-50,-0.41,1365544,16477999850
094800,맵스리얼티1,4755,4750,-5,-0.11,59670,282531710
138040,메리츠금융지주,20450,19600,-850,-4.16,418958,8156113850
008560,메리츠증권,4830,4880,50,1.04,1972095,9595511300
000060,메리츠화재,21200,21150,-50,-0.24,284189,5986537700
090370,메타랩스,1100,1110,10,0.91,498750,541604070
017180,명문제약,5500,5470,-30,-0.55,106062,580434010
009900,명신산업,26450,27450,1000,3.78,215415,5836780200
012690,모나리자,5230,5260,30,0.57,188959,994606430
005360,모나미,5320,5220,-100,-1.88,555050,2925540940
204210,모두투어리츠,4190,4080,-110,-2.63,49144,203150275
009680,모토닉,12350,12500,150,1.21,40060,499750500
009580,무림PP,5830,5770,-60,-1.03,713755,4095710670
009200,무림페이퍼,3120,3090,-30,-0.96,155299,480172160
033920,무학,9160,9190,30,0.33,57406,523391040
008420,문배철강,5780,5680,-100,-1.73,1041999,5908480760
025560,미래산업,14500,15000,500,3.45,33677,504784750
007120,미래아이앤지,540,550,10,1.85,1423885,782985139
357250,미래에셋맵스리츠,5010,5010,0,0.0,63568,318416830
085620,미래에셋생명,4225,4170,-55,-1.3,940975,3962166865
006800,미래에셋증권,10000,10100,100,1.0,1931964,19496149850
00680K,미래에셋증권2우B,4885,4930,45,0.92,251684,1235093710
006805,미래에셋증권우,6900,6810,-90,-1.3,124831,852331910
002840,미원상사,219000,220000,1000,0.46,9384,2065502000
268280,미원에스씨,175500,174000,-1500,-0.85,2163,382080500
107590,미원홀딩스,121500,125500,4000,3.29,4506,557536500
134380,미원화학,76900,76100,-800,-1.04,423,32029100
003650,미창석유,83800,83800,0,0.0,4879,403870700
155900,바다로19호,2605,2615,10,0.38,11654,30386890
003610,방림,2785,2905,120,4.31,2458899,7154911310
001340,백광산업,5060,5340,280,5.53,6824617,37085619960
035150,백산,9780,9850,70,0.72,366147,3584660710
002410,범양건영,4065,4080,15,0.37,147430,600154155
096300,베트남개발1,237,237,0,0.0,276290,65155118
007210,벽산,4270,4220,-50,-1.17,860180,3647586250
002760,보락,2360,2365,5,0.21,586787,1394325125
003850,보령제약,23050,23000,-50,-0.22,624550,14360545150
000890,보해양조,1165,1170,5,0.43,2513157,2936374175
003000,부광약품,20700,20600,-100,-0.48,483934,10011520700
001270,부국증권,24900,25100,200,0.8,7419,183848400
001275,부국증권우,22050,22100,50,0.23,1569,34681450
026940,부국철강,5090,4960,-130,-2.55,508660,2573050860
015350,부산가스,68000,64400,-3600,-5.29,11687,766950600
011390,부산산업,139500,139000,-500,-0.36,8897,1242603000
005030,부산주공,594,587,-7,-1.18,270944,158990099
002070,비비안,3415,3580,165,4.83,458516,1614219600
100220,비상교육,7950,8490,540,6.79,1855718,16056001340
030790,비케이탑스,8950,8900,-50,-0.56,80303,715509160
005180,빙그레,64000,62900,-1100,-1.72,56686,3595804700
003960,사조대림,21100,21100,0,0.0,49259,1034948250
008040,사조동아원,1505,1450,-55,-3.65,3219492,4738630485
007160,사조산업,50400,50400,0,0.0,13653,684908300
014710,사조씨푸드,6300,6220,-80,-1.27,243844,1529623560
006090,사조오양,11350,11400,50,0.44,113977,1292437700
001470,삼부토건,2750,2725,-25,-0.91,1258563,3463819425
006400,삼성SDI,602000,626000,24000,3.99,288206,178619161000
006405,삼성SDI우,410500,419000,8500,2.07,7192,2996732500
006660,삼성공조,15700,16050,350,2.23,171398,2778263200
028260,삼성물산,132500,140000,7500,5.66,1000628,138207033500
02826K,삼성물산우B,130000,136000,6000,4.62,26170,3521524500
207940,삼성바이오로직스,866000,948000,82000,9.47,1010588,921105771000
032830,삼성생명,86300,84900,-1400,-1.62,599282,51106015600
018260,삼성에스디에스,175500,180500,5000,2.85,131597,23562496500
028050,삼성엔지니어링,19350,19000,-350,-1.81,3191484,60539575900
009150,삼성전기,160500,164500,4000,2.49,760774,124297276000
009155,삼성전기우,102000,103500,1500,1.47,15319,1578513000
005930,삼성전자,78500,80100,1600,2.04,16450920,1313024424300
005935,삼성전자우,72200,73900,1700,2.35,1058711,77733475100
001360,삼성제약,8260,8430,170,2.06,6918680,57969072000
010140,삼성중공업,5890,5840,-50,-0.85,5039675,29524204720
010145,삼성중공우,302000,301000,-1000,-0.33,1116,338912000
016360,삼성증권,44000,44400,400,0.91,421598,18749915750
068290,삼성출판사,41050,41350,300,0.73,215245,9038452300
029780,삼성카드,33550,33600,50,0.15,178362,5979509900
000810,삼성화재,215000,212500,-2500,-1.16,135934,29050475000
000815,삼성화재우,165000,165500,500,0.3,13773,2270303500
006110,삼아알미늄,14950,13550,-1400,-9.36,1033013,14498779350
145990,삼양사,66200,65700,-500,-0.76,77480,5101555200
145995,삼양사우,48800,49000,200,0.41,1626,79433200
003230,삼양식품,97500,95500,-2000,-2.05,78793,7572233300
002170,삼양통상,86800,87000,200,0.23,3209,277502700
272550,삼양패키징,30650,30000,-650,-2.12,37481,1132015300
000070,삼양홀딩스,122500,120000,-2500,-2.04,71336,8498129000
000075,삼양홀딩스우,79600,77800,-1800,-2.26,1859,145351100
002810,삼영무역,16200,17050,850,5.25,69855,1193191800
005680,삼영전자,11750,12450,700,5.96,360824,4501741700
003720,삼영화학,2800,2815,15,0.54,99188,279081125
023000,삼원강재,3900,3850,-50,-1.28,298708,1154015030
004380,삼익THK,14100,14450,350,2.48,41309,592195700
002450,삼익악기,1760,1755,-5,-0.28,315471,556673860
004440,삼일씨엔에스,15350,15250,-100,-0.65,42819,653721850
000520,삼일제약,9250,9320,70,0.76,63700,588913590
009770,삼정펄프,37400,36600,-800,-2.14,4106,151227700
005500,삼진제약,26350,26600,250,0.95,37869,1001833900
004690,삼천리,86400,86900,500,0.58,8224,711870700
010960,삼호개발,6190,6370,180,2.91,1826339,11517701360
004450,삼화왕관,41500,41800,300,0.72,1030,42864700
009470,삼화전기,35100,33150,-1950,-5.56,193521,6507227100
011230,삼화전자,3850,3850,0,0.0,13605,52939510
001820,삼화콘덴서,60000,60100,100,0.17,76899,4627833100
000390,삼화페인트,13050,13100,50,0.38,131181,1719487150
001290,상상인증권,1365,1345,-20,-1.47,210510,281966825
041650,상신브레이크,4480,4550,70,1.56,112211,514536080
075180,새론오토모티브,5930,5980,50,0.84,4798,28464460
007540,샘표,56900,58500,1600,2.81,35487,2051615300
248170,샘표식품,57000,59500,2500,4.39,155025,9005522800
007860,서연,19000,19500,500,2.63,415499,8037145650
200880,서연이화,8900,9060,160,1.8,134825,1217610220
017390,서울가스,102000,102500,500,0.49,1644,167998500
004410,서울식품,365,358,-7,-1.92,7698131,2764247002
004415,서울식품우,5770,5700,-70,-1.21,28717,165755910
021050,서원,2750,2690,-60,-2.18,1433399,3864868745
008490,서흥,54400,54800,400,0.74,29194,1599885800
007610,선도전기,3985,3960,-25,-0.63,237939,949622935
136490,선진,21550,18400,-3150,-14.62,1254387,24757939700
014910,성문전자,2370,2400,30,1.27,365343,881497865
014915,성문전자우,12250,11950,-300,-2.45,54115,648152300
003080,성보화학,4900,5020,120,2.45,165546,818114610
004980,성신양회,10600,10650,50,0.47,298265,3175741650
004985,성신양회우,17000,17800,800,4.71,17359,306775650
011300,성안,787,787,0,0.0,0,0
000180,성창기업지주,3135,3270,135,4.31,2799011,8906671285
002420,세기상사,6160,6160,0,0.0,0,0
004360,세방,14550,14650,100,0.69,109912,1606306100
004365,세방우,8780,8770,-10,-0.11,7112,62499670
004490,세방전지,82500,82400,-100,-0.12,55263,4534774100
001430,세아베스틸,33850,31100,-2750,-8.12,1110201,35245023700
306200,세아제강,121000,115000,-6000,-4.96,37167,4312389000
003030,세아제강지주,78000,74000,-4000,-5.13,23978,1788352900
019440,세아특수강,17400,16950,-450,-2.59,77869,1331065100
058650,세아홀딩스,112500,110000,-2500,-2.22,2234,247183000
013000,세우글로벌,2470,2470,0,0.0,0,0
091090,세원이앤씨,1745,1755,10,0.57,242037,424745530
021820,세원정공,8090,8090,0,0.0,0,0
067830,세이브존IC,4000,4080,80,2.0,83074,334606375
033530,세종공업,8170,8210,40,0.49,75751,624826410
075580,세진중공업,6350,6650,300,4.72,879801,5805363050
027970,세하,2190,2130,-60,-2.74,982483,2123597745
145210,세화아이엠씨,692,653,-39,-5.64,5633044,3710109310
308170,센트랄모텍,26800,27000,200,0.75,51458,1388172550
012600,센트럴인사이트,2490,2490,0,0.0,0,0
068270,셀트리온,265000,270500,5500,2.08,571387,152629437500
336370,솔루스첨단소재,50900,52400,1500,2.95,296135,15311172600
33637K,솔루스첨단소재1우,17850,18250,400,2.24,27894,505223800
33637L,솔루스첨단소재2우B,30250,30400,150,0.5,7779,239691150
248070,솔루엠,24800,24600,-200,-0.81,500728,12375379950
004430,송원산업,18600,19350,750,4.03,233192,4442742650
017550,수산중공업,5300,5420,120,2.26,1477869,7996637530
053210,스카이라이프,9360,9780,420,4.49,895017,8758352590
134790,시디즈,82700,84000,1300,1.57,13269,1114603100
016590,신대양제지,83400,86400,3000,3.6,15420,1307474500
029530,신도리코,31700,31550,-150,-0.47,22683,719374850
004970,신라교역,11900,12250,350,2.94,26409,318838200
011930,신성이엔지,2960,2930,-30,-1.01,4056926,11778706445
005390,신성통상,1875,1885,10,0.53,2563087,4915702015
004170,신세계,307000,308000,1000,0.33,114256,35411321000
035510,신세계IC,177500,176500,-1000,-0.56,7806,1375642000
034300,신세계건설,44200,45850,1650,3.73,70848,3281816700
031430,신세계인터내셔날,221500,224500,3000,1.35,70457,15966065000
031440,신세계푸드,105000,100500,-4500,-4.29,85521,8646804100
006880,신송홀딩스,6150,5730,-420,-6.83,139289,817615420
005800,신영와코루,118500,123000,4500,3.8,1908,231261000
001720,신영증권,63300,62200,-1100,-1.74,13969,870285300
001725,신영증권우,63000,63200,200,0.32,1574,98896500
009270,신원,1775,1770,-5,-0.28,1044052,1841160335
009275,신원우,75400,74000,-1400,-1.86,35919,2920033700
002700,신일전자,2155,2130,-25,-1.16,2621268,5661693910
019170,신풍제약,66200,65600,-600,-0.91,1011538,67514046200
019175,신풍제약우,87700,83900,-3800,-4.33,33261,2907069700
002870,신풍제지,3300,3285,-15,-0.45,180600,595238055
293940,신한알파리츠,8210,8230,20,0.24,84078,689412200
055550,신한지주,41500,41200,-300,-0.72,1058721,43508416400
001770,신화실업,31800,32500,700,2.2,10821,348627000
004080,신흥,14800,15900,1100,7.43,88264,1391086700
102280,쌍방울,634,636,2,0.32,1370586,873149973
003410,쌍용CE,7610,7610,0,0.0,895821,6832243320
003620,쌍용차,2770,2770,0,0.0,0,0
004770,써니전자,3425,3485,60,1.75,203841,707800835
015540,쎌마테라퓨틱스,6410,6410,0,0.0,0,0
004920,씨아이테크,1615,1675,60,3.72,186637,306871475
112610,씨에스윈드,69100,69200,100,0.14,269169,18736896200
008700,아남전자,2745,2750,5,0.18,315248,868630840
002790,아모레G,75400,74700,-700,-0.93,111410,8401286000
00279K,아모레G3우전환,50000,49750,-250,-0.5,15762,778645550
002795,아모레G우,26950,26950,0,0.0,42688,1152066900
090430,아모레퍼시픽,290000,291500,1500,0.52,156262,45486619100
090435,아모레퍼시픽우,102500,103500,1000,0.98,95224,9952177000
002030,아세아,133000,137000,4000,3.01,2809,380180500
183190,아세아시멘트,136000,138000,2000,1.47,22241,3047682000
002310,아세아제지,55000,55400,400,0.73,56050,3085557400
012170,아센디오,2900,2900,0,0.0,101191,290553420
267850,아시아나IDT,23800,23500,-300,-1.26,52950,1254983250
020560,아시아나항공,15200,15100,-100,-0.66,384703,5831914850
122900,아이마켓코리아,10900,11700,800,7.34,1079870,12400130650
010780,아이에스동서,64600,64600,0,0.0,40867,2643345400
001780,알루코,4995,5000,5,0.1,1264098,6322241595
018250,애경산업,26150,26000,-150,-0.57,85678,2232216450
161000,애경유화,12550,13350,800,6.37,871305,11495468700
011090,에넥스,2205,2240,35,1.59,3100840,7064641865
005850,에스엘,26850,26950,100,0.37,693762,18786081350
012750,에스원,79800,79900,100,0.13,67851,5419835400
023960,에쓰씨엔지니어링,4165,4355,190,4.56,272541,1158611440
298690,에어부산,3560,3560,0,0.0,228016,813849300
140910,에이리츠,13800,15850,2050,14.86,987433,14774322700
078520,에이블씨엔씨,7820,7860,40,0.51,75172,591095650
015260,에이엔피,1505,1515,10,0.66,165696,247476840
007460,에이프로젠KIC,2110,2320,210,9.95,74469548,172604055405
003060,에이프로젠제약,1205,1280,75,6.22,21581247,27344666250
244920,에이플러스에셋,8800,8670,-130,-1.48,186692,1625492140
036570,엔씨소프트,841000,831000,-10000,-1.19,91373,76431883000
138250,엔에스쇼핑,13600,13550,-50,-0.37,110741,1489464950
085310,엔케이,1370,1385,15,1.09,440912,608686785
009810,엔케이물산,605,599,-6,-0.99,799515,477682320
900140,엘브이엠씨홀딩스,3525,3655,130,3.69,596577,2152015285
014440,영보화학,4945,4950,5,0.1,471696,2332096235
111770,영원무역,46250,47100,850,1.84,187094,8616850750
009970,영원무역홀딩스,53000,54300,1300,2.45,23272,1253016800
003520,영진약품,6260,6240,-20,-0.32,506427,3157969530
000670,영풍,705000,701000,-4000,-0.57,3681,2562108000
006740,영풍제지,6690,6700,10,0.15,73645,492475690
012280,영화금속,1985,1960,-25,-1.26,781339,1547989615
012160,영흥,1245,1235,-10,-0.8,687904,859845045
015360,예스코홀딩스,36250,36750,500,1.38,979,36099950
007310,오뚜기,550000,547000,-3000,-0.55,5866,3222955000
002630,오리엔트바이오,1520,1655,135,8.88,24245124,40889757260
271560,오리온,122000,121000,-1000,-0.82,102238,12253403500
001800,오리온홀딩스,17900,17950,50,0.28,185828,3331689600
070960,용평리조트,5210,5270,60,1.15,361586,1908058310
316140,우리금융지주,11050,11100,50,0.45,1811715,20119008700
033660,우리금융캐피탈,11850,11900,50,0.42,41139,487474450
118000,우리들휴브레인,2160,2140,-20,-0.93,395726,851009845
010050,우리종금,871,867,-4,-0.46,6034450,5223915631
006980,우성사료,38900,37600,-1300,-3.34,75956,2878131700
017370,우신시스템,5140,5250,110,2.14,45025,234048750
105840,우진,5210,5310,100,1.92,822752,4413749360
010400,우진아이엔에스,9140,9300,160,1.75,140774,1338384190
049800,우진플라임,5400,4980,-420,-7.78,346260,1740104250
016880,웅진,2360,2430,70,2.97,705811,1707837365
095720,웅진씽크빅,4160,4115,-45,-1.08,1408819,5828611155
005820,원림,24550,24550,0,0.0,20318,510489750
010600,웰바이오텍,3840,3570,-270,-7.03,2929591,10557607245
008600,윌비스,2225,2230,5,0.22,2149583,4847057070
033270,유나이티드제약,57200,56500,-700,-1.22,473963,27548418700
014830,유니드,78100,79000,900,1.15,47739,3733310100
000910,유니온,8020,7970,-50,-0.62,225415,1808598570
047400,유니온머티리얼,3895,3830,-65,-1.67,759346,2947223575
011330,유니켐,1645,1665,20,1.22,410944,681991700
077500,유니퀘스트,10800,11100,300,2.78,231820,2537010400
002920,유성기업,3470,3645,175,5.04,411063,1477432445
000700,유수홀딩스,8150,8230,80,0.98,264056,2169460780
003470,유안타증권,4425,4450,25,0.56,654596,2913066375
003475,유안타증권우,5020,4970,-50,-1.0,117209,584215405
011690,유양디앤유,2440,2440,0,0.0,0,0
072130,유엔젤,4105,4105,0,0.0,80955,331995445
000220,유유제약,9800,9690,-110,-1.12,372325,3632374090
000225,유유제약1우,16350,15200,-1150,-7.03,157206,2437418350
000227,유유제약2우B,31850,33050,1200,3.77,20591,666286350
001200,유진투자증권,4535,4535,0,0.0,531552,2418778490
000100,유한양행,62400,63300,900,1.44,473601,29685524100
000105,유한양행우,60600,61400,800,1.32,1017,61954500
003460,유화증권,2690,2695,5,0.19,52672,141244210
003465,유화증권우,2800,2750,-50,-1.79,15470,42295065
008730,율촌화학,23300,24100,800,3.43,123941,2962315800
008250,이건산업,13250,14250,1000,7.55,1239005,17270922400
025820,이구산업,4480,4355,-125,-2.79,2405110,10494170100
214320,이노션,58800,59300,500,0.85,35391,2096083100
088260,이리츠코크렙,6120,6120,0,0.0,45385,278393920
139480,이마트,154500,154000,-500,-0.32,191123,29565279000
007660,이수페타시스,3735,3800,65,1.74,287995,1082370630
005950,이수화학,13000,13600,600,4.62,1225859,16466311400
015020,이스타코,2660,3290,630,23.68,31669626,100457589170
093230,이아이디,456,439,-17,-3.73,35313520,15732546583
074610,이엔플러스,3430,3500,70,2.04,280514,972271895
102460,이연제약,23000,24750,1750,7.61,3120750,76495229700
084680,이월드,3500,3505,5,0.14,331169,1167475445
350520,이지스레지던스리츠,5040,5060,20,0.4,49459,249803060
334890,이지스밸류리츠,4995,5010,15,0.3,140749,703883410
000760,이화산업,19600,19800,200,1.02,1428,28087100
014990,인디에프,1500,1500,0,0.0,156255,235445760
101140,인바이오젠,3105,3095,-10,-0.32,336635,1048423560
006490,인스코비,3185,3035,-150,-4.71,2168098,6709579365
023800,인지컨트롤스,21750,23150,1400,6.44,1313303,30044758200
034590,인천도시가스,27350,27500,150,0.55,2267,62081200
129260,인터지스,4555,4620,65,1.43,665957,3123169675
023810,인팩,12400,12400,0,0.0,154731,1942270400
249420,일동제약,15400,15600,200,1.3,60462,940843900
000230,일동홀딩스,14100,14200,100,0.71,4141,58438200
013360,일성건설,2300,2310,10,0.43,2441200,5841060625
003120,일성신약,87400,90900,3500,4.0,22663,2045814500
003200,일신방직,108500,108500,0,0.0,2919,316005000
007110,일신석재,2150,2140,-10,-0.47,1054826,2267410965
007570,일양약품,38400,39250,850,2.21,497617,19612226550
007575,일양약품우,42100,43500,1400,3.33,13947,623692800
008500,일정실업,16100,16100,0,0.0,2223,35758950
081000,일진다이아,40100,40450,350,0.87,21621,874748150
020760,일진디스플,4560,4460,-100,-2.19,242147,1094725795
020150,일진머티리얼즈,64200,66300,2100,3.27,214465,14230929200
103590,일진전기,4000,4035,35,0.88,128296,513082585
015860,일진홀딩스,5320,5330,10,0.19,146162,779733200
226320,잇츠한불,27250,27850,600,2.2,152591,4242078250
317400,자이에스앤디,10600,10600,0,0.0,150882,1594288100
033240,자화전자,18300,19500,1200,6.56,164081,3171623250
000950,전방,40450,40250,-200,-0.49,2251,90932700
348950,제이알글로벌리츠,5150,5160,10,0.19,410211,2111943260
194370,제이에스코퍼레이션,21750,21950,200,0.92,126524,2761924800
025620,제이준코스메틱,2295,2305,10,0.44,303434,699039805
036420,제이콘텐트리,44900,45750,850,1.89,68201,3129167700
030000,제일기획,22700,23000,300,1.32,251144,5754706650
271980,제일약품,42300,42700,400,0.95,45146,1915181400
001560,제일연마,8680,8780,100,1.15,16099,140268140
002620,제일파마홀딩스,24900,24750,-150,-0.6,22009,549085350
006220,제주은행,7210,7040,-170,-2.36,850554,6059812430
089590,제주항공,25050,24500,-550,-2.2,276199,6784642500
004910,조광페인트,8700,8610,-90,-1.03,507009,4388122040
004700,조광피혁,55500,54900,-600,-1.08,3533,194368300
001550,조비,23100,23400,300,1.3,51941,1207702000
000480,조선내화,91100,91500,400,0.44,3316,300513700
120030,조선선재,156500,155500,-1000,-0.64,17087,2668376500
018470,조일알미늄,1000,958,-42,-4.2,7451208,7237644186
002600,조흥,187500,190000,2500,1.33,556,105316500
185750,종근당,129000,130500,1500,1.16,45614,5922424000
063160,종근당바이오,62400,61000,-1400,-2.24,130314,8016175000
001630,종근당홀딩스,110500,111500,1000,0.9,15564,1714489000
044380,주연테크,1100,1110,10,0.91,346728,381913115
013890,지누스,95100,97000,1900,2.0,140880,13587422800
013870,지엠비코리아,7480,7430,-50,-0.67,57177,427333150
071320,지역난방공사,42500,42800,300,0.71,13003,553620800
010580,지코,306,306,0,0.0,0,0
035000,지투알,6630,6670,40,0.6,45931,304822500
088790,진도,5140,5360,220,4.28,149775,791852650
003780,진양산업,5530,5620,90,1.63,226251,1275852760
010640,진양폴리,3685,3745,60,1.63,85989,319596930
100250,진양홀딩스,3095,3130,35,1.13,122912,382857075
051630,진양화학,4155,4175,20,0.48,73317,306734635
272450,진에어,24100,24000,-100,-0.41,450809,10892739550
011000,진원생명과학,19100,19350,250,1.31,2897981,54561881250
002780,진흥기업,2400,2405,5,0.21,3275089,7978076380
002787,진흥기업2우B,15400,20000,4600,29.87,102270,2030191500
002785,진흥기업우B,7370,9580,2210,29.99,357349,3382252150
009310,참엔지니어링,1525,1530,5,0.33,251919,385181595
000650,천일고속,70800,74900,4100,5.79,21237,1584809000
033250,체시스,1600,1625,25,1.56,592677,973478350
035720,카카오,109500,109000,-500,-0.46,2276082,248488860000
006380,카프로,5050,4860,-190,-3.76,846373,4152917785
109070,컨버즈,4100,4100,0,0.0,0,0
001620,케이비아이동국실업,865,884,19,2.2,222616,195218449
029460,케이씨,28100,28600,500,1.78,53724,1535164850
344820,케이씨씨글라스,62500,63500,1000,1.6,102917,6539817300
281820,케이씨텍,27700,29300,1600,5.78,192597,5566589950
145270,케이탑리츠,1955,2020,65,3.32,766118,1539902570
357120,코람코에너지리츠,6090,6090,0,0.0,195014,1182840360
007815,코리아써우,7540,7720,180,2.39,22502,172443400
007810,코리아써키트,12300,12550,250,2.03,54390,676676900
00781K,코리아써키트2우B,9340,9380,40,0.43,31218,295783610
003690,코리안리,9950,9920,-30,-0.3,648342,6470718300
192820,코스맥스,123000,120500,-2500,-2.03,80060,9680842500
044820,코스맥스비티아이,18400,18200,-200,-1.09,30725,559744650
005070,코스모신소재,24100,24900,800,3.32,563909,13935753350
005420,코스모화학,11100,11250,150,1.35,305518,3451782650
071950,코아스,1290,1310,20,1.55,470458,610114355
002020,코오롱,32150,32800,650,2.02,56104,1837049300
003070,코오롱글로벌,25850,26500,650,2.51,111706,2938471900
003075,코오롱글로벌우,35500,37100,1600,4.51,19479,746833750
144620,코오롱머티리얼,2960,2990,30,1.01,80256,240139310
002025,코오롱우,23300,23150,-150,-0.64,39690,935102950
120110,코오롱인더,59400,60400,1000,1.68,168797,10131637300
120115,코오롱인더우,29900,29950,50,0.17,11185,335518550
138490,코오롱플라스틱,6330,6420,90,1.42,129831,828187610
021240,코웨이,76600,78000,1400,1.83,702469,54809489400
031820,콤텍시스템,1265,1280,15,1.19,368807,470224855
192400,쿠쿠홀딩스,133500,134500,1000,0.75,5312,713971000
284740,쿠쿠홈시스,45300,46000,700,1.55,113234,5209218050
015590,큐로,594,595,1,0.17,1834229,1096403940
264900,크라운제과,14100,14300,200,1.42,131181,1849563250
26490K,크라운제과우,31900,31650,-250,-0.78,118673,3764206800
005740,크라운해태홀딩스,12200,12700,500,4.1,196376,2464116650
005745,크라운해태홀딩스우,25550,26600,1050,4.11,48542,1283187150
020120,키다리스튜디오,13750,14100,350,2.55,103029,1440580900
039490,키움증권,126000,126500,500,0.4,149550,18875571500
014580,태경비케이,4770,4680,-90,-1.89,290214,1362289815
015890,태경산업,7020,7000,-20,-0.28,58975,411626290
006890,태경케미컬,14350,14150,-200,-1.39,351354,5053509950
003240,태광산업,1200000,1208000,8000,0.67,1708,2064672000
011280,태림포장,5040,5100,60,1.19,124816,634893200
004100,태양금속,1650,1595,-55,-3.33,3154630,5035549705
004105,태양금속우,3700,3665,-35,-0.95,300801,1087122240
009410,태영건설,13350,13600,250,1.87,128490,1735408950
009415,태영건설우,19200,19500,300,1.56,60207,1169544750
001420,태원물산,4870,4875,5,0.1,177648,880619370
007980,태평양물산,2870,2825,-45,-1.57,1159037,3270103380
055490,테이팩스,55200,56200,1000,1.81,39700,2215274800
078000,텔코웨어,12150,12300,150,1.23,17600,215154950
214420,토니모리,8200,8150,-50,-0.61,51561,420860890
019180,티에이치엔,3245,3330,85,2.62,174993,576435550
363280,티와이홀딩스,25350,25950,600,2.37,73967,1902464050
36328K,티와이홀딩스우,27450,27950,500,1.82,25166,701281600
091810,티웨이항공,3105,3085,-20,-0.64,2300567,7029265850
004870,티웨이홀딩스,1390,1405,15,1.08,1184060,1690735090
005690,파미셀,16700,18300,1600,9.58,9555404,171433282400
036580,팜스코,8780,8180,-600,-6.83,1131607,9350681500
004720,팜젠사이언스,12250,12450,200,1.63,537996,6753310650
028670,팬오션,7200,6870,-330,-4.58,13412185,93938166730
010820,퍼스텍,2455,2490,35,1.43,211981,523905800
016800,퍼시스,44000,45750,1750,3.98,25721,1159345500
001020,페이퍼코리아,2185,2185,0,0.0,62815,137869690
090080,평화산업,1190,1210,20,1.68,181430,217874345
010770,평화홀딩스,4135,4240,105,2.54,44079,185097105
058430,포스코강판,73400,68600,-4800,-6.54,583933,41455395700
047050,포스코인터내셔널,21250,22000,750,3.53,643011,14146035700
003670,포스코케미칼,145000,146500,1500,1.03,235159,34216558000
007630,폴루스바이오팜,1225,1225,0,0.0,0,0
017810,풀무원,23000,21400,-1600,-6.96,960852,20755988950
103140,풍산,44900,43550,-1350,-3.01,1039452,45505876700
005810,풍산홀딩스,29400,29100,-300,-1.02,84221,2467398200
950210,프레스티지바이오파마,29800,29350,-450,-1.51,211025,6250219750
086790,하나금융지주,46850,45900,-950,-2.03,995440,45800166250
293480,하나제약,23200,23300,100,0.43,13078,303664700
039130,하나투어,68700,68400,-300,-0.44,164095,11333727400
172580,하이골드12호,2370,2370,0,0.0,20165,47578735
153360,하이골드3호,1680,1685,5,0.3,15518,26089485
352820,하이브,240500,242500,2000,0.83,149565,36290484000
071090,하이스틸,4020,3790,-230,-5.72,1320468,5042246665
019490,하이트론,7660,9160,1500,19.58,1873671,16509929240
000080,하이트진로,35350,35700,350,0.99,1055675,37676426950
000087,하이트진로2우B,22850,23050,200,0.88,8218,188305050
000140,하이트진로홀딩스,16750,17500,750,4.48,90300,1547667800
000145,하이트진로홀딩스우,19450,19800,350,1.8,4152,82942300
152550,한국ANKOR유전,1670,1665,-5,-0.3,48713,81233135
036460,한국가스공사,32100,32150,50,0.16,383722,12395146800
005430,한국공항,43350,43350,0,0.0,24782,1074918300
071050,한국금융지주,104000,106000,2000,1.92,357950,37392505500
071055,한국금융지주우,86300,87000,700,0.81,37454,3241966100
010040,한국내화,4675,4585,-90,-1.93,421074,1941936175
025540,한국단자,80200,83600,3400,4.24,375605,31496092600
004090,한국석유,17400,16800,-600,-3.45,461774,7803835100
002200,한국수출포장,26250,26200,-50,-0.19,17554,460648750
002960,한국쉘석유,284500,280500,-4000,-1.41,4519,1272822000
000240,한국앤컴퍼니,18650,18800,150,0.8,235950,4442655300
123890,한국자산신탁,4825,4975,150,3.11,690364,3400754770
015760,한국전력,23750,23900,150,0.63,2631245,59378275500
006200,한국전자홀딩스,1230,1260,30,2.44,564126,705906665
009540,한국조선해양,149000,148500,-500,-0.34,410730,60877014000
023350,한국종합기술,8370,8850,480,5.73,563699,4930778090
025890,한국주강,2735,2675,-60,-2.19,166681,445849375
000970,한국주철관,10150,10250,100,0.99,272562,2776164950
104700,한국철강,11350,11150,-200,-1.76,279242,3110158500
017960,한국카본,11750,11750,0,0.0,425833,5009668250
161890,한국콜마,57000,57000,0,0.0,100551,5758725300
024720,한국콜마홀딩스,31200,31300,100,0.32,62852,1962601550
161390,한국타이어앤테크놀로지,48050,48000,-50,-0.1,189111,9133025350
034830,한국토지신탁,2335,2350,15,0.64,842248,1976006385
007280,한국특강,3855,3770,-85,-2.2,678333,2513946175
168490,한국패러랠,1980,1975,-5,-0.25,28955,57290335
010100,한국프랜지,3085,3150,65,2.11,156900,489036760
047810,한국항공우주,30900,31250,350,1.13,445608,13961638000
123690,한국화장품,11750,11750,0,0.0,68475,807085900
003350,한국화장품제조,35700,35400,-300,-0.84,20711,732134750
011500,한농화성,14900,14900,0,0.0,139391,2087752850
002390,한독,28750,28800,50,0.17,42970,1234493150
014790,한라,5750,5760,10,0.17,234902,1357659380
060980,한라홀딩스,43500,44000,500,1.15,68370,3007066100
053690,한미글로벌,11550,11950,400,3.46,145952,1742595100
042700,한미반도체,30000,32850,2850,9.5,2050356,65682551450
008930,한미사이언스,74500,66600,-7900,-10.6,720625,49313390800
128940,한미약품,347500,329000,-18500,-5.32,130105,43153867000
009240,한샘,106500,105500,-1000,-0.94,48374,5146221500
020000,한섬,48850,48150,-700,-1.43,153215,7381563150
003680,한성기업,8330,8450,120,1.44,63858,539052280
105630,한세실업,25650,27550,1900,7.41,755666,19966640300
069640,한세엠케이,4605,4690,85,1.85,74287,346718365
016450,한세예스24홀딩스,9090,9220,130,1.43,87496,807133550
010420,한솔PNS,2145,2200,55,2.56,162570,354873720
009180,한솔로지스틱스,3355,3395,40,1.19,984791,3346391585
213500,한솔제지,16650,16850,200,1.2,162418,2728453350
014680,한솔케미칼,232000,242000,10000,4.31,47828,11449809500
004710,한솔테크닉스,9400,9340,-60,-0.64,280272,2632829150
004150,한솔홀딩스,4415,4475,60,1.36,157510,702526395
025750,한솔홈데코,2285,2220,-65,-2.84,6423004,14449908005
004960,한신공영,26900,26600,-300,-1.12,80308,2136946700
011700,한신기계,2350,2340,-10,-0.43,321256,760316995
001750,한양증권,14900,14550,-350,-2.35,110323,1617659150
001755,한양증권우,25250,24650,-600,-2.38,7279,179888100
018880,한온시스템,15950,16000,50,0.31,682767,10954586400
009420,한올바이오파마,20600,20700,100,0.49,241196,5009183150
014130,한익스프레스,6920,6870,-50,-0.72,156125,1074550730
300720,한일시멘트,160500,161500,1000,0.62,15664,2577425000
002220,한일철강,3395,3290,-105,-3.09,408079,1336476985
006390,한일현대시멘트,41750,41400,-350,-0.84,50339,2091624600
003300,한일홀딩스,14650,14800,150,1.02,13534,200672800
051600,한전KPS,38000,38700,700,1.84,972242,37734796250
052690,한전기술,40850,40100,-750,-1.84,675315,27534074300
130660,한전산업,5120,5090,-30,-0.59,216658,1106117930
002320,한진,39500,39500,0,0.0,39893,1578485850
097230,한진중공업,8240,8240,0,0.0,116053,958548420
003480,한진중공업홀딩스,4300,4345,45,1.05,58805,253406685
180640,한진칼,60000,59900,-100,-0.17,156535,9380084200
18064K,한진칼우,45050,43350,-1700,-3.77,10941,476509400
005110,한창,1265,1235,-30,-2.37,760954,951726415
009460,한창제지,2380,2395,15,0.63,731597,1749248100
000880,한화,32850,31800,-1050,-3.2,1721031,55666622700
00088K,한화3우B,15550,15550,0,0.0,55334,860071250
088350,한화생명,4215,3950,-265,-6.29,22731381,91431038235
000370,한화손해보험,5310,4875,-435,-8.19,5236941,26275260885
009830,한화솔루션,43900,44050,150,0.34,1090439,47926353050
009835,한화솔루션우,54900,54700,-200,-0.36,4410,241633400
272210,한화시스템,16900,16750,-150,-0.89,585403,9843687800
012450,한화에어로스페이스,42250,43250,1000,2.37,1074285,46155335000
000885,한화우,47350,46400,-950,-2.01,4412,207427150
003530,한화투자증권,5200,5150,-50,-0.96,4844810,25248131180
003535,한화투자증권우,30150,29800,-350,-1.16,726026,22126634250
195870,해성디에스,32050,32750,700,2.18,102870,3363180200
101530,해태제과식품,10550,10550,0,0.0,166105,1757264850
143210,핸즈코퍼레이션,6510,6540,30,0.46,69494,448452990
000720,현대건설,51500,51900,400,0.78,578649,30167290800
267270,현대건설기계,60900,60100,-800,-1.31,203935,12287055000
000725,현대건설우,229000,227000,-2000,-0.87,1655,380053000
005440,현대그린푸드,11300,11300,0,0.0,2982082,34329523400
086280,현대글로비스,189000,186000,-3000,-1.59,208071,38879803500
064350,현대로템,20100,20100,0,0.0,834428,16832240400
079430,현대리바트,18200,18300,100,0.55,138867,2533268900
012330,현대모비스,277000,275000,-2000,-0.72,332608,91868968500
010620,현대미포조선,89600,88900,-700,-0.78,545984,48694032300
069960,현대백화점,91100,91100,0,0.0,159956,14606654000
004560,현대비앤지스틸,22050,20950,-1100,-4.99,741600,15768321300
004565,현대비앤지스틸우,101500,99400,-2100,-2.07,3824,381695300
004310,현대약품,6840,6960,120,1.75,139138,963141070
322000,현대에너지솔루션,32150,32350,200,0.62,26805,865647700
017800,현대엘리베이,48700,49600,900,1.85,229133,11304594250
307950,현대오토에버,107000,109000,2000,1.87,35922,3922265000
011210,현대위아,79400,81000,1600,2.02,990304,80986583700
267260,현대일렉트릭,22650,23050,400,1.77,365043,8410329150
004020,현대제철,57000,55900,-1100,-1.93,1868784,105225052600
267250,현대중공업지주,75000,73400,-1600,-2.13,432497,31645130800
005380,현대차,229500,229000,-500,-0.22,1357407,313063406000
005387,현대차2우B,113000,113000,0,0.0,63394,7189040500
005389,현대차3우B,105000,104500,-500,-0.48,11430,1201465500
005385,현대차우,111000,111500,500,0.45,92351,10335065500
001500,현대차증권,14300,14450,150,1.05,167589,2424187950
011760,현대코퍼레이션,21100,21100,0,0.0,87672,1852337250
227840,현대코퍼레이션홀딩스,15000,15050,50,0.33,55935,842045600
126560,현대퓨처넷,4305,4360,55,1.28,305851,1326957610
001450,현대해상,24950,24800,-150,-0.6,744984,18497621950
057050,현대홈쇼핑,88800,93600,4800,5.41,120000,11145901200
093240,형지엘리트,4540,4900,360,7.93,22533752,116424005035
003010,혜인,7480,7480,0,0.0,188859,1431938620
111110,호전실업,14000,13900,-100,-0.71,107866,1510865500
008770,호텔신라,93700,92600,-1100,-1.17,671347,62939103600
008775,호텔신라우,90100,90600,500,0.55,17768,1607439300
002460,화성산업,13750,13800,50,0.36,102718,1422723300
378850,화승알앤에이,6380,6320,-60,-0.94,127183,807752240
241590,화승엔터프라이즈,20650,20350,-300,-1.45,543991,11398284250
006060,화승인더,8720,8700,-20,-0.23,720185,6278898350
013520,화승코퍼레이션,2335,2230,-105,-4.5,831604,1894946420
010690,화신,5360,5700,340,6.34,7649737,43649208940
133820,화인베스틸,2970,2860,-110,-3.7,905660,2570110135
010660,화천기계,2685,2670,-15,-0.56,154566,411623275
000850,화천기공,38000,37450,-550,-1.45,12227,464772200
016580,환인제약,20600,20950,350,1.7,124104,2587920150
032560,황금에스티,10050,10050,0,0.0,761403,7640349560
004800,효성,102500,102500,0,0.0,60951,6275605500
094280,효성ITX,19500,19450,-50,-0.26,17569,342572700
298040,효성중공업,64500,64700,200,0.31,39095,2516095000
298050,효성첨단소재,361500,360500,-1000,-0.28,44378,16092839000
298020,효성티앤씨,699000,729000,30000,4.29,93808,67906884000
298000,효성화학,382500,377000,-5500,-1.44,55947,21269197000
093370,후성,9830,10000,170,1.73,408093,4078776390
081660,휠라홀딩스,55100,53700,-1400,-2.54,814983,44202759300
005870,휴니드,8060,8060,0,0.0,66296,535890920
079980,휴비스,11250,11050,-200,-1.78,428784,4819178600
005010,휴스틸,18350,17400,-950,-5.18,453783,7928153600
069260,휴켐스,21900,21950,50,0.23,136623,2989857950
000540,흥국화재,4850,4735,-115,-2.37,414622,1982905800
000547,흥국화재2우B,33650,33700,50,0.15,26108,929198550
000545,흥국화재우,12150,12400,250,2.06,53236,695434050
003280,흥아해운,258,258,0,0.0,0,0
